scorer,neutral,minute,own_goal,penalty,home_goal,away_goal,total_goals
A'ala Hubail,5,717.0,0,1,10,3,13
A. Elangovan,0,42.0,0,0,1,0,1
Aage Rou Jensen,0,85.0,0,0,0,1,1
Aaran Lines,1,170.0,0,0,3,0,3
Aaron Boupendza,1,16.0,0,0,0,1,1
Aaron Hughes,0,5.0,0,0,1,0,1
Aaron Long,0,131.0,0,0,2,0,2
Aaron Mooy,0,217.0,0,0,2,2,4
Aaron Njovu,1,108.0,0,0,1,1,2
Aaron Ramsey,2,813.0,0,5,7,10,17
Aaron Tumwa,0,90.0,0,0,1,0,1
Aarón Padilla Gutiérrez,0,80.0,0,0,1,1,2
Aatef Jenyat,1,17.0,0,0,0,1,1
Abay Bokoleyev,1,63.0,0,0,0,1,1
Abbas Ahmed Atwi,1,122.0,0,1,1,1,2
Abbas Chahrour,0,28.0,0,0,1,0,1
Abbas Hassan Hassun,2,147.0,0,0,0,2,2
Abbas Obeid,1,4.0,0,0,0,1,1
Abbas Souan,0,90.0,0,0,1,0,1
Abdah Alif,1,32.0,0,0,0,1,1
Abdallah Azhar,1,160.0,0,1,2,1,3
Abdallah Deeb,0,291.0,0,2,2,5,7
Abdallah El Said,1,242.0,0,0,3,1,4
Abdel Halim Ali,1,135.0,0,0,3,1,4
Abdel Kafi El-Sheikh,0,38.0,0,0,1,0,1
Abdel Rasoul Hesham,0,146.0,0,0,2,1,3
Abdel Razak Al-Farjani,0,43.0,0,0,1,0,1
Abdel Razak Jaranah,0,58.0,0,0,1,0,1
Abdel Sattar Sabry,1,159.0,0,0,3,1,4
Abdel-Hadi Al-Maharmeh,0,28.0,0,0,0,1,1
Abdel-Zaher El-Saqqa,0,84.0,1,0,1,1,2
Abdelatif Bahdari,0,90.0,0,0,1,0,1
Abdelaziz Barrada,0,3.0,0,0,1,0,1
Abdelaziz Daidi,0,44.0,0,0,1,0,1
Abdelaziz Ibrahim Adam,1,90.0,0,0,0,1,1
Abdelfattah El Khattari,0,48.0,0,0,2,0,2
Abdelfettah Rhiati,1,83.0,0,0,1,1,2
Abdelghani Lakhal,0,35.0,0,0,1,0,1
Abdelhafid Tasfaout,2,449.0,0,0,7,3,10
Abdelhakim Serrar,0,20.0,1,0,0,1,1
Abdelilah Hafidi,0,82.0,0,0,0,1,1
Abdeljalil Hadda,2,397.0,0,0,5,1,6
Abdelkabir Mezyane,0,72.0,0,0,1,0,1
Abdelkader Ben Hassen,1,48.0,0,0,1,0,1
Abdelkader Ferhaoui,1,36.0,0,0,1,0,1
Abdelkader Ghezzal,0,86.0,0,0,2,0,2
Abdelkader Rakbaoui,0,72.0,0,0,2,0,2
Abdelkarim Hassan,1,164.0,0,0,1,2,3
Abdelkrim Merry,2,168.0,0,1,1,2,3
Abdellah Tazi,1,19.0,0,0,1,0,1
Abdelmajid Bouyboud,0,93.0,0,0,0,2,2
Abdelmajid Chetali,1,109.0,0,0,2,1,3
Abdelmajid Tlemçani,0,60.0,0,0,1,0,1
Abdelmalek Cherrad,1,125.0,0,0,2,2,4
Abdelmoumene Djabou,2,158.0,0,0,0,2,2
Abdelmutaleb Nasir,1,40.0,0,0,0,1,1
Abdelrazak Belgharbi,1,36.0,1,0,0,1,1
Abdelrazaq Al Hussain,4,251.0,0,0,1,3,4
Abdelwahab Lahmar,0,84.0,0,0,1,0,1
Abdelâali Zahraoui,2,168.0,0,0,1,1,2
Abderraouf Ben Aziza,2,266.0,0,0,3,1,4
Abderrazak Hamdallah,0,39.0,0,1,1,0,1
Abderrazak Khairi,2,45.0,0,0,0,2,2
Abdesalam Kames,1,42.0,0,0,1,0,1
Abdeslam Laghrissi,0,62.0,0,0,1,0,1
Abdeslam Ouaddou,2,165.0,0,0,1,1,2
Abdessalam Benjelloun,0,40.0,0,0,1,1,2
Abdesselam Adhouma,0,15.0,0,0,0,1,1
Abdesselem Cheman,1,87.0,0,0,1,0,1
Abdi Idleh Hamza,0,74.0,0,0,1,0,1
Abdiel Arroyo,3,326.0,0,0,3,2,5
Abdoh Otaif,0,78.0,0,1,2,1,3
Abdolreza Barzegari,2,114.0,0,0,0,2,2
Abdou Bin Amidou,0,39.0,0,0,0,1,1
Abdou Diallo,1,151.0,0,0,1,1,2
Abdou Jammeh,0,93.0,0,0,2,0,2
Abdou Karim Sèye,0,24.0,0,0,1,0,1
Abdou Traoré,0,54.0,0,0,0,1,1
Abdou-Rahman Njie,0,64.0,0,0,1,0,1
Abdoul Camara,2,107.0,0,1,1,2,3
Abdoul Tapsoba,4,220.0,0,0,2,2,4
Abdoul-Aziz Nikiema,0,79.0,0,0,1,0,1
Abdoulai Demba,0,48.0,0,0,1,0,1
Abdoulay Diaby,1,37.0,0,0,1,0,1
Abdoulaye Ba,0,63.0,0,0,1,0,1
Abdoulaye Cissé,0,79.0,0,0,2,0,2
Abdoulaye Emmerson,0,116.0,0,0,2,0,2
Abdoulaye Faye,1,155.0,0,0,3,0,3
Abdoulaye M'Baye,1,80.0,0,0,0,1,1
Abdoulaye Makhtar Diop,0,32.0,0,0,1,0,1
Abdoulaye Traoré,9,888.0,0,1,13,4,17
Abdukahhor Marifaliev,0,62.0,0,0,0,2,2
Abdul Aziz Al-Muqbali,1,382.0,0,0,6,1,7
Abdul Aziz Corr,0,18.0,0,1,1,0,1
Abdul Farooq,0,80.0,0,0,0,1,1
Abdul Hadi Yahya,0,70.0,0,0,0,1,1
Abdul Hakim,0,80.0,0,0,1,0,1
Abdul Hamid Al Katbi,0,36.0,0,0,1,0,1
Abdul Jaloof,0,126.0,0,0,1,1,2
Abdul Kader Kardaghli,0,4.0,0,0,1,0,1
Abdul Kader Keïta,4,457.0,0,0,8,0,8
Abdul Kader Rifai,0,10.0,0,0,1,0,1
Abdul Latif Helou,0,226.0,0,0,2,2,4
Abdul Majeed Waris,0,141.0,0,0,3,0,3
Abdul Mubin Mokhtar,0,132.0,0,0,3,0,3
Abdul Nzayinawo,0,64.0,0,0,1,0,1
Abdul Rahman Abdulla,0,65.0,0,0,1,0,1
Abdul Razaq Ibrahim,0,52.0,0,0,2,1,3
Abdul Rwatubyaye,0,21.0,0,0,1,0,1
Abdul Sesay,1,81.0,0,0,1,0,1
Abdul-Aziz Hassan,0,45.0,0,0,1,0,1
Abdul-Hamid Bassiouny,0,127.0,0,0,3,0,3
Abdul-Wahab Abu Al-Hail,4,243.0,0,3,5,2,7
Abdulaziz Al Sulaiti,0,14.0,0,0,0,1,1
Abdulaziz Al-Anberi,2,646.0,0,0,9,4,13
Abdulaziz Al-Dosari,0,30.0,0,0,1,0,1
Abdulaziz Al-Hajeri,0,5.0,0,0,0,1,1
Abdulaziz Hatem,5,256.0,0,0,3,4,7
Abdulaziz Mohamed,1,241.0,0,0,2,1,3
Abdulfattah Asiri,0,95.0,0,0,2,0,2
Abdulfattah Shehab,0,64.0,0,0,1,1,2
Abdulgadir Ilyas Bakur,0,37.0,0,0,0,1,1
Abdulghani Tatiche,0,12.0,0,0,0,1,1
Abdulla Al Marzooqi,0,8.0,0,0,1,0,1
Abdulla Baba Fatadi,0,71.0,0,0,1,1,2
Abdulla Nasur,1,25.0,0,0,0,2,2
Abdullah Al-Buloushi,2,154.0,0,0,1,1,2
Abdullah Al-Dosari,1,155.0,0,0,1,1,2
Abdullah Al-Hamdan,0,61.0,0,0,1,0,1
Abdullah Al-Waked,0,61.0,0,1,1,1,2
Abdullah Bin Shehan,2,209.0,0,0,1,4,5
Abdullah Fawaz,2,281.0,0,1,3,2,5
Abdullah Jumaan Al-Dosari,0,50.0,0,0,1,0,1
Abdullah Mawei,0,59.0,0,0,1,0,1
Abdullah Omar,1,66.0,0,0,0,1,1
Abdullah Wabran,2,83.0,0,0,3,0,3
Abdullah Yousuf Ma'yoof,0,16.0,0,0,0,1,1
Abdulnaser Abbas,1,88.0,0,0,1,0,1
Abdulnasser Al-Obaidly,1,93.0,0,0,0,2,2
Abdulrahim Jumaa,0,19.0,0,0,1,0,1
Abdulrahman Al-Qahtani,1,45.0,0,0,1,0,1
Abdulrahman Fawzi,3,109.0,0,0,2,1,3
Abdulrahman Ibrahim,0,148.0,0,0,2,0,2
Abdulrahman Mohamed,0,78.0,0,0,1,0,1
Abdulrazaq Ibrahim Balooshi,2,320.0,0,1,6,0,6
Abdulsalaam Jumaa,0,49.0,0,0,0,1,1
Abdulsalam Al Ghurbani,0,170.0,0,0,2,1,3
Abdulwahab Al-Malood,0,153.0,0,0,1,1,2
Abdulwasea Al-Matari,1,37.0,0,0,1,1,2
Abdy Bäşimow,0,44.0,0,0,1,0,1
Abe Lenstra,0,106.0,0,0,3,0,3
Abedi Pele,6,411.0,0,0,3,5,8
Abedi Saïd,0,77.0,0,0,3,0,3
Abekah Ankrah,0,18.0,0,0,0,1,1
Abel Aguilar,3,261.0,0,0,3,2,5
Abel Balbo,4,249.0,0,0,2,3,5
Abel Hernández,5,246.0,0,1,6,0,6
Abel Lobatón,1,16.0,0,0,1,0,1
Abel Xavier,0,128.0,0,0,1,1,2
Abelardo Fernández,0,43.0,0,0,2,0,2
Abinesh Samy,2,145.0,0,0,2,0,2
Ablie Jallow,2,100.0,0,0,1,1,2
Abner Trigueros,1,176.0,0,0,1,1,2
Abou Diaby,0,20.0,0,0,0,1,1
Abou Seydou,0,89.0,0,0,1,0,1
Aboubacar Titi Camara,1,44.0,0,0,0,1,1
Aboubakar Kamara,0,22.0,0,0,1,0,1
Aboubakari Ouédraogo,1,74.0,0,0,0,1,1
Abraham Tedros,0,89.0,0,0,0,1,1
Abram Raselemane,1,35.0,0,0,0,1,1
Absalom Iimbondi,0,25.0,0,0,1,0,1
Abu Kamara,0,23.0,1,0,0,1,1
Abu Kanu,0,104.0,0,0,2,0,2
Abu Obeida Adam,0,82.0,0,0,1,0,1
Abuaagla Abdalla,0,53.0,1,0,1,0,1
Abubakar Al-Mass,0,74.0,0,0,1,0,1
Abubaker Bani,0,161.0,0,0,2,0,2
Abubaker Ben Brahim,0,53.0,0,0,1,0,1
Abubaker Tabula,0,77.0,0,0,1,0,1
Abubeker Nassir,0,86.0,0,0,0,1,1
Abukari Gariba,2,140.0,0,0,0,2,2
Abzal Beisebekov,0,62.0,1,0,0,1,1
Achille Emaná,2,239.0,0,0,2,3,5
Achraf Dari,1,9.0,0,0,0,1,1
Achraf Hakimi,2,326.0,0,0,4,1,5
Aco Stojkov,0,176.0,0,0,4,0,4
Ad-Diba,4,271.0,0,0,5,1,6
Adalbert Deşu,1,1.0,0,0,0,1,1
Adalberto Escobar,0,63.0,0,0,0,2,2
Adam Abdulativ,0,142.0,0,0,2,0,2
Adam Buksa,0,375.0,0,0,2,3,5
Adam El-Abd,0,4.0,1,0,0,1,1
Adam Gnezda Čerin,0,84.0,0,0,1,0,1
Adam Hložek,1,65.0,0,0,0,1,1
Adam Johnson,0,152.0,0,0,1,1,2
Adam Lallana,0,140.0,0,0,1,1,2
Adam Ledwoń,0,32.0,0,0,1,0,1
Adam Marušić,0,47.0,0,0,0,2,2
Adam Ndlovu,1,265.0,0,0,2,3,5
Adam Nemec,0,336.0,0,0,5,3,8
Adam Newton,0,88.0,0,0,0,1,1
Adam Ounas,3,166.0,0,0,1,2,3
Adam Taggart,0,44.0,0,0,0,3,3
Adama Coulibaly,0,32.0,0,0,1,0,1
Adama Diomande,0,77.0,0,0,1,0,1
Adama Guira,1,90.0,1,0,0,1,1
Adama Klofie Koné,1,2.0,0,0,1,0,1
Adama Traoré,5,173.0,0,0,5,0,5
Adane Girma,1,155.0,0,0,1,1,2
Adel Abbas Hussain,1,60.0,0,1,1,0,1
Adel Abdelrahman,1,75.0,0,0,0,1,1
Adel Abdulrahman Marzouq,1,1.0,0,0,1,0,1
Adel Al-Salimi,0,208.0,0,1,3,2,5
Adel Chedli,0,147.0,0,0,2,0,2
Adel Khamis,0,150.0,0,0,2,1,3
Adel Khamis Al Noobi,0,30.0,0,0,1,0,1
Adel Khudhair,1,63.0,0,0,1,0,1
Adel Malulla,0,90.0,0,0,1,0,1
Adel Mohamed Abdulla,0,75.0,0,0,0,2,2
Adel Mubarak Khamis,0,85.0,0,0,0,1,1
Adel Sellimi,2,429.0,0,3,3,5,8
Adel Taarabt,0,178.0,0,0,0,2,2
Adelaido Camaití,2,46.0,0,0,0,2,2
Adelardo Rodríguez,1,35.0,0,0,0,1,1
Adem Ljajić,0,233.0,0,0,2,1,3
Ademir de Menezes,6,930.0,0,0,20,2,22
Ademola Adeshina,1,118.0,0,0,1,1,2
Adhemar Canavesi,1,85.0,1,0,1,0,1
Adi Hütter,0,176.0,0,0,2,0,2
Adi Said,0,36.0,0,0,0,1,1
Adil Khan,0,88.0,0,0,1,0,1
Adis Jahović,0,149.0,0,1,1,1,2
Adisak Kraisorn,2,208.0,0,0,2,1,3
Admir Mehmedi,2,320.0,0,0,4,2,6
Admiral Muskwe,0,86.0,0,0,1,0,1
Adnan Ahmed Al-Sabbou,0,88.0,0,0,0,1,1
Adnan Al Talyani,6,908.0,0,0,13,5,18
Adnan Ali Deif,0,69.0,0,0,1,0,1
Adnan Dirjal,1,89.0,0,0,1,0,1
Adnan Januzaj,1,51.0,0,0,0,1,1
Adnan Kovačević,0,88.0,1,0,1,0,1
Adnan Ćustović,0,90.0,0,0,1,0,1
Ado Onaiwu,0,91.0,0,1,3,0,3
Adokiye Amiesimaka,1,120.0,0,0,1,1,2
Adolf Scherer,4,546.0,0,1,8,2,10
Adolf Urban,0,38.0,0,0,0,1,1
Adolfino Cañete,2,122.0,0,0,2,0,2
Adolfo Aldana,0,90.0,0,0,1,0,1
Adolfo Bautista,4,155.0,0,0,4,2,6
Adolfo Erico,1,38.0,0,1,1,0,1
Adolfo Magallanes,2,41.0,0,0,1,1,2
Adolfo Olivares,0,113.0,0,0,1,1,2
Adolfo Pedernera,1,98.0,0,0,3,0,3
Adolfo Valencia,2,391.0,0,0,3,3,6
Adolfo Zumelzú,2,163.0,0,0,4,0,4
Adolpho Millón Junior,0,77.0,0,0,1,0,1
Adoram Keisi,0,37.0,0,0,0,2,2
Adrian Aliaj,0,101.0,1,0,2,0,2
Adrian Alston,0,250.0,0,0,4,0,4
Adrian Bumbescu,0,70.0,0,0,1,0,1
Adrian Clifton,2,149.0,0,0,2,0,2
Adrian Elrick,0,81.0,0,0,1,0,1
Adrian Ilie,1,258.0,0,0,6,3,9
Adrian Knup,2,750.0,0,1,6,9,15
Adrian Kunz,0,90.0,0,0,1,0,1
Adrian Madaschi,0,56.0,0,0,2,0,2
Adrian Mariappa,0,166.0,1,0,2,0,2
Adrian Mierzejewski,0,130.0,0,0,0,2,2
Adrian Mutu,1,1047.0,0,5,17,7,24
Adrian Popa,0,95.0,0,0,1,1,2
Adrian Popescu,0,31.0,0,0,0,1,1
Adrian Rus,0,45.0,1,0,1,0,1
Adrian Serioux,0,4.0,0,0,1,0,1
Adriano,14,815.0,0,0,10,7,17
Adriano Leite Ribeiro,0,293.0,0,0,5,1,6
Adriano Samaniego,1,73.0,0,0,0,1,1
Adrien Rabiot,1,102.0,0,0,2,0,2
Adrien Silva,1,104.0,0,1,1,0,1
Adrián Escudero,1,78.0,0,0,0,1,1
Adrián Ramos,1,105.0,0,0,1,1,2
Adrián Romero,0,49.0,0,0,1,0,1
Ady Schmit,0,285.0,0,0,3,2,5
Ady Williams,0,59.0,0,0,0,1,1
Adékambi Olufadé,2,160.0,0,0,2,2,4
Afonso Guimarães da Silva,1,30.0,0,0,1,0,1
Afran Ismayilov,0,132.0,0,1,3,0,3
Aftandil Hacıyev,0,16.0,1,0,1,0,1
Agent Sawu,0,306.0,0,0,4,3,7
Agim Ibraimi,0,103.0,0,2,2,1,3
Agne Simonsson,0,419.0,0,0,7,1,8
Agung Setyabudi,0,7.0,0,0,1,0,1
Agustin Kola,0,138.0,1,0,1,1,2
Agustín Delgado,7,1106.0,0,0,15,8,23
Agustín Garcia,1,80.0,0,0,1,0,1
Agustín Gaínza,0,130.0,0,0,1,1,2
Agustín Lizarbe,1,81.0,0,0,1,0,1
Agustín Zelada,1,49.0,0,0,0,1,1
Agustín Álvarez,0,47.0,0,0,1,0,1
Ahmad Abu Nahyeh,3,141.0,0,0,3,0,3
Ahmad Ajab,0,254.0,0,0,6,0,6
Ahmad Al Saleh,1,90.0,0,0,1,0,1
Ahmad Al-Bashir,1,44.0,0,0,0,1,1
Ahmad Che Zambil,0,2.0,0,0,1,0,1
Ahmad Elrich,0,250.0,0,0,2,1,3
Ahmad Ersan,0,103.0,0,0,2,0,2
Ahmad Hayel,0,333.0,0,0,6,1,7
Ahmad Ibrahim Khalaf,0,125.0,1,0,1,1,2
Ahmad Kadhim,0,228.0,0,0,3,0,3
Ahmad Kallasi,1,57.0,0,0,1,0,1
Ahmad Khalifa Hashim,0,154.0,0,0,1,1,2
Ahmad Mnajed,2,135.0,0,0,2,0,2
Ahmad Nourollahi,1,120.0,0,0,1,2,3
Ahmad Salah Alwan,0,57.0,0,0,0,1,1
Ahmed Aadil,1,4.0,0,0,0,1,1
Ahmed Abdel Baki,0,80.0,0,0,0,1,1
Ahmed Abdul Karim Al-Brid,2,111.0,0,0,0,2,2
Ahmed Abdul Maqsoud,0,90.0,0,0,0,1,1
Ahmed Abou El Fotouh,0,39.0,0,0,0,1,1
Ahmed Abou Rehab,1,34.0,0,0,1,0,1
Ahmed Abouali,1,58.0,0,0,1,0,1
Ahmed Akaïchi,2,221.0,0,0,0,4,4
Ahmed Al Hashmi,0,87.0,0,0,1,0,1
Ahmed Al Masli,0,186.0,0,0,4,1,5
Ahmed Al Nifawi,1,10.0,0,0,1,0,1
Ahmed Al-Fraidi,0,153.0,0,0,1,1,2
Ahmed Al-Mousa,2,93.0,0,0,2,0,2
Ahmed Al-Sarori,1,173.0,0,0,1,1,2
Ahmed Al-Tash,1,64.0,0,0,0,1,1
Ahmed Awad,0,77.0,0,0,1,0,1
Ahmed Bahja,1,89.0,0,1,1,3,4
Ahmed Bareed,1,77.0,0,0,1,0,1
Ahmed Belal,1,25.0,0,0,0,1,1
Ahmed Ben Soed,0,90.0,0,0,0,1,1
Ahmed Bushara Wahba,1,128.0,0,0,1,1,2
Ahmed Chombi,1,114.0,0,0,0,2,2
Ahmed Daham,1,90.0,0,0,1,0,1
Ahmed Daher,0,23.0,0,0,0,1,1
Ahmed Eid Abdel Malek,0,216.0,0,0,2,1,3
Ahmed El-Kass,2,223.0,0,0,3,2,5
Ahmed Elmohamady,1,77.0,0,0,3,0,3
Ahmed Faras,6,534.0,0,0,10,2,12
Ahmed Faris Al-Binali,0,3.0,1,0,1,0,1
Ahmed Fathy,1,59.0,1,0,1,1,2
Ahmed H. Saeed,0,14.0,0,0,1,0,1
Ahmed Hadid Al-Mukhaini,0,39.0,0,0,1,0,1
Ahmed Hassan,7,1070.0,0,2,11,8,19
Ahmed Hassan Mahgoub,0,76.0,0,0,2,0,2
Ahmed Issa Al-Mohannadi,0,52.0,0,0,1,0,1
Ahmed Jamil Madani,2,227.0,0,0,1,2,3
Ahmed Keshkesh,1,82.0,0,0,1,0,1
Ahmed Khalil,4,1226.0,0,5,17,6,23
Ahmed Limane,0,34.0,0,0,1,0,1
Ahmed Makrouh,1,86.0,0,0,0,1,1
Ahmed Mogni,2,147.0,0,0,0,2,2
Ahmed Mohammed Al-Mahri,0,40.0,0,0,1,0,1
Ahmed Mubarak Al-Mahaijri,1,392.0,0,1,6,3,9
Ahmed Musa,6,405.0,0,1,4,3,7
Ahmed Nashid,0,11.0,0,0,0,1,1
Ahmed Niyaz,0,87.0,0,0,1,0,1
Ahmed Osman,0,74.0,0,0,1,0,1
Ahmed Ouattara,2,230.0,0,0,2,1,3
Ahmed Radhi,10,845.0,0,0,13,5,18
Ahmed Rahim,0,90.0,0,0,1,0,1
Ahmed Saad Osman,3,354.0,0,0,5,1,6
Ahmed Salah Hosny,1,30.0,0,0,1,0,1
Ahmed Samir,0,127.0,0,1,1,1,2
Ahmed Sidibe,0,10.0,0,0,1,0,1
Ahmed Thoriq,0,181.0,0,0,3,0,3
Ahmed Touba,0,118.0,0,0,1,0,1
Ahmed Waseem Razeek,2,71.0,0,1,0,2,2
Ahmed Yasin Ghani,4,300.0,0,0,3,1,4
Ahmed Zuway,1,22.0,0,0,1,1,2
Ahmet Ataýew,1,79.0,0,1,0,1,1
Ahn Jung-hwan,3,461.0,0,0,5,1,6
Aias Aosman,1,83.0,0,1,0,2,2
Aibek Bokoev,0,76.0,0,0,1,0,1
Aidas Preikšaitis,0,88.0,0,0,1,0,1
Aiden McGeady,0,136.0,0,0,1,3,4
Aidil Zafuan,0,54.0,0,0,1,0,1
Ainārs Linards,0,114.0,0,0,2,1,3
Ajdin Hrustic,1,220.0,0,0,0,3,3
Akaki Khubutia,0,28.0,1,0,1,0,1
Akbar Eftekhari,0,111.0,0,0,2,0,2
Akbar Kargarjam,0,85.0,0,0,1,0,1
Akhlidin Israilov,1,42.0,0,0,0,1,1
Akhtam Khamrakulov,0,61.0,0,0,1,0,1
Akhtam Nazarov,0,122.0,0,2,1,1,2
Akhyar Rashid,0,144.0,0,0,2,0,2
Aki Heiskanen,0,133.0,0,0,1,2,3
Aki Hyryläinen,0,139.0,0,0,0,2,2
Aki Lahtinen,0,40.0,1,0,1,0,1
Aki Riihilahti,0,246.0,0,0,3,2,5
Akie Noah,0,58.0,0,0,1,0,1
Akihiro Nishimura,0,116.0,0,0,2,0,2
Akinori Nishizawa,5,327.0,0,0,7,1,8
Akira Kaji,0,28.0,0,0,1,0,1
Akmal Kholmatov,0,50.0,0,0,1,1,2
Akmal Rizal Ahmad Rakhli,2,208.0,0,1,2,2,4
Akmal Shorakhmedov,0,43.0,1,0,1,0,1
Akram Afif,4,509.0,0,2,7,3,10
Akram Al-Selwi,0,73.0,0,0,1,0,1
Akram Emmanuel,0,47.0,0,0,0,1,1
Akram Moghrabi,0,52.0,0,0,1,0,1
Akram Tawfik,0,59.0,0,0,0,1,1
Akram Zuway,0,88.0,0,0,0,1,1
Akuetteh Armah,0,35.0,0,1,1,0,1
Akwá,0,807.0,0,0,11,3,14
Al Hasan Al-Yami,0,59.0,0,0,1,0,1
Al Zerhusen,0,84.0,0,0,1,0,1
Ala Al-Sasi,1,69.0,0,0,1,0,1
Ala'a Eldin Yousif,0,45.0,0,0,1,0,1
Alaa Abbas,2,180.0,0,0,1,1,2
Alaa Abdul-Zahra,1,186.0,0,0,2,1,3
Alaa Al Dali,1,17.0,0,0,1,1,2
Alaa El-Hamouly,0,32.0,0,0,0,1,1
Alaa Kadhim,8,317.0,0,0,1,7,8
Alaa Mayhoub,0,7.0,0,0,1,0,1
Alagame Seck,0,109.0,0,0,2,0,2
Alain Boghossian,0,81.0,0,0,0,1,1
Alain Cervantes,1,135.0,0,0,0,2,2
Alain Couriol,1,72.0,0,0,0,1,1
Alain Geiger,0,162.0,1,0,1,1,2
Alain Giresse,3,280.0,0,0,4,1,5
Alain Masudi,1,35.0,0,0,1,0,1
Alain N'Kong,0,72.0,0,0,0,1,1
Alain Nana,0,73.0,0,0,1,0,1
Alain Nurenberg,0,37.0,0,0,1,0,1
Alain Rakotondramanana,0,23.0,0,0,0,1,1
Alain Roche,0,89.0,0,0,0,1,1
Alain Sutter,1,53.0,0,0,1,3,4
Alain Traoré,5,549.0,0,0,6,2,8
Alaixys Romao,0,21.0,1,0,0,1,1
Alan Ball Jr.,0,90.0,0,1,0,1,1
Alan Browne,0,18.0,0,0,0,1,1
Alan Carvalho,1,238.0,0,0,3,0,3
Alan Curtis,0,138.0,0,0,1,1,2
Alan Durban,0,67.0,0,0,1,1,2
Alan Dzagoev,2,365.0,0,0,4,4,8
Alan Edward Davidson,0,33.0,0,0,1,0,1
Alan Gilzean,0,183.0,0,0,2,3,5
Alan Kernaghan,0,25.0,0,0,1,0,1
Alan Marley,0,270.0,0,0,3,0,3
Alan McDonald,1,119.0,1,0,1,2,3
Alan McLoughlin,0,86.0,0,0,0,2,2
Alan Mullery,1,31.0,0,0,1,0,1
Alan Shearer,4,679.0,0,5,15,6,21
Alan Smith,0,21.0,0,0,1,0,1
Alan Vest,1,264.0,0,0,2,2,4
Alassane Ouédraogo,1,96.0,0,0,1,1,2
Alban Bushi,0,333.0,0,0,4,2,6
Albeiro Usuriaga,0,73.0,0,0,1,0,1
Albert Bell,0,90.0,0,0,1,0,1
Albert Brülls,1,141.0,0,0,2,2,4
Albert Bwalya,0,67.0,0,0,0,1,1
Albert Cluytens,0,13.0,0,0,0,1,1
Albert Emon,0,62.0,0,0,1,0,1
Albert Gemmrich,0,79.0,0,0,0,1,1
Albert Guðmundsson,0,176.0,0,2,2,1,3
Albert Luque,0,128.0,0,0,2,0,2
Albert Meyong,2,310.0,0,0,4,0,4
Albert Mpinganjira,0,71.0,0,0,1,0,1
Albert Nađ,0,77.0,0,0,0,2,2
Albert Niyonkuru,0,89.0,0,1,0,1,1
Albert Onyeanwuna,1,89.0,0,0,0,1,1
Albert Riera,0,179.0,0,0,0,2,2
Albert Rusnák,0,107.0,0,0,1,2,3
Albert Sarkisyan,0,157.0,0,2,1,2,3
Alberth Elis,0,255.0,0,0,2,4,6
Alberto Acosta,1,81.0,0,0,1,0,1
Alberto Aquilani,0,127.0,0,0,2,1,3
Alberto Bica,0,4.0,0,0,1,0,1
Alberto Blanco,0,89.0,0,0,0,1,1
Alberto Carvalhal,0,172.0,0,0,1,1,2
Alberto Doesburg,0,80.0,0,0,1,0,1
Alberto Fonseca,0,118.0,0,0,1,1,2
Alberto Fouilloux,0,164.0,0,0,3,0,3
Alberto Galateo,1,48.0,0,0,1,0,1
Alberto Gallardo,5,347.0,0,0,1,6,7
Alberto García Aspe,5,411.0,0,5,5,5,10
Alberto Gilardino,1,601.0,0,0,8,2,10
Alberto Gómez,0,37.0,0,0,1,0,1
Alberto Górriz,1,38.0,0,0,0,1,1
Alberto Jiménez,0,94.0,0,0,2,0,2
Alberto Marcovecchio,0,148.0,0,0,2,0,2
Alberto Medina,1,19.0,0,0,1,0,1
Alberto Montaño,0,51.0,0,0,1,0,1
Alberto Montellanos,0,48.0,0,0,2,0,2
Alberto Ohaco,2,191.0,0,2,4,0,4
Alberto Orlando,0,171.0,0,0,4,0,4
Alberto Quintero,2,202.0,0,0,4,0,4
Alberto Rendo,0,89.0,0,0,1,0,1
Alberto Santelli,0,74.0,0,0,0,1,1
Alberto Spencer,0,148.0,0,0,3,1,4
Alberto Tarantini,0,43.0,0,0,1,0,1
Alberto Terry,1,308.0,0,1,7,1,8
Alberto Valencia,1,37.0,0,0,0,1,1
Alberto Zozaya,0,313.0,0,0,5,0,5
Albino Rodríguez,1,75.0,0,0,1,0,1
Alcides Ghiggia,3,234.0,0,0,0,4,4
Alcides Peña,0,9.0,0,0,1,0,1
Alcides Silveira,2,65.0,0,3,0,3,3
Alcides Sosa,0,53.0,0,0,0,1,1
Aldair,2,60.0,0,0,1,1,2
Alderman Lesmond,0,7.0,0,0,1,0,1
Aldo Donelli,4,278.0,0,0,0,5,5
Aldo Junior Simoncini,0,26.0,1,0,1,0,1
Aldo Serena,0,155.0,0,0,1,2,3
Aldo de Nigris,4,312.0,0,0,2,3,5
Alejandrino Genés,4,212.0,0,0,2,3,5
Alejandro Alpízar,0,133.0,0,0,1,1,2
Alejandro Carrillo,1,83.0,0,0,0,1,1
Alejandro Chumacero,0,113.0,0,0,2,0,2
Alejandro Cichero,0,50.0,1,0,2,0,2
Alejandro Guerra,0,81.0,0,0,1,0,1
Alejandro Hisis,0,49.0,0,0,2,0,2
Alejandro Luces,0,63.0,0,0,1,0,1
Alejandro Madrigal,0,48.0,0,0,0,1,1
Alejandro Moreno,0,56.0,0,0,1,0,1
Alejandro Romero Gamarra,1,180.0,0,0,3,0,3
Alejandro Scopelli,1,115.0,0,0,3,0,3
Alejandro Villanueva,1,61.0,0,0,1,1,2
Alekos Alexandris,0,54.0,0,0,0,1,1
Alekos Alexiadis,0,125.0,0,0,2,0,2
Aleksandar Dragović,0,30.0,0,0,1,0,1
Aleksandar Kolarov,1,410.0,0,1,3,5,8
Aleksandar Luković,0,90.0,1,0,0,1,1
Aleksandar Mitrović,3,1383.0,0,0,18,10,28
Aleksandar Petaković,2,89.0,0,0,1,2,3
Aleksandar Prijović,0,74.0,0,0,1,0,1
Aleksandar Radosavljević,0,39.0,0,0,1,0,1
Aleksandar Tirnanić,1,21.0,0,0,0,1,1
Aleksandar Tonev,0,202.0,0,0,4,0,4
Aleksandar Trajkovski,0,602.0,0,1,7,4,11
Aleksandar Trifunović,0,79.0,0,0,0,1,1
Aleksandar Tunchev,0,26.0,0,0,0,1,1
Aleksandar Vasoski,0,70.0,0,0,0,1,1
Aleksandar Đurić,0,213.0,0,0,6,1,7
Aleksandar Šofranac,0,66.0,1,0,1,0,1
Aleksander Knavs,0,110.0,0,0,1,2,3
Aleksander Rodić,0,44.0,0,0,1,0,1
Aleksandr Amisulashvili,0,13.0,0,0,1,0,1
Aleksandr Borodiuk,0,89.0,0,0,0,1,1
Aleksandr Golovin,0,263.0,0,0,2,1,3
Aleksandr Gorshkov,0,118.0,0,0,2,0,2
Aleksandr Iashvili,0,499.0,0,1,7,5,12
Aleksandr Ivanov,1,56.0,0,0,0,1,1
Aleksandr Kerzhakov,1,828.0,0,0,12,9,21
Aleksandr Khapsalis,0,28.0,0,0,0,1,1
Aleksandr Kokorin,1,200.0,0,2,4,4,8
Aleksandr Kuchma,0,150.0,1,0,2,0,2
Aleksandr Merzlikin,2,38.0,0,0,1,1,2
Aleksandr Mostovoi,1,287.0,0,1,5,2,7
Aleksandr Panov,0,115.0,0,0,0,2,2
Aleksandr Samedov,0,124.0,0,0,2,1,3
Aleksandr Shadrin,0,53.0,0,0,0,1,1
Aleksandr Shirko,0,88.0,0,0,0,1,1
Aleksandr Sobolev,0,90.0,0,0,0,1,1
Aleksandr Yerokhin,0,97.0,0,0,2,1,3
Aleksandre Chivadze,2,63.0,0,0,2,0,2
Aleksandre Karapetian,0,37.0,0,0,2,1,3
Aleksandrs Cauņa,0,464.0,0,2,5,4,9
Aleksandrs Jeļisejevs,0,89.0,0,0,0,2,2
Aleksei Ionov,0,94.0,0,0,1,1,2
Aleksei Mamykin,1,56.0,0,0,1,1,2
Aleksei Miranchuk,0,94.0,0,0,1,1,2
Aleksei Sutormin,0,62.0,0,0,1,0,1
Aleksejs Višņakovs,0,273.0,0,0,3,2,5
Aleksey Dionisiev,0,21.0,0,0,1,0,1
Aleksey Shchotkin,0,28.0,0,0,0,2,2
Alen Bokšić,2,366.0,0,0,4,4,8
Alessandro Altobelli,6,609.0,0,2,9,5,14
Alessandro Costacurta,0,19.0,0,0,0,1,1
Alessandro Del Piero,2,1047.0,0,3,11,6,17
Alessandro Della Valle,0,112.0,2,0,2,1,3
Alessandro Diamanti,1,73.0,0,0,0,1,1
Alessandro Florenzi,0,97.0,0,0,2,0,2
Alessandro Frigerio,0,76.0,0,0,0,1,1
Alessandro Schöpf,1,60.0,0,0,0,1,1
Alessio Romagnoli,0,149.0,0,0,1,1,2
"Alex ""Didí"" Valverde",0,53.0,0,0,1,0,1
Alex Brosque,0,204.0,0,0,3,0,3
Alex Bunbury,1,458.0,0,0,9,3,12
Alex Chola,0,32.0,0,0,2,0,2
Alex Greive,2,53.0,0,0,2,0,2
Alex Iwobi,1,172.0,0,0,2,1,3
Alex Král,0,71.0,0,0,1,0,1
Alex Moucketou-Moussounda,0,84.0,0,0,1,0,1
Alex Nyarko,1,8.0,0,0,1,0,1
Alex Oxlade-Chamberlain,0,249.0,0,0,2,3,5
Alex Pineda Chacón,1,100.0,0,0,2,1,3
Alex Roldan,1,171.0,0,0,2,0,2
Alex Sandro,0,12.0,0,0,1,0,1
Alex Scott,0,70.0,0,0,1,0,1
Alex Tobin,0,59.0,1,0,1,0,1
Alex Valderrama,0,75.0,0,0,1,1,2
Alex Young,0,20.0,0,0,0,2,2
Alexander Cruzata,0,94.0,1,0,1,1,2
Alexander Djiku,1,77.0,0,0,1,0,1
Alexander Frei,2,997.0,0,2,13,11,24
Alexander Gerndt,0,88.0,0,0,0,1,1
Alexander Geynrikh,7,803.0,0,1,11,5,16
Alexander Hleb,0,48.0,0,0,0,1,1
Alexander Horváth,0,116.0,0,0,2,0,2
Alexander Isak,0,280.0,0,0,4,3,7
Alexander Kačaniklić,0,107.0,0,0,1,1,2
Alexander Khatskevich,0,81.0,0,0,3,0,3
Alexander Kobakhidze,0,71.0,0,0,0,1,1
Alexander Larín,0,36.0,0,1,1,1,2
Alexander Linwood,0,78.0,0,0,1,0,1
Alexander López,1,108.0,0,1,0,3,3
Alexander Riley,0,8.0,1,0,1,0,1
Alexander Ring,0,8.0,0,0,1,0,1
Alexander Rondón,0,197.0,0,0,3,0,3
Alexander Satariano,0,20.0,0,0,0,1,1
Alexander Saununu,0,2.0,0,0,0,1,1
Alexander Søderlund,0,107.0,0,1,2,0,2
Alexander Sørloth,0,416.0,0,0,3,4,7
Alexander Tettey,0,122.0,0,0,1,2,3
Alexander Viveros,0,27.0,0,0,1,0,1
Alexander Ødegaard,0,89.0,0,0,1,0,1
Alexandr Korzanov,1,4.0,0,0,1,0,1
Alexandre Alphonse,1,64.0,0,0,1,0,1
Alexandre Boucicaut,1,71.0,0,0,1,0,1
Alexandre Czerniatynski,1,183.0,0,0,2,1,3
Alexandre Martínez Palau,0,90.0,0,0,1,0,1
Alexandre Pato,2,89.0,0,0,2,0,2
Alexandre Rey,0,144.0,0,0,3,1,4
Alexandros Garpozis,0,16.0,0,0,1,0,1
Alexandros Tziolis,0,26.0,0,0,0,1,1
Alexandru Antoniuc,0,117.0,0,0,0,2,2
Alexandru Badea,0,43.0,0,0,1,0,1
Alexandru Chipciu,0,184.0,0,0,0,3,3
Alexandru Cicâldău,0,134.0,0,0,0,2,2
Alexandru Curtianu,0,22.0,0,0,2,0,2
Alexandru Dedov,0,63.0,0,1,2,0,2
Alexandru Ene,0,175.0,0,0,2,1,3
Alexandru Epureanu,0,237.0,0,0,1,2,3
Alexandru Gațcan,0,154.0,0,0,0,2,2
Alexandru Guzun,0,6.0,0,0,1,0,1
Alexandru Maxim,0,326.0,0,1,2,2,4
Alexandru Mitriță,0,171.0,0,0,2,1,3
Alexandru Neagu,2,167.0,0,0,1,2,3
Alexandru Suvorov,0,384.0,0,0,2,3,5
Alexei Eremenko,0,482.0,0,0,6,4,10
Alexei Klishin,0,73.0,0,0,0,2,2
Alexei Kosolapov,0,38.0,0,0,1,0,1
Alexei Rios,0,47.0,0,0,0,1,1
Alexi Lalas,2,97.0,0,0,2,1,3
Alexis Alexandris,0,235.0,0,0,1,3,4
Alexis Mac Allister,1,46.0,0,0,0,1,1
Alexis Mendoza,0,66.0,0,0,1,0,1
Alexis Saddler,0,141.0,0,1,3,0,3
Alexis Saelemaekers,0,65.0,0,0,1,0,1
Alexis Sánchez,8,1392.0,0,0,14,16,30
Alexis Tumahai,1,90.0,0,0,0,1,1
Alexis Vega,1,207.0,0,0,2,1,3
Alexsandro de Souza,8,521.0,0,1,8,1,9
Alf Martinsen,1,127.0,0,0,1,1,2
Alf Ringstead,0,3.0,0,0,1,0,1
Alfa Potowabawi,0,29.0,0,0,0,1,1
Alfaz Ahmed,3,191.0,0,0,0,3,3
Alfonso Cañón,0,72.0,0,0,0,1,1
Alfonso Domínguez,2,148.0,1,0,2,2,4
Alfonso Pérez,3,652.0,0,0,5,5,10
Alfonso Rodríguez Salas,0,21.0,0,0,0,1,1
Alfonso Yáñez,1,35.0,0,1,0,1,1
Alfred Aston,0,3.0,0,0,0,1,1
Alfred Bickel,1,64.0,0,0,0,1,1
Alfred Effiong,0,85.0,0,0,2,0,2
Alfred Heiß,0,30.0,0,0,0,1,1
Alfred Körner,1,131.0,0,0,1,2,3
Alfred Pfaff,1,25.0,0,0,1,0,1
Alfred Scheiwiler,0,29.0,0,0,1,0,1
Alfred Wabealo,2,134.0,0,0,0,2,2
Alfredo Carricaberry,2,94.0,0,0,2,1,3
Alfredo Di Stéfano,6,624.0,0,0,8,5,13
Alfredo Esteves,1,35.0,1,0,0,1,1
Alfredo France,1,33.0,0,0,0,1,1
Alfredo Garasini,0,72.0,0,0,1,0,1
Alfredo Hernández,0,140.0,0,0,0,3,3
Alfredo Megido,0,67.0,0,0,1,0,1
Alfredo Mejía,1,90.0,0,0,0,1,1
Alfredo Mendoza,2,320.0,0,0,3,4,7
Alfredo Mosquera,3,120.0,0,0,1,2,3
Alfredo Pacheco,1,179.0,0,1,1,3,4
Alfredo Pérez,1,81.0,0,0,0,1,1
Alfredo Quaresma,0,48.0,0,0,1,0,1
Alfredo Torres,0,149.0,0,0,2,0,2
Alfredo del Águila,1,29.0,0,0,0,1,1
Alfredo dos Santos,0,3.0,0,0,1,0,1
Alfreð Finnbogason,1,270.0,0,1,4,2,6
Alhaji Kamara,2,160.0,0,0,1,1,2
Alhassan Kamara,0,142.0,0,0,1,1,2
Alhassane Bangoura,0,88.0,0,0,1,0,1
Alhassane Issoufou,0,153.0,0,0,2,0,2
Ali Abo Greisha,3,260.0,0,0,6,1,7
Ali Aboud Awad,0,82.0,0,0,0,1,1
Ali Adnan Kadhim,4,323.0,0,2,5,0,5
Ali Afif,0,53.0,0,1,0,1,1
Ali Al Saadi,0,93.0,0,0,3,0,3
Ali Al-Beshari,0,247.0,0,0,4,0,4
Ali Al-Hadyah,0,120.0,0,0,2,0,2
Ali Al-Hassan,0,52.0,0,0,1,0,1
Ali Al-Nono,0,428.0,0,0,4,3,7
Ali Al-Wehaibi,0,110.0,0,0,1,1,2
Ali Asel,1,61.0,0,0,0,1,1
Ali Asghar Modir Roosta,0,404.0,0,0,6,1,7
Ali Ashfaq,1,860.0,0,2,10,4,14
Ali Assadalla,1,164.0,0,0,3,1,4
Ali Bala,1,75.0,0,0,0,1,1
Ali Cheikh Dib,2,148.0,0,1,1,2,3
Ali Daei,23,2776.0,0,8,26,23,49
Ali Diab,1,30.0,1,0,1,0,1
Ali Djabari,0,74.0,0,0,1,0,1
Ali Elkhattabi,1,40.0,0,0,1,0,1
Ali Elmusrati,1,68.0,0,0,1,0,1
Ali Faez,1,24.0,1,0,0,1,1
Ali Fasir,1,25.0,0,0,0,1,1
Ali Fergani,1,125.0,0,0,3,0,3
Ali Gagarin,3,225.0,0,1,4,2,6
Ali Gerba,6,611.0,0,0,8,4,12
Ali Gholizadeh,2,202.0,0,0,1,2,3
Ali Hamam,0,68.0,1,0,1,1,2
Ali Hosni,1,59.0,0,0,1,0,1
Ali Jabbari,1,391.0,0,0,2,3,5
Ali Kaabi,2,191.0,0,0,1,2,3
Ali Kadhim,2,46.0,0,0,2,0,2
Ali Karimi,5,659.0,0,0,8,5,13
Ali Khalil,0,106.0,0,0,3,0,3
Ali Mabkhout,6,1530.0,0,5,23,9,32
Ali Madan,0,111.0,0,0,2,0,2
Ali Maher,1,133.0,0,0,3,1,4
Ali Maqseed,1,12.0,0,0,1,0,1
Ali Marwi,6,217.0,0,0,2,4,6
Ali Maâloul,0,43.0,0,0,1,0,1
Ali Meçabih,2,176.0,0,0,2,2,4
Ali Mohammed Al-Saadah,0,90.0,0,0,1,0,1
Ali Momin,0,50.0,1,0,0,1,1
Ali Mousavi,1,82.0,0,0,0,1,1
Ali Nasseredine,0,183.0,0,0,2,2,4
Ali Parvin,0,163.0,0,0,2,1,3
Ali Saad,1,31.0,0,0,1,0,1
Ali Salama,0,27.0,0,0,1,0,1
Ali Salmeen,0,32.0,0,0,1,0,1
Ali Samooh,0,23.0,0,0,1,0,1
Ali Sharafat,0,81.0,0,0,1,0,1
Ali Shiham,0,68.0,0,0,1,0,1
Ali Sulieman,0,65.0,0,0,1,0,1
Ali Sylla,0,11.0,0,0,0,1,1
Ali Thani Jumaa,2,43.0,0,0,0,2,2
Ali Umar,0,200.0,0,0,3,0,3
Ali Zaid,1,47.0,0,0,1,0,1
Ali Zitouni,2,449.0,0,0,4,4,8
Ali'i Mitchell,1,57.0,0,0,1,0,1
Aliaksandr Kulchiy,0,49.0,0,0,0,1,1
Alicio Solalinde,0,77.0,0,0,0,1,1
Alick Maemae,0,208.0,0,0,3,0,3
Alick Saurei,1,90.0,0,0,0,1,1
Alier Ashurmamadov,2,94.0,0,0,2,1,3
Alimardon Shukurov,1,136.0,0,0,2,1,3
Alin Toșca,0,11.0,0,0,1,0,1
Alireza Azizi,0,90.0,0,0,2,0,2
Alireza Jahanbakhsh,3,423.0,0,1,6,2,8
Alireza Khorshidi,0,145.0,0,0,2,0,2
Alireza Mansourian,0,91.0,0,0,4,0,4
Alireza Vahedi Nikbakht,0,153.0,0,0,3,2,5
Alirou Rachidou,0,87.0,0,0,1,0,1
Alisher Dzhalilov,0,91.0,0,0,2,0,2
Alistair Johnston,1,44.0,0,0,0,1,1
Alivate Driu,0,1.0,0,0,0,1,1
Aljaž Struna,0,35.0,0,0,1,0,1
Alkhaly Bangoura,0,90.0,0,0,1,0,1
Allan Boath,0,19.0,0,0,1,0,1
Allan Brown,0,26.0,0,0,2,0,2
Allan Clarke,1,159.0,0,3,2,1,3
Allan Cruz,1,75.0,0,0,1,0,1
Allan Hansen,0,156.0,0,1,2,0,2
Allan Hunter,0,32.0,0,0,1,0,1
Allan Johnston,0,100.0,0,0,0,2,2
Allan Mørkøre,0,21.0,0,0,0,1,1
Allan Nielsen,2,317.0,0,0,3,4,7
Allan Oviedo,0,145.0,0,0,1,1,2
Allan Simonsen,0,433.0,0,3,6,3,9
Allan Wanga,0,77.0,0,0,1,0,1
Allean Richard Grant Velasquez,0,87.0,0,0,0,1,1
Allianni Urgelles,0,90.0,0,0,1,0,1
Alloysius Atuegbu,0,65.0,0,0,2,0,2
Ally Abubakari,0,54.0,0,0,0,1,1
Ally McCoist,1,604.0,0,0,10,3,13
Almazbek Mirzaliev,0,90.0,0,0,1,0,1
Almedin Hota,0,89.0,0,0,0,1,1
Almir Da Silva,0,28.0,0,0,0,1,1
Almiro Lobo,1,143.0,0,1,2,1,3
Almoez Ali,13,898.0,0,2,10,10,20
Alon Hazan,0,64.0,0,0,1,0,1
Alon Mizrahi,0,225.0,0,0,5,1,6
Alonso Botero,1,72.0,0,0,1,1,2
Alonso Solís,0,188.0,0,0,1,2,3
Aloísio,0,46.0,0,0,0,1,1
Alpaslan Eratlı,0,54.0,0,0,0,1,1
Alpay Özalan,0,176.0,0,0,3,0,3
Alphonse Leweck,0,232.0,0,0,1,2,3
Alphonse Tchami,3,374.0,0,0,6,5,11
Alphonso Davies,8,455.0,0,1,2,7,9
Alphonsus Brown,0,66.0,0,0,1,0,1
Alphose Qorig,3,163.0,0,1,0,3,3
Alsény Diaby,0,14.0,0,0,1,0,1
Altin Haxhi,1,122.0,0,0,2,0,2
Altin Lala,0,101.0,0,0,1,1,2
Altin Rraklli,0,304.0,0,0,5,1,6
Altino Marcondes,0,9.0,0,0,1,0,1
Altymyrat Annadurdyýew,2,252.0,0,0,2,2,4
Aluísio Francisco da Luz,0,47.0,0,0,0,1,1
Alvaro José Rodrigues Valente,1,10.0,0,0,1,0,1
Alvin Ceccoli,0,42.0,0,0,1,0,1
Alvin Corneal,0,28.0,0,0,1,0,1
Alvin Jones,0,37.0,0,0,1,0,1
Alvin Kieh,0,85.0,0,0,1,0,1
Alvin Tehau,6,265.0,0,0,3,4,7
Alvin Thomas,1,89.0,0,0,1,0,1
Alwin Hou,3,144.0,0,0,2,1,3
Alwin Komolong,1,24.0,0,0,0,1,1
Alwyn Guy,0,248.0,0,0,5,1,6
Alyaksandr Martynovich,0,82.0,1,0,0,1,1
Alyaksandr Taykow,0,57.0,0,0,1,0,1
Amad Al-Hosni,3,423.0,0,1,8,2,10
Amad Ali,0,94.0,0,0,0,2,2
Amadeo Ortega,2,88.0,0,0,2,0,2
Amado Guevara,5,871.0,0,4,10,5,15
Amadou Haidara,1,37.0,0,0,0,1,1
Amadou Pathé Diallo,1,46.0,0,0,0,1,1
Amadou Sabo,1,68.0,0,0,0,1,1
Amadou Touré,0,107.0,0,0,0,2,2
Amancio Amaro,1,436.0,0,0,9,0,9
Amani Habimana,0,78.0,0,0,1,0,1
Amar Ramadan,0,45.0,0,0,0,1,1
Amara Simba,0,41.0,0,0,1,0,1
Amara Touré,0,115.0,0,0,1,1,2
Amarildo Tavares da Silveira,3,175.0,0,0,3,0,3
Amaro,1,75.0,0,0,0,1,1
Ambroise Oyongo,1,84.0,0,0,0,1,1
Amby Fogarty,0,164.0,0,0,2,1,3
Amer Deeb,0,271.0,0,0,5,0,5
Amer Gojak,0,205.0,0,0,2,2,4
Amer Mushraf,1,54.0,0,0,1,0,1
Amido Baldé,0,62.0,0,0,0,1,1
Amilcar Ramos,0,36.0,0,0,1,0,1
Amin Dabo,0,82.0,0,0,1,0,1
Amin Younes,1,128.0,0,0,2,0,2
Amine Chermiti,1,1.0,0,0,0,1,1
Amir Abrashi,0,90.0,0,0,0,1,1
Amir Al-Ammari,1,86.0,0,1,1,0,1
Amir Kamal,1,88.0,0,0,0,1,1
Amir Rrahmani,1,108.0,0,0,2,1,3
Amir Waithe,0,115.0,0,0,0,2,2
Amit Ben-Shushan,1,95.0,0,0,1,1,2
Amjad Al-Harthi,1,75.0,0,0,0,1,1
Amjad Attwan,0,57.0,0,0,0,1,1
Amjad Kalaf,1,42.0,0,0,1,0,1
Amleto Frignani,1,182.0,0,0,1,2,3
Ammar Jemal,0,6.0,0,0,0,1,1
Ammar Merrichkou,0,13.0,0,0,0,1,1
Ammar Rihawi,1,66.0,0,0,0,1,1
Ammo Yousif,0,6.0,0,0,0,1,1
Amnon Aharonskind,1,70.0,0,0,1,0,1
Amor Jebali,0,89.0,0,0,0,1,1
Amr Zaki,4,756.0,0,0,13,4,17
Amran Al-Hidi,0,90.0,0,0,1,0,1
Amredin Sharifi,1,47.0,0,0,0,1,1
Amri Kiemba,0,28.0,0,0,1,1,2
Américo Gallego,0,14.0,0,0,1,0,1
Américo Galván,1,69.0,0,0,0,3,3
Amílcar Barbuy,1,198.0,0,1,4,0,4
An Chol-Hyok,0,171.0,0,0,0,2,2
An Se-Uk,1,30.0,0,0,1,0,1
An Yong-hak,0,122.0,0,0,2,0,2
Anani Afanou,0,58.0,0,0,0,1,1
Anas Al Khouja,0,57.0,1,0,1,0,1
Anas Al-Zboun,1,90.0,0,0,1,0,1
Anas Bani Yaseen,1,26.0,0,0,0,1,1
Anas Elnour,0,52.0,0,0,1,0,1
Anas Farah Ali,1,32.0,0,0,1,0,1
Anastasios Bakasetas,0,209.0,0,2,1,2,3
Anastasios Donis,0,80.0,0,0,0,1,1
Anastasios Douvikas,0,45.0,0,0,0,1,1
Anatoli Banişevski,0,245.0,0,0,0,5,5
Anatoli Ilyin,3,312.0,0,0,2,4,6
Anatoli Isayev,0,32.0,0,0,0,2,2
Anatolie Doroș,0,160.0,0,1,1,1,2
Anatoliy Banishevskiy,1,354.0,0,0,4,2,6
Anatoliy Byshovets,5,422.0,0,0,3,5,8
Anatoliy Demyanenko,1,163.0,0,0,3,1,4
Anatoliy Konkov,2,92.0,0,0,2,1,3
Anbar Bashir Abubakr,0,82.0,0,1,1,0,1
Anders Grönhagen,0,166.0,0,0,1,2,3
Anders Limpar,0,37.0,0,0,0,1,1
Anders Svensson,1,578.0,0,0,9,3,12
Andi Herzog,0,239.0,0,1,4,0,4
Andi Lala,0,26.0,0,0,0,1,1
Andile Jali,0,169.0,0,1,1,1,2
Andoni Goikoetxea,0,65.0,0,0,0,1,1
Andoni Goikoetxea Olaskoaga,1,68.0,0,1,0,1,1
Andoni Zubizarreta,1,73.0,1,0,0,1,1
Andranik Eskandarian,1,43.0,1,0,0,1,1
Andranik Teymourian,0,271.0,0,0,2,2,4
Andraž Kirm,0,65.0,0,0,1,1,2
Andraž Struna,0,50.0,0,0,1,0,1
Andraž Šporar,0,162.0,0,0,1,2,3
Andre Boucaud,1,42.0,0,0,1,0,1
Andre Espinoza,0,3.0,0,0,0,1,1
Andre Gray,0,159.0,0,0,1,1,2
Andre Hinds,0,166.0,0,0,2,2,4
Andre Kona N'Gole,1,90.0,0,0,0,1,1
Andre Schembri,0,143.0,0,0,3,0,3
Andre Sinedo,1,79.0,0,0,0,1,1
Andre Wabealo,1,11.0,0,0,0,1,1
Andre de Jong,1,75.0,0,0,1,0,1
Andrea Belotti,0,414.0,0,1,1,8,9
Andrea Dossena,1,45.0,1,0,0,1,1
Andrea Pirlo,4,406.0,0,3,6,4,10
Andreas Andersson,0,120.0,0,0,1,1,2
Andreas Avraam,0,134.0,0,0,1,1,2
Andreas Bjelland,0,28.0,0,0,1,0,1
Andreas Bonovas,0,63.0,0,0,1,0,1
Andreas Brehme,4,295.0,0,1,5,1,6
Andreas Christensen,1,176.0,0,0,1,2,3
Andreas Cornelius,0,204.0,0,0,3,1,4
Andreas Granqvist,2,408.0,0,5,4,3,7
Andreas Heraf,0,55.0,0,0,0,1,1
Andreas Herzog,1,934.0,0,5,13,4,17
Andreas Ivanschitz,0,299.0,0,1,4,2,6
Andreas Jakobsson,0,48.0,0,0,1,0,1
Andreas Krause,0,11.0,0,0,1,0,1
Andreas Lava Olsen,0,82.0,0,0,0,1,1
Andreas Malin,0,80.0,1,0,1,0,1
Andreas Möller,2,354.0,0,0,9,0,9
Andreas Niniadis,0,37.0,0,1,1,0,1
Andreas Ogris,1,241.0,0,0,3,2,5
Andreas Papaemmanouil,0,178.0,0,0,3,1,4
Andreas Ravelli,0,114.0,1,0,2,0,2
Andreas Samaris,1,42.0,0,0,1,0,1
Andreas Skov Olsen,0,214.0,0,0,2,3,5
Andreas Sotiriou,0,187.0,0,0,4,2,6
Andreas Thom,0,615.0,0,0,5,6,11
Andrei Agius,0,89.0,1,0,1,1,2
Andrei Finonchenko,0,118.0,0,0,1,1,2
Andrei Fyodorov,0,219.0,0,2,3,1,4
Andrei Kanchelskis,0,246.0,0,0,3,2,5
Andrei Karpovich,0,34.0,0,0,1,0,1
Andrei Karyaka,0,168.0,1,0,2,3,5
Andrei Mostovoy,0,56.0,0,0,1,0,1
Andrei Piatnitski,0,14.0,0,0,0,1,1
Andrei Sidorenkov,0,66.0,1,0,0,1,1
Andrei Stepanov,0,27.0,0,0,1,0,1
Andrei Zygmantovich,1,29.0,0,0,0,1,1
Andrej Kramarić,2,575.0,0,0,7,4,11
Andrej Kvašňák,2,438.0,0,2,6,4,10
Andrejs Cigaņiks,0,89.0,0,0,1,0,1
Andrejs Perepļotkins,0,86.0,0,0,0,1,1
Andrejs Prohorenkovs,0,166.0,0,0,1,2,3
Andrejs Rubins,0,97.0,0,0,2,1,3
Andrejs Štolcers,0,185.0,0,0,1,3,4
Andres Oper,0,906.0,0,0,10,7,17
Andrew Hainault,0,54.0,0,0,0,1,1
Andrew Lepani,3,155.0,0,0,0,4,4
Andrew Mobberley,1,35.0,0,0,1,1,2
Andrew Murunga,0,53.0,0,0,0,1,1
Andrew Robertson,0,91.0,0,0,1,1,2
Andrew Sinkala,0,35.0,0,0,0,1,1
Andrew Tembo,1,157.0,0,0,1,1,2
Andrey Akopyants,1,82.0,0,0,0,1,1
Andrey Arshavin,2,678.0,0,0,5,8,13
Andrey Galabinov,0,6.0,0,0,1,0,1
Andrey Krasnov,0,92.0,0,0,1,0,1
Andrey Movsisyan,0,67.0,0,0,1,0,1
Andrey Tikhonov,0,34.0,0,0,0,1,1
Andrey Zhelyazkov,0,111.0,0,0,3,0,3
Andrezinho,0,16.0,0,0,1,0,1
Andri Guðjohnsen,0,173.0,0,0,2,0,2
Andri Sigthórsson,0,66.0,0,0,1,0,1
Andrija Delibašić,0,373.0,0,0,4,2,6
Andrius Gedgaudas,0,90.0,0,0,1,0,1
Andrius Skerla,0,89.0,0,0,0,1,1
Andriy Bal,1,34.0,0,0,0,1,1
Andriy Husin,0,504.0,0,0,2,5,7
Andriy Polunin,0,18.0,0,0,0,1,1
Andriy Rusol,1,124.0,0,0,1,2,3
Andriy Shevchenko,2,2073.0,0,5,20,20,40
Andriy Vorobey,0,290.0,0,0,4,0,4
Andriy Voronin,0,183.0,0,0,4,0,4
Andriy Yarmolenko,3,1126.0,0,2,13,12,25
Andronikos Kakoullis,0,89.0,0,0,0,1,1
Andros Townsend,0,150.0,0,0,2,0,2
Andrzej Buncol,1,123.0,0,0,2,0,2
Andrzej Iwan,0,6.0,0,0,1,0,1
Andrzej Jarosik,0,247.0,0,1,4,1,5
Andrzej Juskowiak,0,445.0,0,1,5,6,11
Andrzej Niedzielan,0,73.0,0,0,0,2,2
Andrzej Pałasz,0,80.0,0,0,1,0,1
Andrzej Szarmach,7,536.0,0,0,7,6,13
András Schäfer,0,105.0,0,0,0,2,2
András Tóth,1,81.0,0,1,1,0,1
András Törőcsik,0,96.0,0,0,1,2,3
André Abegglen,4,262.0,0,0,0,4,4
André Ayew,13,861.0,0,4,8,8,16
André Bikey,0,11.0,0,0,0,1,1
André Biyogo Poko,0,11.0,0,0,0,1,1
André Carrillo,5,446.0,1,0,3,6,9
André De Nul,0,75.0,0,0,1,0,1
André Egli,0,98.0,0,1,2,1,3
André Guy,0,80.0,0,0,0,2,2
André Halter,0,57.0,0,0,1,0,1
André Kalonzo,1,70.0,0,0,1,0,1
André Kana-Biyik,3,370.0,0,0,2,5,7
André Luiz Moreira,1,3.0,0,0,1,0,1
André Maschinot,2,130.0,0,0,2,0,2
André Mbouta,1,81.0,0,0,1,0,1
André Onana,0,43.0,1,0,0,1,1
André Ooijer,0,64.0,0,0,2,0,2
André Piters,0,11.0,0,0,1,0,1
André Schürrle,4,967.0,0,0,4,11,15
André Silva,1,558.0,0,0,3,8,11
André van Herpe,0,9.0,0,0,0,1,1
André-Frank Zambo Anguissa,2,117.0,0,0,1,2,3
André-Pierre Gignac,0,179.0,0,0,3,1,4
Andrés Andrade,0,14.0,0,0,0,1,1
Andrés Augusto Mendoza,0,86.0,0,0,0,1,1
Andrés Aurelio González,0,53.0,0,0,1,0,1
Andrés Cabrero,0,91.0,0,0,2,0,2
Andrés D'Alessandro,1,140.0,0,0,2,0,2
Andrés Escobar,0,35.0,1,0,1,0,1
Andrés Guardado,13,1094.0,0,4,11,9,20
Andrés Iniesta,2,479.0,0,1,3,5,8
Andrés Martínez,1,45.0,0,0,1,0,1
Andrés Mendoza,0,171.0,0,0,2,1,3
Andrés Prieto,2,82.0,0,0,2,0,2
Andrés Scotti,0,77.0,0,0,1,0,1
Andrėjus Tereškinas,0,85.0,0,0,0,1,1
Andualem Nigussie,0,118.0,0,0,2,0,2
Andy Aleong,0,83.0,0,0,2,0,2
Andy Baptiste,0,90.0,0,0,1,0,1
Andy Carroll,1,23.0,0,0,0,1,1
Andy Cole,0,90.0,0,0,0,1,1
Andy Egli,0,75.0,0,0,1,1,2
Andy Furtado,0,107.0,0,0,2,0,2
Andy Gray,0,103.0,0,0,1,1,2
Andy Herron,3,216.0,0,0,4,1,5
Andy Jones,0,86.0,0,0,1,0,1
Andy Keogh,0,90.0,0,0,1,0,1
Andy McEvoy,0,122.0,0,0,1,2,3
Andy Melville,0,181.0,1,0,1,3,4
Andy Najar,2,131.0,0,0,2,0,2
Andy Reid,0,45.0,0,0,2,0,2
Andy Selva,0,380.0,0,1,6,1,7
Andy Sophie,0,134.0,0,1,1,1,2
Andy Townsend,0,143.0,0,0,1,3,4
Andy Williams,3,381.0,0,3,2,6,8
Anel Ahmedhodžić,0,77.0,0,0,0,1,1
Anfilogino Guarisi,0,40.0,0,0,1,0,1
Anfilogino Marques,1,16.0,0,0,1,0,1
Angel Chiessa,1,10.0,0,0,1,0,1
Angel Mussenden,0,35.0,1,0,1,0,1
Angel Perucca,2,176.0,0,0,2,0,2
Angel Rambert,0,17.0,0,0,1,0,1
Angelo Cijntje,0,90.0,0,0,1,0,1
Angelo Costanzo,1,83.0,0,0,1,0,1
Angelo Domenghini,1,358.0,0,0,6,1,7
Angelo Martina,1,11.0,0,0,1,0,1
Angelo Schiavio,0,206.0,0,0,4,0,4
Angelo Sormani,0,86.0,0,0,0,1,1
Angelo Zimmerman,1,199.0,1,0,2,1,3
Angelos Basinas,0,262.0,0,4,2,3,5
Angelos Charisteas,3,893.0,0,2,12,8,20
Angelos Tsolakis,0,89.0,0,0,0,1,1
Anghel Iordănescu,0,349.0,0,2,4,3,7
Angus Eve,1,722.0,0,0,9,3,12
Ani Gome,1,7.0,0,0,0,1,1
Anice Badri,0,78.0,0,0,0,1,1
Anicet Abel,1,86.0,0,0,1,1,2
Anicet Adjamossi,1,147.0,1,0,1,1,2
Anicet Yala Ngoukou,0,56.0,0,0,1,0,1
Anil Gurung,0,19.0,0,2,2,0,2
Anirudh Thapa,1,68.0,0,0,0,1,1
Anis Ben Slimane,0,90.0,0,0,0,1,1
Anjan Bista,1,69.0,0,1,1,2,3
Anjas Asmara,1,71.0,0,0,0,2,2
Anon Nanok,0,30.0,0,0,1,0,1
Ansi Agolli,0,78.0,0,0,1,0,1
Ansyari Lubis,0,58.0,0,0,2,0,2
Antal Dunai,0,110.0,0,0,2,3,5
Antal Nagy,0,50.0,0,0,1,0,1
Antal Róth,0,49.0,0,0,0,1,1
Antar Yahia,1,163.0,0,0,4,0,4
Ante Juric,1,36.0,0,0,1,0,1
Ante Milicic,1,28.0,0,0,2,1,3
Ante Razov,0,209.0,0,0,2,2,4
Ante Rebić,1,66.0,0,0,0,2,2
Ante Žanetić,0,55.0,0,0,0,1,1
Anteneh Alameraw,0,48.0,0,0,1,0,1
Anthonie van der Linden,0,11.0,0,0,1,0,1
Anthony Abrams,0,73.0,0,0,0,1,1
Anthony Annan,0,83.0,0,0,1,0,1
Anthony Augustine,0,72.0,0,0,1,0,1
Anthony Contreras,0,89.0,0,0,1,1,2
Anthony Dominique,0,8.0,0,0,1,0,1
Anthony Hernandez,1,30.0,0,0,1,0,1
Anthony Laffor,0,50.0,0,0,1,0,1
Anthony Lozano,0,147.0,0,0,1,2,3
Anthony Martial,0,50.0,0,0,0,1,1
Anthony Modeste,0,233.0,0,0,1,2,3
Anthony Rougier,0,21.0,0,0,2,0,2
Anthony Réveillère,0,66.0,0,0,1,0,1
Anthony Straker,0,33.0,0,1,1,0,1
Anthony Yeboah,1,29.0,0,0,1,0,1
Anthony van den Hurk,0,17.0,0,0,1,0,1
Antoine Griezmann,4,1142.0,0,6,18,6,24
Antoine Kohn,0,6.0,0,0,1,0,1
Antoine Mocude,0,64.0,0,0,1,0,1
Antolín Alcaraz,2,71.0,0,0,1,1,2
Anton Allemann,0,124.0,0,0,2,0,2
Anton Camilleri,0,20.0,0,0,1,0,1
Anton Doboş,0,35.0,0,0,0,1,1
Anton Haven,0,28.0,0,0,1,1,2
Anton Jongsma,0,15.0,0,0,0,1,1
Anton Miranchuk,0,41.0,0,0,1,0,1
Anton Moravčík,0,23.0,0,0,0,1,1
Anton Ondruš,2,99.0,1,0,1,2,3
Anton Polster,0,138.0,0,0,2,0,2
Anton Putsila,0,145.0,0,0,1,1,2
Anton Rogan,0,30.0,1,0,1,0,1
Anton Saroka,0,44.0,0,0,0,1,1
Anton Schall,1,93.0,0,0,1,0,1
Anton Silva,1,14.0,0,0,1,0,1
Anton Weibel,0,77.0,1,0,0,1,1
Anton Zabolotny,0,82.0,0,0,1,0,1
Anton Zemlianukhin,0,188.0,0,1,2,2,4
Anton Žlogar,0,83.0,0,0,1,0,1
Antonee Robinson,0,100.0,0,0,1,1,2
Antonhy Stanton,0,43.0,0,0,1,0,1
Antoni Lima Solá,0,80.0,0,0,0,1,1
Antonio Alzamendi,3,271.0,0,0,1,4,5
Antonio Angelillo,0,69.0,0,0,1,0,1
Antonio Blanco,1,80.0,0,0,1,0,1
Antonio Cabrini,1,189.0,0,1,3,0,3
Antonio Campolo,1,48.0,0,0,0,1,1
Antonio Candreva,0,183.0,0,2,1,4,5
Antonio Cassano,3,373.0,0,0,7,2,9
Antonio Cerroti,0,41.0,0,0,1,0,1
Antonio Conte,1,122.0,0,0,0,2,2
Antonio Di Natale,2,358.0,0,0,0,6,6
Antonio Flores,0,78.0,0,0,2,0,2
Antonio González,1,11.0,0,0,0,1,1
Antonio Gómez,0,89.0,0,0,0,1,1
Antonio López Guerrero,0,1.0,0,0,0,1,1
Antonio Maceda,2,319.0,0,0,2,4,6
Antonio Martina,1,90.0,0,0,1,0,1
Antonio Muñoz Gómez,0,18.0,0,0,0,1,1
Antonio Pacheco D'Agosti,1,90.0,0,0,0,1,1
Antonio Rada,1,226.0,0,1,3,0,3
Antonio Ravelo,2,173.0,0,0,1,1,2
Antonio Rüdiger,0,88.0,0,0,1,1,2
Antonio Sacco,0,123.0,0,0,0,2,2
Antonio Sanabria,0,130.0,0,0,1,1,2
Antonio Sardina,0,17.0,0,0,0,1,1
Antonio Sastre,1,53.0,0,0,1,0,1
Antonio Urdinarán,2,45.0,0,2,0,2,2
Antonio Valencia,2,353.0,0,0,6,2,8
Antonio Valentín Angelillo,8,289.0,0,0,8,0,8
Antonio Zelaya,0,86.0,0,0,1,0,1
Antonio de Miguel,2,126.0,0,0,2,0,2
Antonio de Nigris,0,33.0,0,0,2,0,2
Antonio dos Santos,0,1.0,0,0,1,0,1
Antonis Antoniadis,0,139.0,0,1,2,2,4
Antonis Migiakis,1,73.0,0,0,0,1,1
Antony,0,176.0,0,0,1,1,2
Antony de Ávila,4,363.0,0,0,4,3,7
Antonín Barák,1,168.0,0,0,1,4,5
Antonín Panenka,3,449.0,0,5,9,2,11
Antonín Puč,1,121.0,0,0,1,1,2
Antti Sumiala,0,429.0,0,1,4,3,7
Antwan Russell,0,52.0,0,0,1,0,1
António Dias Teixeira,0,81.0,0,0,1,0,1
António Folha,0,148.0,0,0,1,1,2
António Luís Alves Ribeiro Oliveira,0,175.0,0,0,1,1,2
António Mendonça,0,84.0,0,0,1,0,1
António Neto,0,44.0,0,0,0,1,1
António Nogueira,0,1.0,0,0,1,0,1
António Simões,1,104.0,0,0,1,1,2
António Sousa,1,52.0,0,0,1,0,1
Antônio Almeida,1,72.0,0,0,1,0,1
Antônio Carlos Zago,0,77.0,0,0,1,1,2
Anvarjon Soliev,0,306.0,0,0,4,0,4
Anwar Ahmed,0,8.0,0,0,0,1,1
Anwar Jackaria,0,17.0,0,0,0,1,1
Anwar Shakunda,1,86.0,0,0,1,0,1
Anzur Ismailov,0,117.0,0,0,2,1,3
Aníbal Ciocca,3,184.0,0,0,2,3,5
Aníbal Godoy,1,225.0,1,0,3,1,4
Aníbal Médicis Candiota,1,46.0,0,0,1,0,1
Aníbal Tarabini,0,43.0,0,0,0,1,1
Ao Tanaka,1,59.0,0,0,2,0,2
Aples Tecuari,0,73.0,0,0,1,0,1
Apostolos Giannou,1,90.0,0,0,0,1,1
Ara Hakobyan,0,177.0,0,0,1,2,3
Aram Ayrapetyan,0,80.0,1,0,0,1,1
Aram Hakobyan,0,52.0,0,0,0,1,1
Aras Özbiliz,0,139.0,0,0,2,1,3
Arash Afshin,1,67.0,0,0,0,1,1
Arash Borhani,0,147.0,0,0,1,1,2
Araz Abdullayev,0,24.0,0,0,1,0,1
Arben Minga,0,86.0,0,0,1,0,1
Arbër Zeneli,0,61.0,0,0,1,0,1
Arcadia Martin Wesay Toe,0,54.0,0,0,0,1,1
Archie Gemmill,2,417.0,0,3,4,2,6
Archie Robertson,0,29.0,0,0,1,0,1
Archie Thompson,1,1180.0,0,0,18,3,21
Archil Arveladze,0,205.0,0,0,2,1,3
Arda Turan,1,697.0,0,0,8,3,11
Ardian Kozniku,0,81.0,0,0,1,0,1
Aref Al Agha,2,74.0,0,0,0,2,2
Aref Al-Shewaier,1,73.0,0,0,0,1,1
Arfon Griffiths,0,234.0,0,0,3,1,4
Argenis Tortolero,0,40.0,0,0,1,0,1
Argjend Beqiri,0,75.0,0,0,1,0,1
Argo Arbeiter,0,90.0,0,0,0,1,1
Ari Hjelm,0,284.0,0,0,4,3,7
Ari Mäkynen,0,82.0,0,1,1,0,1
Ari Valvee,0,209.0,0,0,2,1,3
Ariagner Smith,2,53.0,0,0,0,2,2
Arie Haan,2,120.0,0,0,1,2,3
Ariel Francisco Rodríguez,1,4.0,0,0,1,0,1
Ariel Graziani,3,526.0,0,0,3,7,10
Ariel Lassiter,1,21.0,0,0,1,0,1
Ariel Martínez,3,183.0,0,0,3,0,3
Ariel Ortega,3,338.0,0,0,5,5,10
Ariel Álvarez,0,56.0,0,0,1,0,1
Arif Erdem,0,513.0,0,0,4,5,9
Arif Kocabıyık,0,86.0,0,0,1,0,1
Arif Mirzoyev,0,80.0,0,0,1,0,1
Arijan Ademi,0,284.0,0,0,1,3,4
Aristide Bancé,4,554.0,0,1,6,3,9
Aritatsu Ogi,1,68.0,1,0,0,1,1
Aritz Aduriz,0,85.0,0,0,1,0,1
Ariza Makukula,0,84.0,0,0,0,1,1
Arj Changatamilman,0,31.0,0,0,1,0,1
Arjan Bellaj,0,25.0,0,0,0,1,1
Arjan Beqaj,0,42.0,1,0,1,0,1
Arjen Robben,8,1010.0,0,1,12,10,22
Arkadiusz Głowacki,0,57.0,1,0,0,1,1
Arkadiusz Milik,1,594.0,0,0,8,2,10
Arlindo Gomes Semedo,0,237.0,0,0,5,0,5
Arman Karamyan,0,27.0,0,0,0,1,1
Armand Djerabe,0,47.0,0,0,1,0,1
Armand Jurion,0,82.0,0,1,1,1,2
Armand Muller,0,3.0,0,0,1,0,1
Armand Penverne,0,40.0,0,0,0,1,1
Armando Alonso,0,167.0,0,0,1,2,3
Armando Broja,0,228.0,0,0,2,1,3
Armando Contreras,0,44.0,0,0,1,1,2
Armando Cooper,1,103.0,0,0,2,1,3
Armando Cruz,0,79.0,0,1,0,1,1
Armando Macamo,0,25.0,0,0,1,0,1
Armando Sadiku,1,251.0,0,0,2,5,7
Armando Tapia,1,77.0,0,0,1,0,1
Armando Tobar,1,77.0,0,0,1,0,1
Armands Zeiberliņš,0,230.0,0,0,2,1,3
Armel Disney,0,222.0,0,0,4,0,4
Armen Shahgeldyan,0,313.0,0,1,2,3,5
Armend Dallku,0,90.0,0,0,1,0,1
Armin Hodžić,0,209.0,0,0,1,2,3
Armin Krings,0,28.0,0,0,0,1,1
Arminas Narbekovas,0,96.0,0,0,1,1,2
Arnaldo Owanga,0,50.0,0,0,1,0,1
Arnar Gunnlaugsson,0,3.0,0,0,0,1,1
Arnar Viðarsson,0,6.0,0,0,1,0,1
Arnaut Danjuma,0,75.0,0,0,1,0,1
Arnbjørn Hansen,0,150.0,0,0,3,0,3
Arne Brustad,1,83.0,0,0,0,1,1
Arne Friedrich,1,169.0,2,0,1,2,3
Arne Larsen Økland,0,205.0,0,0,1,3,4
Arne Nyberg,3,123.0,0,0,0,3,3
Arne Pedersen,0,16.0,0,0,1,0,1
Arne Selmosson,0,26.0,0,0,1,0,1
Arno Bertogna,1,90.0,0,0,1,0,1
Arnold Bouka Moutou,0,87.0,0,0,0,1,1
Arnold Cruz,0,19.0,0,0,1,0,1
Arnold Dwarika,2,491.0,0,2,6,3,9
Arnold Mühren,0,151.0,0,1,3,0,3
Arnold Wetl,0,226.0,1,0,2,1,3
Arnoldo Iguarán,8,701.0,0,0,8,6,14
Arnulfo Valentierra,0,67.0,0,0,0,1,1
Arnór Guðjohnsen,0,317.0,0,0,5,1,6
Arnór Ingvi Traustason,1,90.0,0,0,1,0,1
Arnór Sigurðsson,0,38.0,0,0,1,0,1
Aron Gunnarsson,0,137.0,0,0,1,1,2
Aron Jóhannsson,0,122.0,0,0,1,1,2
Aron Winter,1,270.0,0,0,2,2,4
Arouna Koné,0,43.0,0,0,0,1,1
Arsen Avakov,0,131.0,0,0,3,1,4
Arsenio Luzardo,0,68.0,0,0,1,0,1
Arshad Al-Alawi,0,90.0,0,0,2,0,2
Arslanmyrat Amanow,1,414.0,0,0,2,5,7
Art Hughes,0,135.0,0,0,2,0,2
Art Welch,0,70.0,0,0,1,0,1
Artak Grigoryan,0,50.0,0,0,1,0,1
Artem Besyedin,0,165.0,0,0,0,2,2
Artem Dovbyk,1,289.0,0,0,0,3,3
Artem Dzyuba,0,1377.0,0,4,14,10,24
Artem Fedetskiy,0,158.0,0,0,1,1,2
Artem Kontsevoy,0,87.0,0,0,0,1,1
Artem Kravets,1,226.0,0,0,4,2,6
Artem Milevskyi,0,135.0,0,1,2,0,2
Arthur Fitzsimons,0,97.0,0,0,2,0,2
Arthur Friedenreich,2,308.0,0,0,6,1,7
Arthur Melo,0,33.0,0,0,0,1,1
Arthur Minasyan,0,39.0,0,0,1,0,1
Arthur Moses,0,89.0,0,0,1,0,1
Artim Šakiri,0,352.0,0,1,6,3,9
Artiom Rudņev,0,83.0,0,0,1,0,1
Arto Tolsa,0,128.0,0,0,2,1,3
Artur Correia,0,37.0,0,0,1,0,1
Artur Geworkýan,0,156.0,0,0,3,0,3
Artur Ioniță,0,73.0,0,0,0,1,1
Artur Jorge,0,46.0,0,0,1,0,1
Artur Petrosyan,0,454.0,0,0,5,4,9
Artur Sarkisov,0,250.0,0,0,1,2,3
Artur Wichniarek,0,45.0,0,0,0,1,1
Arturo Arrieta,1,49.0,0,0,1,0,1
Arturo Carmona,2,78.0,0,0,1,1,2
Arturo Mendoza,1,52.0,0,0,0,1,1
Arturo Mina,1,128.0,1,0,2,0,2
Arturo Norambuena,0,70.0,0,0,1,0,1
Arturo Tardío,1,84.0,0,0,1,0,1
Arturo Vidal,5,1299.0,1,6,15,10,25
Arturo Vázquez Ayala,1,45.0,0,1,1,0,1
Arturo Álvarez,1,146.0,0,0,2,0,2
Artyom Filiposyan,0,44.0,1,0,0,1,1
Artýom Nazarow,0,70.0,0,0,0,1,1
Artūras Fomenka,0,169.0,0,0,2,0,2
Artūrs Zjuzins,0,182.0,0,0,2,1,3
Aruna Dindane,3,475.0,0,1,6,4,10
Arvydas Novikovas,0,434.0,0,3,3,3,6
Ary Papel,0,56.0,0,0,1,0,1
Arístides Rojas,0,165.0,0,0,2,1,3
Arístides del Puerto,1,74.0,0,0,2,0,2
Arūnas Šuika,0,124.0,0,0,3,0,3
Asa Hartford,0,35.0,0,0,1,0,1
Asadhulla Abdulla,0,37.0,0,0,1,0,1
Asam Duraiban,1,16.0,0,0,1,0,1
Asamoah Gyan,12,1198.0,0,4,10,14,24
Aschalew Tamene,0,90.0,0,1,1,0,1
Asher Welch,0,11.0,0,0,1,0,1
Ashish Bhadra,0,15.0,0,0,0,1,1
Ashkan Dejagah,2,211.0,0,3,6,0,6
Ashley Grimes,0,2.0,0,0,1,0,1
Ashley Rambanapasi,0,78.0,0,0,1,0,1
Ashley Williams,1,79.0,1,0,1,1,2
Ashley Young,0,136.0,0,0,2,2,4
Ashraf Luthfy,0,82.0,0,0,1,0,1
Ashraf Uddin Ahmed Chunnu,1,213.0,0,0,2,1,3
Asier Illarramendi,0,76.0,0,0,0,1,1
Asier del Horno,0,75.0,0,0,1,0,1
Asimakis Krassas,0,95.0,0,0,0,1,1
Askhat Kadyrkulov,1,82.0,0,0,0,1,1
Asmeron Germa,0,180.0,0,0,2,0,2
Asnake Tenkir,0,50.0,0,0,1,0,1
Asparuh Nikodimov,1,12.0,0,0,1,0,1
Assad Ghani,0,65.0,0,0,1,0,1
Assan Ceesay,0,65.0,0,0,0,1,1
Assan Sarr,0,90.0,0,0,0,1,1
Assani Bajope,0,17.0,0,0,1,0,1
Astrit Ziu,0,22.0,0,0,0,1,1
Asuquo Ekpe,1,78.0,0,0,0,1,1
Atanas Iliev,0,39.0,0,0,0,1,1
Atanas Mihaylov,0,84.0,0,0,1,1,2
Atdhe Nuhiu,1,102.0,0,0,1,1,2
Athanas Tendeng,1,50.0,0,0,1,0,1
Athuman Iddy,0,5.0,0,0,1,0,1
Ati Kepo,2,133.0,0,0,0,2,2
Atiba Harris,0,87.0,0,0,1,1,2
Atiba Hutchinson,1,370.0,1,0,4,2,6
Atik Ismail,0,202.0,0,0,4,0,4
Atilio Ancheta,0,76.0,0,0,1,0,1
Atilio Cremaschi,8,453.0,0,0,6,2,8
Atilio García,5,255.0,0,0,0,5,5
Atilio López,4,103.0,0,0,2,2,4
Atkin Kaua,1,32.0,0,0,1,1,2
Atli Eðvaldsson,1,441.0,0,0,5,2,7
Atnesh Prasad,2,170.0,0,0,0,2,2
Ats Purje,0,167.0,0,0,1,1,2
Atsuhiro Miura,1,77.0,0,0,0,1,1
Atsushi Yanagisawa,3,105.0,0,0,1,2,3
Atsuto Uchida,1,140.0,1,0,2,0,2
Attila Abonyi,2,235.0,0,1,4,2,6
Attila Fiola,0,90.0,0,0,1,1,2
Attila Korsós,0,117.0,0,0,2,0,2
Attila Pinte,0,80.0,0,0,0,1,1
Attila Pintér,0,120.0,0,0,2,0,2
Attilio Lombardo,0,56.0,0,0,0,2,2
Atusaye Nyondo,0,70.0,0,0,0,1,1
Au Chi Yin,0,78.0,0,0,2,0,2
Au Wai Lun,1,166.0,0,0,2,1,3
Au-yeong Pak Kuan,0,90.0,0,0,1,0,1
Audel Laville,1,82.0,0,0,1,0,1
Audrius Kšanavičius,0,142.0,0,0,0,2,2
Audrius Žuta,0,87.0,0,0,0,1,1
August Foe a Man,0,45.0,0,0,1,0,1
August Starek,0,177.0,0,0,0,4,4
Augustine Ahinful,0,109.0,0,0,2,0,2
Augustine Ofuokwu,0,90.0,0,0,0,1,1
Augustine Peli,0,146.0,0,0,0,2,2
Augusto Espinoza,0,151.0,0,0,2,1,3
Augusto da Costa,0,15.0,0,0,1,0,1
Aung Khin,1,80.0,0,0,1,0,1
Aung Thu,1,171.0,0,0,2,1,3
Aurel Ţicleanu,0,67.0,0,0,1,0,1
Aurelien Bekogo,1,34.0,0,0,0,1,1
Aurelijus Skarbalius,0,61.0,0,0,0,1,1
Aurelio Domínguez,0,60.0,0,0,1,0,1
Aurelio González,6,410.0,0,0,6,1,7
Aurelio Martínez,0,57.0,0,0,0,1,1
Aurelio Vidmar,0,373.0,0,1,9,1,10
Aurélien Chedjou,1,104.0,1,0,1,1,2
Aurélien Joachim,0,454.0,0,1,3,4,7
Aurélien Tchouaméni,1,17.0,0,0,0,1,1
Ausberto García,1,334.0,0,0,6,0,6
Austin Berry,1,22.0,0,1,2,1,3
Austin Huggins,0,108.0,0,0,2,1,3
Austin Makacha,0,40.0,0,0,0,1,1
Avdija Vršajević,1,135.0,0,0,2,0,2
Avelino Salvador Maluana,1,57.0,0,0,0,1,1
Avi Cohen,0,54.0,0,0,1,1,2
Avi Nimni,0,289.0,0,1,0,6,6
Avi Yehiel,0,39.0,0,0,0,1,1
Aviram Baruchyan,0,15.0,0,0,1,0,1
Avondale Williams,0,229.0,0,1,1,2,3
Avraam Papadopoulos,0,90.0,1,0,0,1,1
Avraham Menchel,1,32.0,0,0,1,0,1
Avraham Nudelmann,0,61.0,0,0,0,1,1
Awad Koka,0,70.0,0,0,1,0,1
Awad Ragheb,0,90.0,0,0,1,0,1
Awer Mabil,4,94.0,0,0,3,1,4
Axel Méyé,0,103.0,0,0,0,2,2
Axel Temataua,3,120.0,0,0,3,0,3
Axel Witsel,2,228.0,0,0,2,4,6
Ayad Al-Qadi,0,70.0,0,1,1,0,1
Ayad El-Ghadi,0,30.0,0,0,1,0,1
Ayan Sadakov,0,87.0,0,0,0,2,2
Aydın Yelken,0,60.0,0,0,1,0,1
Ayedi Hamrouni,0,181.0,0,0,3,0,3
Ayel Mayélé,0,43.0,0,0,1,1,2
Ayhan Elmastaşoğlu,0,43.0,0,0,1,1,2
Ayila Yussuf,0,62.0,0,0,1,0,1
Ayman Al Husaini,0,8.0,0,0,0,1,1
Ayman Mansour,1,25.0,0,0,1,1,2
Ayman Younes,1,58.0,0,0,1,0,1
Aymen Abdennour,0,58.0,0,0,1,0,1
Aymen Barkok,0,20.0,0,0,1,0,1
Aymen Hussein,2,188.0,0,0,1,3,4
Aymeric Laporte,0,45.0,0,0,1,0,1
Ayoub El Kaabi,0,223.0,0,0,5,0,5
Ayrton Preciado,2,84.0,0,0,1,1,2
Aytec Genc,0,4.0,0,0,1,0,1
Ayub Masika,0,23.0,0,0,0,1,1
Azamat Ishenbaev,0,55.0,0,0,1,0,1
Azinho Solomon,1,86.0,0,0,1,0,1
Aziz Behich,1,166.0,2,0,2,0,2
Aziz Bouderbala,0,176.0,0,0,2,1,3
Aziz Bouhaddouz,2,104.0,1,0,1,1,2
Aziz Ibrahimov,0,147.0,0,0,0,2,2
Aziz Mashaan,1,61.0,0,0,1,0,1
Azizbek Haydarov,1,7.0,0,0,0,1,1
Azizol Abu Haniffah,2,183.0,0,0,3,1,4
Azmahar Ariano,0,69.0,0,0,1,0,1
Azman Adnan,2,249.0,0,0,5,2,7
Azubuike Egwuekwe,0,89.0,0,0,0,1,1
Azzedine Ounahi,0,75.0,0,0,2,0,2
Azər Salahlı,0,82.0,0,0,1,0,1
Aïssa Laïdouni,0,18.0,0,0,1,0,1
Aïssa Mandi,1,83.0,1,0,0,2,2
Baba Adamu,1,90.0,0,0,1,0,1
Baba Otu Mohammed,3,129.0,0,0,2,1,3
Babacar Gueye,0,21.0,0,0,1,0,1
Babatounde Bello,0,137.0,0,0,2,0,2
Babiker Santo,0,170.0,0,0,1,2,3
Babkin Melikian,0,117.0,0,0,1,1,2
Baboucar Sowe,0,22.0,0,0,1,0,1
Bachirou Osseni,0,12.0,0,0,0,1,1
Bachirou Salou,0,29.0,0,0,2,0,2
Backer Aloenouvo,0,90.0,0,0,1,0,1
Badal Das,0,76.0,0,0,1,0,1
Badar Al-Mahrouqi,0,89.0,0,0,1,0,1
Badar Al-Maimani,1,235.0,0,0,4,1,5
Badawi Abdel Fattah,1,160.0,0,0,1,2,3
Baddrol Bakhtiar,0,59.0,0,0,1,0,1
Bader Al-Mutawa,6,766.0,0,4,8,6,14
Badr Abdul Hameed Bo Abbas,0,76.0,0,0,1,0,1
Badr Haji,1,84.0,0,1,0,1,1
Badran Al-Shagran,0,286.0,0,0,2,3,5
Baghdad Bounedjah,2,130.0,0,2,2,2,4
Baha' Abdel-Rahman,2,130.0,0,0,3,0,3
Baha' Faisal,2,320.0,0,1,4,3,7
Bahodir Nasimov,0,290.0,0,0,2,2,4
Bahtiyor Kambaraliev,0,30.0,0,0,1,0,1
Bai He,0,87.0,0,0,1,0,1
Bai Malleh Wadda,0,81.0,0,0,1,0,1
Baichung Bhutia,0,88.0,0,1,2,0,2
Baihakki Khaizan,0,62.0,1,0,1,0,1
Bajram Franholli,0,57.0,0,0,1,0,1
Bakalevu Moceimereke,0,209.0,0,0,3,0,3
Bakar Ibor,0,53.0,0,1,0,1,1
Bakari Koné,3,433.0,0,0,3,4,7
Bakary Koné,1,82.0,1,0,1,0,1
Bakary Sako,1,37.0,0,0,1,1,2
Bakary Traoré,1,10.0,0,0,1,0,1
Bakaye Traoré,1,30.0,0,0,1,0,1
Bakhit Alabadla,0,60.0,0,0,0,1,1
Bakhtiyar Duyshobekov,0,7.0,0,0,1,0,1
Bakhtiyar Zaynutdinov,0,181.0,0,0,1,3,4
Bakhtiyor Ashurmatov,0,6.0,0,0,1,0,1
Bako,1,76.0,0,0,0,1,1
Bako Touré,2,117.0,0,0,2,0,2
Bakri Almadina,0,2.0,0,0,1,0,1
Bakri Ibni,1,78.0,0,0,1,0,1
Bal Gopal Maharjan,1,52.0,0,0,0,1,1
Balal Arezou,0,63.0,0,0,0,1,1
Baltazar,4,567.0,0,0,8,3,11
Baltazar Maria de Morais Júnior,0,57.0,0,0,1,0,1
Balázs Dzsudzsák,2,641.0,0,3,7,3,10
Bamba Dieng,1,174.0,0,0,1,1,2
Bambang Nurdiansyah,0,149.0,0,0,3,1,4
Bambang Pamungkas,0,262.0,0,0,3,1,4
Banana Yaya,1,156.0,0,0,1,1,2
Banou Diawara,0,179.0,0,0,2,0,2
Barak Yitzhaki,0,11.0,0,0,0,1,1
Barrios Zapata,0,3.0,0,0,1,0,1
Barry Ferguson,0,148.0,0,0,1,1,2
Barry Hulshoff,0,149.0,0,0,2,1,3
Barry Hunter,0,53.0,0,0,1,0,1
Barry Opdam,0,38.0,0,0,0,1,1
Bart Goor,0,309.0,0,0,6,0,6
Bart McGhee,1,23.0,0,0,0,1,1
Bartosz Bosacki,2,98.0,0,0,0,2,2
Bartosz Kapustka,0,82.0,0,0,1,1,2
Bartosz Karwan,0,250.0,0,0,2,1,3
Basam Al-Khateeb,1,88.0,0,0,1,0,1
Basanta Thapa,2,121.0,0,0,1,1,2
Basaula Lemba,1,48.0,0,0,0,1,1
Basel Abdul Rahim,1,84.0,0,1,0,1,1
Basem Fathi,0,85.0,0,0,0,1,1
Bashar Abdulaziz,0,154.0,0,0,1,2,3
Bashar Abdullah,3,542.0,0,0,8,2,10
Bashar Bani Yaseen,1,112.0,0,0,0,2,2
Bashar Rashid,1,10.0,0,0,1,0,1
Bashar Resan,2,42.0,0,0,1,1,2
Bashar Srour,0,365.0,0,1,8,0,8
Basheer Saeed,1,308.0,1,0,4,1,5
Bashir Abdel Samad,2,114.0,0,0,2,0,2
Basile Boli,0,25.0,0,0,0,1,1
Basile de Carvalho,0,38.0,0,0,1,0,1
Bassala Touré,0,84.0,0,0,2,0,2
Bassam Al-Rawi,2,127.0,0,0,2,0,2
Bassam Jeridi,0,123.0,0,0,5,1,6
Bastian Schweinsteiger,3,715.0,0,1,7,7,14
Batman Furigi,0,88.0,0,0,1,0,1
Batram Suri,6,599.0,0,1,4,6,10
Bauyrzhan Islamkhan,0,79.0,0,0,1,0,1
Bauyrzhan Turysbek,0,144.0,0,0,1,1,2
Bayarzorig Davaa,1,36.0,0,0,0,1,1
Bayazir al-Said,3,271.0,0,0,2,4,6
Beat Sutter,0,28.0,0,0,0,1,1
Bebeto,5,1018.0,0,0,13,6,19
Bedel Moyimbouabeka,0,7.0,0,0,1,0,1
Beder Caicedo,0,46.0,0,0,0,1,1
Bedri Omuri,0,150.0,0,0,1,2,3
Begençmuhammet Kulyýew,2,497.0,0,0,5,3,8
Behailu Assefa,0,57.0,0,0,1,0,1
Behtash Fariba,7,434.0,0,0,2,6,8
Bekim Balaj,0,305.0,0,0,2,3,5
Bekuretsion Gebre-Hiwot,0,86.0,0,0,1,0,1
Ben Acheampong,3,97.0,0,0,1,2,3
Ben Badi,1,14.0,0,0,0,1,1
Ben Brereton Díaz,1,173.0,0,0,4,0,4
Ben Chilwell,0,17.0,0,0,0,1,1
Ben Davies,0,77.0,0,0,1,0,1
Ben Federspiel,0,11.0,1,0,0,1,1
Ben Iroha,1,26.0,0,0,1,0,1
Ben Lemana,2,88.0,0,1,1,1,2
Ben Malango,0,236.0,0,0,1,2,3
Ben Olsen,1,23.0,0,0,1,0,1
Ben Sahar,0,393.0,0,0,5,0,5
Ben Sigmund,1,98.0,0,0,0,2,2
Ben Waine,1,75.0,0,0,0,1,1
Ben Wattman,0,90.0,0,0,0,1,1
Ben Wijnstekers,0,30.0,0,0,1,0,1
Ben Woodburn,0,74.0,0,0,1,0,1
Benas Šatkus,0,18.0,1,0,1,0,1
Benedict Akwuegbu,0,50.0,0,0,2,0,2
Benedicto Godoy Véizaga,2,87.0,0,0,2,0,2
Bengally Sylla,3,89.0,0,1,2,1,3
Bengt Berndtsson,0,20.0,0,0,1,0,1
Benigno Apocada,1,173.0,0,0,0,2,2
Benigno Gutiérrez,3,270.0,0,0,3,2,5
Benito Armingol,1,42.0,0,0,1,0,1
Benito Lorenzi,1,78.0,0,0,0,1,1
Benjamin Fischer,0,109.0,0,0,1,1,2
Benjamin Huggel,0,22.0,0,0,0,1,1
Benjamin Kololli,0,16.0,1,0,1,0,1
Benjamin Källman,0,57.0,0,0,0,1,1
Benjamin Moukandjo,2,101.0,0,0,2,2,4
Benjamin Pavard,1,57.0,0,0,1,0,1
Benjamin Totori,0,239.0,0,0,5,0,5
Benjamin Verbič,0,262.0,0,0,3,1,4
Benjamin Šeško,0,67.0,0,0,0,1,1
Benjamín Delgado,3,125.0,0,0,3,0,3
Benjamín Galindo,5,589.0,0,6,11,2,13
Benjani Mwaruwari,1,299.0,0,0,3,2,5
Benni McCarthy,9,453.0,0,1,7,5,12
Bennie Muller,0,52.0,0,0,1,0,1
Benny Feilhaber,0,73.0,0,0,1,0,1
Benny Nielsen,0,150.0,0,1,3,0,3
Benny Tabak,0,54.0,0,0,3,0,3
Bent Burgess,0,65.0,0,0,1,0,1
Bent Christensen Arensøe,1,172.0,0,0,2,4,6
Bent Hansen,0,19.0,0,0,1,0,1
Bent Jensen,0,84.0,0,1,0,1,1
Bep Bakhuys,0,291.0,0,0,2,2,4
Berat Djimsiti,0,23.0,0,0,0,1,1
Berat Sadik,0,90.0,0,0,0,1,1
Berdi Şamyradow,0,84.0,0,0,0,1,1
Bernard Akue Adovi,0,57.0,0,0,0,1,1
Bernard Blanchet,0,118.0,0,0,0,2,2
Bernard Chanda,3,411.0,0,0,4,3,7
Bernard Genghini,3,260.0,0,0,3,1,4
Bernard Lacombe,1,170.0,0,0,3,3,6
Bernard Leclézio,0,48.0,1,0,1,0,1
Bernard N'Guessan,0,129.0,0,1,2,0,2
Bernard Parker,1,447.0,1,1,6,2,8
Bernard Rahis,0,59.0,0,0,0,1,1
Bernard Tchoutang,1,358.0,0,0,5,0,5
Bernard Voorhoof,2,162.0,0,0,3,1,4
Bernardo Añor,0,64.0,0,0,1,0,1
Bernardo Redín,3,268.0,0,1,0,3,3
Bernardo Silva,1,228.0,0,0,2,3,5
Bernd Bransch,0,106.0,0,0,2,0,2
Bernd Hölzenbein,2,244.0,0,0,1,2,3
Bernd Krauss,0,30.0,1,0,1,0,1
Bernd Schneider,1,180.0,0,1,1,1,2
Bernd Schuster,0,80.0,0,0,0,2,2
Bernhard Cullmann,0,129.0,0,0,1,2,3
Bernhard Klodt,1,52.0,0,0,1,0,1
Bernt Haas,0,10.0,0,0,1,0,1
Bert Patenaude,4,144.0,0,0,0,4,4
Berthy Suárez,1,152.0,0,0,2,1,3
Berti Vogts,1,141.0,1,0,2,0,2
Bertil Ericsson,0,83.0,0,0,2,0,2
Bertrand Bouity,0,26.0,0,0,1,0,1
Bertrand Crasson,0,24.0,0,0,0,1,1
Bertrand Kaï,6,366.0,0,0,0,6,6
Bertrand St. Ange,0,44.0,0,0,0,1,1
Bertrand Traoré,2,164.0,0,0,3,1,4
Besar Halimi,0,70.0,0,0,0,1,1
Besart Abdurahimi,0,90.0,0,0,1,0,1
Besnik Hasi,0,137.0,0,0,1,1,2
Bessam,0,3.0,0,0,1,0,1
Beto,1,39.0,0,0,0,1,1
Beto Gonçalves,0,49.0,0,0,2,0,2
Bharat Khawas,0,80.0,0,0,1,0,1
Bhola Silwal,0,56.0,0,0,1,0,1
Bhupinder Thakur,3,143.0,0,0,2,1,3
Bibiano Zapirain,0,95.0,0,0,3,0,3
Bibras Natcho,0,166.0,0,0,0,3,3
Bijou Kisombe Mundaba,1,77.0,0,0,0,1,1
Bikash Panji,0,120.0,0,0,1,1,2
Bilal Al-Laham,1,16.0,0,0,0,1,1
Bilal Kısa,0,47.0,0,0,0,1,1
Bilal Mohammed,0,30.0,0,0,2,0,2
Bilal Sidibé,0,16.0,1,0,1,0,1
Bill Looby,0,176.0,0,0,0,4,4
Bill Tchato,0,88.0,0,0,0,1,1
Bill Tuiloma,3,174.0,0,0,1,2,3
Bill de Graaf,2,63.0,0,0,2,0,2
Billel Dziri,3,204.0,0,0,1,2,3
Billy Bingham,0,69.0,0,0,1,1,2
Billy Bremner,0,86.0,0,0,2,0,2
Billy Caskey,0,83.0,0,0,0,1,1
Billy Dodds,0,307.0,0,1,6,1,7
Billy Forbes,0,22.0,0,0,0,1,1
Billy Hamilton,2,200.0,0,0,1,3,4
Billy Humphries,0,54.0,0,0,0,1,1
Billy McAdams,0,168.0,0,0,3,0,3
Billy McClure,0,5.0,0,1,1,0,1
Billy McKinlay,0,101.0,0,0,1,2,3
Billy McNeill,0,33.0,0,0,2,0,2
Billy Simpson,0,60.0,0,0,1,0,1
Billy Steel,0,23.0,0,0,0,1,1
Billy Wright,0,212.0,0,0,6,0,6
Bima Sakti,0,51.0,0,0,1,0,1
Biplu Ahmed,0,81.0,0,0,0,1,1
Biram Kayal,0,81.0,0,0,1,0,1
Biren Basnet,0,90.0,0,0,1,0,1
Birkir Bjarnason,1,488.0,0,0,3,9,12
Birkir Már Sævarsson,1,100.0,1,0,0,2,2
Bixente Lizarazu,0,174.0,0,0,2,0,2
Bizwell Phiri,1,166.0,0,0,1,1,2
Bjarni Guðjónsson,0,73.0,0,0,1,0,1
Björn Andersson,0,27.0,0,0,1,0,1
Björn Bergmann Sigurðarson,1,25.0,0,0,0,1,1
Bjørn Borgen,1,64.0,0,0,0,1,1
Bjørn Helge Riise,0,74.0,0,0,0,1,1
Bjørn Maars Johnsen,0,173.0,0,0,1,2,3
Blagoje Marjanović,1,187.0,0,0,2,1,3
Blagoy Georgiev,0,171.0,0,0,0,2,2
Blaise Matuidi,1,21.0,0,0,0,2,2
Blaise Nkufo,0,269.0,0,0,3,2,5
Blas Pérez,10,1315.0,0,0,16,8,24
Blas Saruppo,2,165.0,0,0,3,0,3
Blati Touré,1,82.0,0,0,1,0,1
Blaž Slišković,0,50.0,0,0,1,0,1
Bledar Kola,2,252.0,0,1,3,1,4
Blerim Džemaili,2,250.0,0,1,3,2,5
Blessing Makunike,0,43.0,0,0,1,0,1
Bo Börjesson,0,137.0,0,0,2,1,3
Bo Larsson,1,380.0,0,3,4,4,8
Boaz Kofman,0,31.0,0,0,0,1,1
Bob Latchford,0,167.0,0,0,2,2,4
Bob Peeters,0,261.0,0,0,3,1,4
Boban Babunski,0,53.0,1,1,1,1,2
Boban Grnčarov,0,79.0,0,0,0,1,1
Boban Nikolov,0,162.0,0,0,1,2,3
Bobby Brennan,0,75.0,0,0,0,1,1
Bobby Chalmers,2,117.0,0,0,2,0,2
Bobby Charlton,2,703.0,0,0,9,5,14
Bobby Collins,1,74.0,0,0,0,1,1
Bobby Convey,0,67.0,0,0,1,0,1
Bobby Decordova-Reid,1,26.0,0,0,1,0,1
Bobby Despotovski,5,296.0,0,1,5,0,5
Bobby Hogg,0,86.0,1,0,0,1,1
Bobby Johnstone,0,42.0,0,0,1,0,1
Bobby Lennox,0,113.0,0,0,1,1,2
Bobby Murdoch,0,143.0,0,0,2,1,3
Bobby Smith,0,132.0,0,0,0,3,3
Bobby Sookram,0,90.0,0,0,0,1,1
Bobby Tambling,0,74.0,0,0,0,1,1
Bobby Wood,0,278.0,0,0,4,2,6
Bobo Bola,0,81.0,0,0,0,1,1
Bodunha,0,99.0,0,0,2,0,2
Bogdan Stancu,1,453.0,0,3,2,7,9
Bogi Løkin,0,47.0,0,0,1,0,1
Bohdan Masztaler,0,27.0,0,0,1,0,1
Bohumil Veselý,0,201.0,0,0,3,0,3
Boitumelo Mafoko,0,80.0,0,0,0,1,1
Bokang Mothoana,0,22.0,0,0,0,1,1
Boldyn Buman-Uchral,1,90.0,0,0,0,1,1
Bolombo Tokala,0,34.0,0,0,0,1,1
Bonaventure Djonkep,1,143.0,0,0,2,1,3
Bonaventure Kalou,1,191.0,0,1,3,1,4
Bongani Khumalo,0,20.0,0,0,1,0,1
Bongani Zungu,2,139.0,0,0,1,1,2
Bongokuhle Hlongwane,0,83.0,0,0,1,0,1
Boniek García,0,62.0,0,0,2,0,2
Boniface Simutowe,0,62.0,0,1,1,0,1
Bora Kostić,0,268.0,0,0,3,1,4
Boraî Bashir,0,58.0,0,0,1,0,1
Boris Cebotari,0,14.0,0,0,0,1,1
Boris Céspedes,0,45.0,0,0,0,1,1
Boris Kazakov,1,14.0,0,0,1,0,1
Boris Kopitović,0,49.0,1,0,1,0,1
Boris Tatushin,1,9.0,0,0,1,0,1
Borislav Dimitrov,0,2.0,0,0,1,0,1
Borna Barišić,0,44.0,0,0,1,0,1
Borče Jovanovski,0,35.0,0,0,0,1,1
Boualem Amirouche,0,97.0,0,1,1,1,2
Boualem Khoukhi,1,362.0,0,0,5,2,7
Boubacar Bagili,0,64.0,0,0,1,1,2
Boubacar Sanogo,1,255.0,0,0,4,2,6
Bouchaib El Moubarki,0,63.0,0,0,0,1,1
Boudewijn Zenden,1,174.0,0,0,4,0,4
Boujemaa Benkhrif,0,72.0,0,0,1,0,1
Boukari Adamou,0,17.0,0,0,0,1,1
Boulat Esmagambetov,0,92.0,0,0,2,1,3
Boulaye Dia,0,71.0,0,0,1,2,3
Boureima Zongo,1,83.0,0,0,1,0,1
Boycho Velichkov,0,44.0,0,0,2,0,2
Bozhidar Iskrenov,0,107.0,0,0,1,1,2
Bozhil Kolev,0,253.0,0,1,4,1,5
Bořek Dočkal,0,199.0,0,0,1,4,5
Boško Balaban,0,343.0,0,0,5,3,8
Boško Gjurovski,0,129.0,0,0,3,0,3
Boško Janković,0,81.0,0,0,1,2,3
Boštjan Cesar,0,365.0,0,0,2,5,7
Božidar Senčar,0,44.0,0,0,1,0,1
Brad Evans,0,90.0,0,0,0,1,1
Brad Maloney,0,106.0,0,0,2,0,2
Bradley August,0,54.0,0,0,1,0,1
Bradley Woods-Garness,0,83.0,0,0,1,0,1
Brahim Kerrit,1,89.0,0,0,0,1,1
Brahim Zafour,1,52.0,0,0,0,1,1
Brahima Korbeogo,0,83.0,0,0,1,0,1
Brahima Traore,0,81.0,0,0,1,0,1
Braian Samudio,1,33.0,0,0,0,1,1
Branco,4,214.0,0,1,1,4,5
Brandley Kuwas,1,7.0,0,0,0,1,1
Brandon Beresford,0,27.0,0,0,0,1,1
Brandon McDonald,0,37.0,0,0,1,0,1
Brandur Olsen,0,70.0,0,0,1,0,1
Branimir Subašić,0,6.0,0,0,1,0,1
Branislav Ivanović,0,371.0,0,0,3,4,7
Branko Bošković,0,89.0,1,0,1,1,2
Branko Brnovic,0,2.0,0,0,0,1,1
Branko Buljevic,0,55.0,0,0,1,1,2
Branko Ilić,0,88.0,0,0,1,0,1
Branko Oblak,1,100.0,0,0,3,0,3
Branko Zebec,1,128.0,0,0,0,2,2
Braulio Luna,0,75.0,0,0,0,1,1
Brayan Moya,0,86.0,0,0,2,0,2
Brede Hangeland,0,185.0,0,0,0,3,3
Breel Embolo,2,404.0,0,1,4,5,9
Brehima Traoré,0,125.0,0,0,2,0,2
Brek Shea,0,151.0,0,0,2,0,2
Brendan Augustine,1,39.0,0,0,1,0,1
Brendan Gan,0,26.0,0,0,1,0,1
Brenden Aaronson,0,141.0,0,0,1,1,2
Brent Fisher,4,137.0,0,0,4,0,4
Brent Sancho,1,25.0,1,0,1,0,1
Brett Emerton,1,834.0,0,1,8,7,15
Brett Holman,3,299.0,0,0,3,3,6
Brian Brendell,2,104.0,0,0,1,1,2
Brian Ching,0,431.0,0,0,7,1,8
Brian Flynn,0,219.0,0,1,2,3,5
Brian Hardman,0,90.0,0,0,1,0,1
Brian Haynes,0,41.0,0,0,0,1,1
Brian Kaltak,2,120.0,0,1,1,1,2
Brian Laudrup,5,805.0,0,0,9,7,16
Brian McBride,5,889.0,0,1,19,4,23
Brian McClair,1,34.0,0,0,2,0,2
Brian Mwila,0,102.0,0,0,3,0,3
Brian Onyango,0,19.0,0,0,1,0,1
Brian Philley,0,44.0,0,0,1,1,2
Brian Quinn,0,46.0,0,0,1,0,1
Brian Said,0,241.0,2,0,3,2,5
Brian Steen Nielsen,0,87.0,0,0,1,1,2
Brian Turner,0,504.0,0,1,5,6,11
Brice Dahité,1,89.0,0,1,1,0,1
Brice Jovial,2,143.0,0,0,0,2,2
Brice Mackaya,2,65.0,0,1,2,1,3
Briel Thomas,2,31.0,1,0,1,1,2
Brighton Sinyangwe,1,299.0,0,0,3,1,4
Britt Assombalonga,1,78.0,0,0,0,1,1
Bronisław Bula,0,90.0,0,0,1,1,2
Bror Mellberg,1,33.0,0,0,0,1,1
Brown Ideye,1,30.0,0,0,0,1,1
Bruce Murray,3,329.0,0,0,4,1,5
Bruce Rioch,0,93.0,0,0,2,0,2
Brunel Fucien,0,90.0,0,0,1,0,1
Bruno Akrapović,0,48.0,0,0,0,1,1
Bruno Alves,0,397.0,0,0,3,5,8
Bruno Bellone,0,99.0,0,0,1,1,2
Bruno Conti,1,154.0,0,0,3,0,3
Bruno Coutinho,1,85.0,0,0,1,0,1
Bruno Ecuele Manga,1,162.0,1,0,3,1,4
Bruno Fernandes,2,298.0,0,1,5,1,6
Bruno Guimarães,0,66.0,0,0,0,1,1
Bruno Martins Indi,0,48.0,0,0,0,2,2
Bruno Mauro,0,106.0,0,0,1,1,2
Bruno Michaud,0,33.0,1,0,0,1,1
Bruno Miranda,0,38.0,0,0,0,1,1
Bruno Mora,1,170.0,0,0,3,0,3
Bruno Petković,1,315.0,0,0,4,1,5
Bruno Pezzey,1,154.0,0,0,4,1,5
Bruno Valdez,0,11.0,0,0,1,0,1
Bruno Versavel,0,74.0,0,0,1,2,3
Bruno Zita Mbanangoyé,2,351.0,0,0,2,2,4
Brutil Hosé,2,123.0,0,0,2,0,2
Bryan Acosta,1,75.0,0,0,1,0,1
Bryan Hamilton,0,76.0,0,0,2,0,2
Bryan Joseph,0,13.0,0,0,1,0,1
Bryan Oviedo,1,7.0,0,0,1,0,1
Bryan Robson,3,582.0,0,0,6,8,14
Bryan Roy,1,139.0,0,0,1,3,4
Bryan Ruiz,6,1014.0,0,1,11,9,20
Brynjar Gunnarsson,0,168.0,0,0,2,2,4
Brynjar Ingi Bjarnason,0,78.0,0,0,1,0,1
Budi Johannis,0,90.0,0,0,1,0,1
Budi Sudarsono,1,109.0,0,0,2,2,4
Buenaventura Ferreira,2,180.0,0,0,2,1,3
Bukayo Saka,3,366.0,0,0,4,2,6
Burak Yılmaz,2,1012.0,0,4,12,10,22
Burhan Sargın,4,212.0,0,0,2,3,5
Burton Mugala,0,47.0,0,0,1,0,1
Bushara Abdel-Nadief,1,49.0,0,0,0,1,1
Byron Bonilla,0,46.0,0,0,1,0,1
Byron Bubb,0,169.0,0,0,1,1,2
Byron Tenorio,0,5.0,0,0,0,1,1
Byun Byung-joo,2,163.0,0,0,3,1,4
Bálint Vécsei,0,88.0,0,0,1,0,1
Bård Borgersen,0,129.0,0,0,0,2,2
Béla Illés,0,489.0,0,1,5,2,7
Béla Várady,0,227.0,0,0,3,1,4
Bülent Eken,0,44.0,0,0,1,0,1
Bülent Korkmaz,1,148.0,0,0,2,1,3
Bănel Nicoliţă,0,69.0,0,0,0,1,1
Cacau,1,70.0,0,0,1,0,1
Caetano Izzo,1,21.0,0,0,1,0,1
Cai Jinbiao,1,27.0,0,0,1,0,1
Cai Sheng,3,285.0,0,0,0,4,4
Cain Attard,0,98.0,0,0,2,0,2
Caio Canedo,1,148.0,0,0,4,0,4
Caio Ribeiro Decoussau,3,97.0,0,0,1,2,3
Callum McGregor,0,121.0,0,0,2,0,2
Callum Robinson,0,134.0,0,0,0,3,3
Calum Willock,0,51.0,0,0,2,0,2
Camara Toure,0,49.0,0,0,1,0,1
Cameron Hepple,0,36.0,0,1,0,1,1
Camille Dimmer,0,160.0,0,0,0,3,3
Camille Libar,0,4.0,0,0,1,0,1
Camille Wagner,0,3.0,0,0,0,1,1
Camillo Gonsalves,0,54.0,0,0,1,0,1
Camillo Jerusalem,0,15.0,0,0,1,0,1
Camilo Romero,1,59.0,1,0,1,0,1
Campbell Best,0,119.0,0,0,0,2,2
Capucho,0,64.0,0,0,1,0,1
Careca,8,698.0,0,1,12,2,14
Carey Harris,0,29.0,0,0,1,0,1
Carl Bertelsen,1,209.0,0,0,1,2,3
Carl Emil Christiansen,0,42.0,0,0,0,1,1
Carl Fister,0,58.0,0,0,1,0,1
Carl Fletcher,0,47.0,0,0,0,1,1
Carl Harris,0,67.0,0,0,0,1,1
Carl Medjani,0,140.0,0,0,1,1,2
Carl Robinson,0,37.0,0,0,0,1,1
Carl Valeri,1,82.0,0,0,0,1,1
Carl Veart,1,233.0,0,0,4,2,6
Carles Puyol,2,152.0,1,0,0,3,3
Carles Rexach,0,127.0,0,0,1,1,2
Carlo Corazzin,5,379.0,0,2,4,3,7
Carlo Costly,9,1202.0,0,0,15,7,22
Carlo Galli,1,48.0,0,0,0,1,1
Carlo Valentini,0,89.0,1,0,0,1,1
Carlos Aguilera,0,324.0,0,0,2,3,5
Carlos Alberto Raffo,5,497.0,0,0,6,4,10
Carlos Alberto Torres,1,86.0,0,0,1,0,1
Carlos Alonso,0,86.0,1,0,1,0,1
Carlos Andrés Sánchez,0,30.0,0,0,0,1,1
Carlos Aragonés,0,459.0,0,3,7,1,8
Carlos Arango,3,216.0,0,1,3,2,5
Carlos Astondoa,0,43.0,0,0,0,1,1
Carlos Babington,1,66.0,0,0,0,1,1
Carlos Bacca,1,166.0,0,0,3,2,5
Carlos Bernárdez,2,93.0,0,0,2,0,2
Carlos Bocanegra,0,314.0,0,0,6,2,8
Carlos Borges,7,311.0,0,0,1,7,8
Carlos Bueno,3,583.0,0,1,6,3,9
Carlos Báez,0,21.0,0,0,1,0,1
Carlos Campillo,2,31.0,0,0,1,1,2
Carlos Campos Sánchez,0,104.0,0,0,2,1,3
Carlos Castro Borja,0,157.0,0,1,4,1,5
Carlos Caszely,0,290.0,0,0,5,2,7
Carlos Cecconato,2,95.0,0,0,2,0,2
Carlos Chavarría,1,190.0,0,0,1,3,4
Carlos Chimomole,0,62.0,0,0,1,0,1
Carlos Discua,0,69.0,0,0,0,1,1
Carlos Dunga,0,54.0,0,0,1,0,1
Carlos Eduardo Gallardo,1,157.0,0,1,2,1,3
Carlos Edwards,0,68.0,0,0,1,2,3
Carlos Elizeche,1,7.0,0,0,1,0,1
Carlos Figueroa,0,15.0,0,0,1,0,1
Carlos Fumo Gonçalves,1,54.0,0,0,1,0,1
Carlos Gabriel Rodríguez,1,68.0,0,0,1,0,1
Carlos Gamarra,3,255.0,1,0,7,1,8
Carlos Geerman,0,19.0,1,0,1,0,1
Carlos Giudice,1,54.0,0,0,1,0,1
Carlos González,0,77.0,0,0,2,0,2
Carlos Gruezo,0,88.0,0,1,0,1,1
Carlos Guerini,0,89.0,0,0,1,0,1
Carlos Guirland,1,38.0,0,0,1,0,1
Carlos Gómez Sánchez,5,290.0,0,0,2,3,5
Carlos Hermosillo,3,863.0,0,0,15,3,18
Carlos Hernández,0,288.0,0,0,4,1,5
Carlos Humberto Paredes,0,333.0,0,0,7,1,8
Carlos Humberto Suazo,0,69.0,0,0,2,0,2
Carlos Izaguirre,2,112.0,0,0,2,1,3
Carlos Jara Saguier,0,116.0,0,0,1,1,2
Carlos José Báez,0,54.0,0,0,0,1,1
Carlos Lapetra,0,63.0,0,0,1,0,1
Carlos Lobatón,1,101.0,0,0,0,1,1
Carlos Loswijk,0,14.0,0,0,1,0,1
Carlos Maldonado,3,253.0,0,0,2,2,4
Carlos Manuel,1,241.0,0,0,3,3,6
Carlos Marchena,0,90.0,0,0,1,0,1
Carlos María Morales,1,53.0,0,0,1,0,1
Carlos Mejía,0,90.0,0,0,1,0,1
Carlos Miguel da Silva Júnior,1,57.0,0,0,1,0,1
Carlos Monteagudo,1,22.0,0,0,0,1,1
Carlos Morais Caló,0,159.0,0,0,0,3,3
Carlos Muñoz,1,54.0,0,0,2,1,3
Carlos Muñoz Cobo,0,206.0,0,0,3,1,4
Carlos Ochoa,1,90.0,0,0,1,0,1
Carlos Pavón,9,1553.0,0,5,23,11,34
Carlos Pedro Silva Morais,0,145.0,0,0,1,1,2
Carlos Peucelle,2,191.0,0,0,3,1,4
Carlos Peña,0,87.0,0,0,0,1,1
Carlos Pineda Alvarado,1,32.0,0,0,0,1,1
Carlos Reinoso,0,76.0,0,0,0,1,1
Carlos Reyes,0,44.0,0,0,1,0,1
Carlos Rivas,0,112.0,0,1,4,0,4
Carlos Rivera,1,33.0,0,0,1,0,1
Carlos Rojas,1,4.0,0,0,1,0,1
Carlos Romero,2,245.0,0,0,0,3,3
Carlos Ruiz,10,2115.0,0,4,32,15,47
Carlos Salcido,2,318.0,0,0,3,3,6
Carlos Saucedo,0,109.0,0,0,3,0,3
Carlos Scarone,2,235.0,0,1,3,3,6
Carlos Secretário,0,19.0,0,0,1,0,1
Carlos Septién,0,85.0,0,0,1,0,1
Carlos Soler,1,120.0,0,0,2,1,3
Carlos Soto,1,15.0,0,0,1,0,1
Carlos Sánchez,1,6.0,1,0,1,0,1
Carlos Tenorio,2,163.0,0,0,2,2,4
Carlos Tevez,5,386.0,0,0,6,1,7
Carlos Torres Garcés,0,64.0,0,1,1,0,1
Carlos Valderrama,3,217.0,0,1,3,3,6
Carlos Valdés,0,49.0,0,0,1,0,1
Carlos Varela,1,25.0,0,0,1,0,1
Carlos Vela,4,454.0,0,1,5,5,10
Carlos Verdejo,2,105.0,0,0,2,0,2
Carlos Vidal,2,68.0,0,0,2,0,2
Carlos Villanueva,1,86.0,0,0,0,1,1
Carlos Vivo Goban,0,51.0,0,0,1,0,1
Carlos Zambrano,0,107.0,0,0,1,1,2
Carlos Ángel López,0,5.0,0,0,0,1,1
Carlton Chapman,1,39.0,0,0,0,1,1
Carlton Palmer,0,78.0,0,0,1,0,1
Carlyle Mitchell,0,110.0,1,0,1,1,2
Carmel Busuttil,0,526.0,0,1,6,4,10
Carmelo Micciche,0,38.0,0,0,1,0,1
Carnejy Antoine,1,181.0,0,0,0,4,4
Carol Creiniceanu,0,75.0,0,0,1,0,1
Carolus Andriamatsinoro,2,108.0,0,0,1,1,2
Carsten Jancker,1,124.0,0,0,2,1,3
Carsten Ramelow,0,7.0,0,0,1,0,1
Carvalho Leite,3,101.0,0,0,3,0,3
Casemiro,1,191.0,0,0,3,1,4
Casiano Mba,0,67.0,0,0,0,1,1
Cassim Langaigne,0,76.0,0,0,0,1,1
Catalino Rivarola,0,129.0,0,0,3,0,3
Catilina Aubameyang,0,56.0,0,0,0,1,1
Cavafe,1,80.0,0,0,1,0,1
Cayetano Ré,4,117.0,0,0,1,3,4
Cecil Jones Attuquayefio,2,173.0,0,0,0,2,2
Cecilio Martínez,3,119.0,0,0,2,1,3
Cecilio Waterman,0,440.0,0,0,5,2,7
Cedric Itten,0,243.0,0,0,2,2,4
Cees Schapendonk,0,48.0,0,0,1,0,1
Ceferino Ramírez,3,228.0,0,0,0,3,3
Celino Mora,2,136.0,0,0,2,3,5
Celso Ayala,1,36.0,0,0,1,1,2
Celso Borges,6,767.0,0,1,10,7,17
Celso Pontes,0,59.0,0,0,1,0,1
Cemil Turan,0,348.0,0,1,5,2,7
Cengiz Ünder,1,170.0,0,0,2,2,4
Cenk Tosun,0,522.0,0,0,6,4,10
Cesc Fàbregas,4,327.0,0,0,4,2,6
Cesáreo Onzari,1,11.0,0,0,1,0,1
Cha Bum-kun,1,467.0,0,1,4,4,8
Cha Du-ri,1,77.0,0,0,2,0,2
Chaabane Merzekane,1,85.0,0,0,1,0,1
Chad Bertrand,1,34.0,0,0,1,0,1
Chadi Hammami,0,142.0,0,0,2,0,2
Chadrac Akolo,0,35.0,0,0,1,0,1
Chalwe Kunda,0,65.0,0,0,0,1,1
Chaminda Steinwall,1,28.0,0,0,0,1,1
Chan Fat Chi,0,79.0,0,0,0,1,1
Chan Ho Man,0,72.0,0,0,1,0,1
Chan Siu Ki,0,257.0,0,0,3,1,4
Chan Vathanaka,0,143.0,0,0,2,0,2
Chanathip Songkrasin,1,65.0,0,0,0,2,2
Chancel Mbemba,1,100.0,0,0,1,1,2
Chandradasa Karunaratne,0,82.0,0,0,1,0,1
Chang Han,0,31.0,0,0,1,0,1
Chang Kuo Chi,1,69.0,0,0,1,1,2
Chang Wu-yeh,0,57.0,0,0,1,0,1
Channa Ediri Bandanage,2,118.0,0,0,2,1,3
Chaouki Ben Saada,2,139.0,0,1,3,1,4
Charles Akonnor,3,321.0,0,0,4,1,5
Charles Alerte,1,44.0,0,0,0,1,1
Charles Amoah,0,112.0,0,0,2,1,3
Charles Antenen,2,277.0,0,0,2,4,6
Charles Aránguiz,2,251.0,0,0,2,4,6
Charles Ashley,0,6.0,0,0,0,1,1
Charles Galinie,1,90.0,0,0,0,1,1
Charles Hambira,2,81.0,1,0,1,1,2
Charles Hertig,0,42.0,0,0,0,1,1
Charles Imboula,0,85.0,0,0,0,1,1
Charles Jumanne,0,44.0,0,0,1,0,1
Charles Kaboré,0,97.0,0,0,2,0,2
Charles Lota,0,70.0,0,0,2,0,2
Charles Pollard,1,155.0,1,0,1,1,2
Charles Scerri,0,48.0,1,0,1,0,1
Charles Spiteri,0,77.0,1,0,0,1,1
Charles Vatú,0,26.0,0,0,1,0,1
Charlie Davies,1,174.0,0,0,1,3,4
Charlie Eliazar,0,58.0,0,0,2,0,2
Charlie Fleming,0,116.0,0,0,0,2,2
Charlie Nicholas,0,204.0,0,0,3,0,3
Charlie Yankos,0,227.0,0,1,3,1,4
Charlison Benschop,3,84.0,0,1,0,3,3
Charlton Vicento,0,89.0,0,0,0,1,1
Charly Loubet,0,272.0,0,0,4,1,5
Charly Musonda,0,44.0,0,1,2,0,2
Chaswe Nsofwa,0,164.0,0,0,2,1,3
Chathura Gunaratne,0,43.0,0,0,1,0,1
Chavdar Tsvetkov,0,395.0,0,0,4,1,5
Chavdar Yankov,0,195.0,0,0,2,1,3
Che Bunce,2,73.0,0,0,1,1,2
Che Chi Man,1,78.0,0,0,1,0,1
Chea Makara,0,90.0,0,0,1,1,2
Cheang Chon Man,1,13.0,0,0,0,1,1
Chedly Laaouini,1,53.0,0,0,1,0,1
Cheick Diabaté,2,267.0,0,1,2,3,5
Cheick Fantamady Diarra,1,75.0,0,0,1,0,1
Cheick Tioté,1,50.0,0,0,1,0,1
Cheikh Ba,0,63.0,0,0,1,0,1
Cheikh Gueye,0,205.0,1,0,1,2,3
Cheikh Moulaye Ahmed,0,71.0,0,0,0,1,1
Cheikh N'Doye,0,90.0,0,0,0,1,1
Cheikh Ndour,0,66.0,0,0,1,0,1
Cheikhou Kouyaté,1,88.0,0,0,2,0,2
Chen Fu-Yuan,1,78.0,0,0,0,1,1
Chen Jingang,2,226.0,0,0,1,2,3
Chen Jiunn-ming,0,90.0,0,0,0,1,1
Chen Jui-te,0,135.0,0,0,1,2,3
Chen Kuei-jen,1,78.0,0,0,0,1,1
Chen Po-liang,0,120.0,0,1,1,1,2
Chen Sing-an,0,41.0,0,0,0,1,1
Chen Tao,0,140.0,0,0,2,0,2
Chen Wei-chuan,0,77.0,1,0,1,0,1
Chen Xirong,1,55.0,0,0,0,1,1
Chen Yi-wei,0,21.0,0,0,1,0,1
Chencho Gyeltshen,0,191.0,0,0,3,1,4
Cheng Sin Siu,0,48.0,0,0,1,0,1
Cheng Siu Kwan,0,85.0,0,0,0,1,1
Cheng Siu Wai,2,212.0,0,0,2,2,4
Cherdsak Chaiyabutr,1,27.0,0,0,1,0,1
Cherkaoui Hafnaoui,1,60.0,0,0,1,0,1
Chernor Mansaray,0,78.0,0,0,2,0,2
Cheung Chi Tak,0,26.0,0,0,0,1,1
Cheung Ka-Ping,0,88.0,0,0,0,1,1
Cheung Kam Wa,1,39.0,0,0,1,1,2
Cheung Sai Ho,0,49.0,0,0,1,0,1
Cheung Yiu Kwok,1,39.0,0,0,1,0,1
Chhin Chhoeun,0,45.0,0,0,0,1,1
Chiang Shih-lu,0,66.0,0,0,0,1,1
Chico,2,346.0,0,0,6,0,6
Chico Faria,0,36.0,0,0,0,1,1
Chidi Odiah,0,51.0,0,0,1,0,1
Chiedozie Ogbene,0,165.0,0,0,0,2,2
Chinedu Obasi,1,12.0,0,0,0,1,1
Chinesinho,1,35.0,0,0,1,0,1
Chiukepo Msowoya,0,410.0,0,0,4,2,6
Cho Byung-kuk,0,51.0,0,0,1,0,1
Cho Gue-sung,2,164.0,0,0,2,1,3
Cho In-Chol,2,104.0,0,0,2,0,2
Cho Kwang-Rae,1,82.0,1,0,0,1,1
Cho Min-Kook,1,189.0,0,0,2,1,3
Cho Yoon-ok,0,163.0,0,0,4,0,4
Cho Young-cheol,1,45.0,0,0,1,0,1
Choe Chol-Man,0,28.0,0,0,0,1,1
Choe Kum-chol,0,144.0,0,0,1,1,2
Choe Yong-Son,3,302.0,0,0,3,2,5
Choi Chung-min,2,337.0,0,0,3,2,5
Choi Jae-pil,2,89.0,0,0,2,0,2
Choi Jin-cheul,1,89.0,0,0,0,2,2
Choi Jong-duk,1,203.0,0,0,2,1,3
Choi Kwang-seok,0,62.0,0,0,0,1,1
Choi Kwang-suk,0,77.0,0,0,0,2,2
Choi Moon-Sik,2,316.0,0,0,1,4,5
Choi Sang-Kuk,0,72.0,0,0,2,0,2
Choi Soon-ho,8,583.0,0,1,7,5,12
Choi Sung-kuk,1,66.0,0,0,1,0,1
Choi Won-nam,3,203.0,0,0,2,2,4
Choi Yong-soo,0,356.0,0,0,6,3,9
Choi York Yee,0,55.0,0,0,1,0,1
Cholponbek Esenkul Uulu,0,45.0,0,0,1,0,1
Chris Armas,0,51.0,0,0,1,0,1
Chris Baird,0,56.0,1,0,1,0,1
Chris Birchall,1,104.0,0,0,2,0,2
Chris Brunt,0,258.0,1,0,3,1,4
Chris Coleman,0,62.0,0,0,2,0,2
Chris Henderson,1,70.0,0,0,2,0,2
Chris Hughton,0,65.0,0,0,1,0,1
Chris Ikonomidis,1,54.0,0,0,1,0,1
Chris Jackson,0,270.0,0,1,3,2,5
Chris James,0,165.0,0,1,1,1,2
Chris Killen,2,404.0,0,0,10,0,10
Chris Lawler,0,74.0,0,0,1,0,1
Chris Malonga,0,116.0,0,0,1,1,2
Chris Martin,1,166.0,0,0,1,2,3
Chris McGrath,0,129.0,0,0,2,1,3
Chris Megaloudis,0,32.0,0,0,1,0,1
Chris Nicholl,0,23.0,0,0,1,1,2
Chris Nurse,0,149.0,0,0,1,1,2
Chris Sagramola,0,68.0,0,0,1,0,1
Chris Waddle,0,204.0,0,0,3,1,4
Chris Wondolowski,0,241.0,0,0,5,0,5
Chris Wood,11,929.0,0,2,10,11,21
Chris Zoricich,1,90.0,0,0,1,0,1
Christ Bongo,0,46.0,0,0,1,1,2
Christian Annan,0,23.0,0,0,1,0,1
Christian Atsu,2,153.0,0,0,3,0,3
Christian Atsu Twasam,1,109.0,0,0,1,1,2
Christian Bassogog,3,262.0,0,0,1,2,3
Christian Benteke,3,481.0,0,0,7,4,11
Christian Benítez,1,455.0,0,0,7,1,8
Christian Bolaños,1,332.0,0,0,4,2,6
Christian Callejas,1,90.0,0,0,1,0,1
Christian Chukwu,1,41.0,0,0,2,0,2
Christian Coste,0,16.0,0,0,0,1,1
Christian Cueva,2,477.0,0,2,6,5,11
Christian Dailly,0,104.0,0,0,1,2,3
Christian Dalger,0,89.0,0,0,1,0,1
Christian Eriksen,1,918.0,0,6,9,9,18
Christian Fassnacht,0,147.0,0,0,1,1,2
Christian Gytkjær,0,286.0,0,0,1,3,4
Christian Holst,0,101.0,0,0,2,0,2
Christian Høgni Jacobsen,0,78.0,0,0,0,1,1
Christian Javier Bautista,0,112.0,0,0,1,1,2
Christian Karembeu,0,29.0,0,0,0,1,1
Christian Lara,0,53.0,0,0,1,0,1
Christian Lopez,1,23.0,0,0,1,0,1
Christian M'Wokozhi,0,79.0,0,0,0,1,1
Christian Matthey,0,54.0,0,0,1,0,1
Christian Mayrleb,0,200.0,0,0,2,2,4
Christian Mouritsen,0,90.0,0,0,0,1,1
Christian Noboa,1,209.0,0,0,3,0,3
Christian Nørgaard,0,39.0,0,0,0,1,1
Christian Obodo,1,159.0,0,0,2,1,3
Christian Panucci,1,166.0,0,0,1,2,3
Christian Perez,0,3.0,0,0,0,1,1
Christian Poulsen,0,231.0,0,0,3,1,4
Christian Pulisic,1,894.0,0,2,12,4,16
Christian Ramos,0,114.0,0,0,1,1,2
Christian Santamaría,0,117.0,0,0,0,3,3
Christian Santos,0,64.0,0,0,0,1,1
Christian Stumpf,0,70.0,0,0,0,1,1
Christian Vieri,9,679.0,0,0,15,3,18
Christian Wilhelmsson,0,382.0,0,0,1,6,7
Christian Ziege,1,177.0,0,0,5,0,5
Christoffer Nyman,0,24.0,0,0,0,1,1
Christoph Baumgartner,1,145.0,0,0,1,3,4
Christoph Metzelder,0,20.0,1,0,0,1,1
Christophe Berra,0,9.0,0,0,1,0,1
Christophe Bonvin,0,54.0,0,0,1,0,1
Christophe Cocard,0,90.0,0,0,1,0,1
Christophe Dugarry,1,215.0,0,0,3,3,6
Christophe Jallet,0,68.0,0,0,1,0,1
Christophe Ohrel,0,297.0,0,0,4,2,6
Christopher Harry,0,82.0,0,1,1,0,1
Christopher Katongo,6,683.0,0,2,5,5,10
Christopher Samba,0,61.0,0,0,1,0,1
Christopher Trimmel,0,22.0,0,0,1,0,1
Christopher Wreh,0,51.0,0,0,2,0,2
Christos Aravidis,0,87.0,0,0,0,1,1
Christos Ardizoglou,0,71.0,0,0,1,0,1
Christos Kolliandris,0,57.0,0,0,1,1,2
Christos Patsatzoglou,0,82.0,0,0,0,1,1
Chrysis Michael,0,93.0,0,1,1,1,2
Chu Gyong-Sik,1,162.0,0,0,3,0,3
Chu Siu Kei,0,89.0,0,0,1,1,2
Chu Wing Wah,0,59.0,0,1,1,0,1
Chuan Tan Teng,0,58.0,0,1,1,0,1
Chuang Yao-tsung,0,23.0,0,0,1,0,1
Chun Keui Chiang,0,13.0,1,0,1,0,1
Chung Chor Wai,2,231.0,0,1,3,1,4
Chung Hae-won,3,424.0,0,0,4,2,6
Chung Jong-Soo,0,41.0,0,0,1,0,1
Chung Kyu-Poong,0,235.0,0,0,3,0,3
Chung Kyung-ho,0,55.0,0,0,0,1,1
Chung Nam-sik,0,42.0,0,0,0,2,2
Chung Soon-cheon,0,183.0,0,0,2,2,4
Chung Yong-Hwan,0,1.0,0,0,1,0,1
Chuni Goswami,1,77.0,0,0,0,1,1
Chus Pereda,0,182.0,0,0,5,0,5
Ché Adams,0,211.0,0,0,2,1,3
Chérif Fetoui,1,61.0,0,0,2,0,2
Chérif Oudjani,0,120.0,0,0,2,0,2
Chérif Souleymane,1,233.0,0,0,3,1,4
Chérif Touré Mamam,1,271.0,0,0,2,2,4
Ciaran Clark,1,71.0,1,0,0,1,1
Cicerone Manolache,0,8.0,0,0,1,0,1
Ciprian Deac,0,114.0,0,0,1,1,2
Ciprian Marica,0,765.0,0,3,11,6,17
Cipriano Co,0,60.0,0,1,1,0,1
Ciriaco Sforza,0,298.0,0,0,3,2,5
Ciro Immobile,0,768.0,0,1,7,6,13
Clarence Goodson,0,151.0,1,0,3,1,4
Clarence Seedorf,0,493.0,0,0,4,5,9
Claude Barthélemy,0,44.0,0,0,0,1,1
Claude Carrara,1,90.0,0,0,0,1,1
Claude Nahimana,0,107.0,0,0,1,1,2
Claude Reiter,0,52.0,0,1,0,1,1
Claudio Caniggia,7,635.0,0,0,8,4,12
Claudio Canti,0,29.0,1,0,1,0,1
Claudio García,1,57.0,0,0,1,0,1
Claudio Gentile,0,8.0,0,0,0,1,1
Claudio Husaín,0,89.0,0,0,0,1,1
Claudio Jara,0,33.0,0,0,0,1,1
Claudio López,1,412.0,0,0,4,4,8
Claudio Marchisio,1,36.0,0,0,0,2,2
Claudio Pizarro,3,438.0,0,1,7,3,10
Claudio Reyna,0,5.0,0,0,0,1,1
Claudio Sulser,0,188.0,0,0,5,0,5
Claudio Suárez,0,119.0,0,0,1,1,2
Claudiu Keșerü,0,514.0,0,0,4,5,9
Claus Bech Jørgensen,0,21.0,0,0,0,1,1
Claus Jensen,0,128.0,0,0,1,3,4
Claus Lundekvam,0,30.0,0,0,1,1,2
Clayton Blackmore,0,71.0,0,0,1,0,1
Clayton Donaldson,0,62.0,0,0,0,1,1
Clayton Failla,0,87.0,0,1,1,1,2
Clayton Lewis,1,90.0,0,1,1,0,1
Clayton Zane,6,366.0,0,0,4,2,6
Cle Kooiman,0,103.0,0,0,1,0,1
Clemens Fritz,0,69.0,0,0,2,0,2
Clement Temile,2,122.0,0,0,0,3,3
Clemente Rolón,0,97.0,0,0,2,0,2
Cleon Wondel,1,44.0,0,0,0,1,1
Clevon Hill,0,15.0,0,0,0,1,1
Cliff Jones,0,145.0,0,1,3,0,3
Cliff Magnam Valcin,0,204.0,0,0,1,2,3
Clifford Odame,0,72.0,0,1,1,0,1
Clifton Msiya,1,35.0,0,0,1,0,1
Clifton Sandvliet,0,178.0,0,0,3,1,4
Climaco Cañarte,0,74.0,0,0,1,0,1
Clint Dempsey,7,1684.0,0,4,30,11,41
Clint Marcelle,1,59.0,0,0,1,0,1
Clint Mathis,0,174.0,0,0,0,3,3
Clinton Morrison,0,160.0,0,0,1,3,4
Clinton N'Jie,1,69.0,0,0,1,1,2
Clive Campbell,0,16.0,0,0,1,0,1
Clive Murray,1,190.0,0,0,2,1,3
Clodoaldo,1,44.0,0,0,1,0,1
Cloudious Zviripayi,0,52.0,0,0,1,0,1
Clyde Best,0,51.0,0,0,0,1,1
Cláudio Christovam de Pinho,2,303.0,0,1,5,0,5
Cláudio Ibrahim Vaz Leal,0,107.0,0,0,1,1,2
Cléber Chalá,1,213.0,0,0,4,0,4
Clément Lenglet,0,52.0,0,0,1,0,1
Clésio,0,6.0,0,0,1,0,1
Clésio Baúque,0,84.0,0,0,1,0,1
Cobi Jones,1,436.0,0,0,3,3,6
Cody Gakpo,2,192.0,0,0,2,2,4
Coen Dillen,0,72.0,0,0,1,0,1
Coffi Agbessi,0,81.0,0,0,1,0,1
Colin Bell,0,198.0,0,0,2,1,3
Colin Bennett,0,85.0,0,0,0,1,1
Colin Calderwood,0,85.0,0,0,0,1,1
Colin Cameron,0,152.0,0,0,2,0,2
Colin Clarke,4,414.0,0,1,6,4,10
Colin Curran,1,58.0,1,0,1,0,1
Colin Hendry,0,129.0,0,0,2,1,3
Colin Hill,0,44.0,0,0,0,1,1
Colin Latimour,0,90.0,0,0,1,0,1
Colin Miller,1,153.0,0,0,1,2,3
Colin Murdock,0,58.0,0,0,1,0,1
Colin Stein,0,269.0,0,0,4,2,6
Colin Walker,0,214.0,0,1,4,0,4
Collen Salelwako,0,72.0,0,0,1,0,1
Collin Samuel,0,63.0,0,0,1,0,1
Collins Mbesuma,1,540.0,0,0,5,5,10
Comlan Lambert Sossa,0,21.0,0,0,0,1,1
Commins Menapi,10,624.0,0,0,5,7,12
Con Boutsianis,0,231.0,0,0,4,0,4
Con Martin,0,173.0,0,2,3,0,3
Connor Roberts,1,179.0,0,0,1,1,2
Conny Torstensson,1,140.0,0,0,1,1,2
Conor Casey,0,121.0,0,0,0,2,2
Conor Hourihane,0,36.0,0,0,1,0,1
Conor McLaughlin,0,66.0,0,0,1,0,1
Conor Washington,0,199.0,0,1,1,3,4
Constantin Barbu,0,53.0,0,0,0,1,1
Constantin Budescu,0,120.0,0,1,2,2,4
Constantin Dinulescu,0,81.0,0,0,1,0,1
Constantin Frățilă,0,213.0,0,0,3,2,5
Constantin Gâlcă,0,182.0,0,0,3,0,3
Constantin Pană,0,55.0,0,0,1,0,1
Constantin Stanciu,1,79.0,0,0,0,1,1
Constantinos Charalambides,0,277.0,0,0,6,0,6
Constantinos Makrides,0,152.0,0,0,3,1,4
Cor van der Gijp,0,57.0,0,0,2,0,2
Cordell Cato,1,14.0,0,0,1,0,1
Corentin Tolisso,0,9.0,0,0,0,1,1
Cornel Cacoveanu,0,67.0,0,0,1,0,1
Cornel Dinu,0,85.0,0,0,1,0,1
Cornelio Heredia,1,140.0,0,2,0,2,2
Cornelius Casey,0,20.0,0,0,0,1,1
Cornelius Stewart,0,134.0,0,0,2,1,3
Cornell Glen,1,234.0,0,0,2,2,4
Corriolan Wadson,1,71.0,0,0,1,0,1
Corry Evans,0,70.0,0,0,0,1,1
Cory Burke,1,14.0,0,0,0,1,1
Cosme da Silva Campos,0,114.0,0,0,1,1,2
Cosmin Contra,0,522.0,1,0,3,5,8
Costa Khaiseb,0,89.0,0,0,1,0,1
Costakis Pierides,0,31.0,0,0,1,0,1
Costas Costa,0,63.0,0,0,0,1,1
Costas Fasouliotis,0,87.0,0,0,1,0,1
Costin Lazăr,0,129.0,0,0,1,1,2
Costinha,1,90.0,0,0,0,1,1
Covi Adé,1,81.0,0,0,0,1,1
Craig Beattie,0,89.0,0,0,1,0,1
Craig Bellamy,0,348.0,0,0,2,5,7
Craig Burley,1,87.0,0,0,2,0,2
Craig Cathcart,0,31.0,0,0,0,1,1
Craig Foster,5,404.0,0,0,6,1,7
Craig Goodwin,1,81.0,0,0,1,1,2
Craig Mackail-Smith,0,32.0,0,0,0,1,1
Craig Moore,1,38.0,0,1,0,1,1
Crescencio Gutiérrez,0,209.0,0,0,5,1,6
Cris,0,84.0,1,0,1,0,1
Cristhian Stuani,0,122.0,0,0,1,1,2
Cristian Arrieta,0,4.0,0,0,1,0,1
Cristian Brolli,0,85.0,3,0,2,1,3
Cristian Castillo,0,104.0,0,0,1,1,2
Cristian Chivu,1,29.0,0,0,0,2,2
Cristian Gamboa,0,85.0,1,0,2,1,3
Cristian Gil,0,31.0,0,0,1,0,1
Cristian Gonzáles,0,90.0,0,0,4,0,4
Cristian Manea,0,18.0,0,0,1,0,1
Cristian Martínez,0,111.0,0,0,0,3,3
Cristian Montecinos,3,240.0,0,0,1,2,3
Cristian Queliz,0,87.0,0,0,0,1,1
Cristian Ramírez,0,23.0,0,0,1,0,1
Cristian Riveros,2,450.0,0,0,6,2,8
Cristian Rodríguez,1,414.0,0,0,4,4,8
Cristian Romero,0,3.0,0,0,0,1,1
Cristian Tănase,0,112.0,0,0,1,1,2
Cristian Zaccardo,1,105.0,1,0,1,1,2
Cristiano Ronaldo,18,4901.0,0,16,50,41,91
Cristián Zapata,0,8.0,0,0,0,1,1
Cristóbal Parralo,0,5.0,0,0,1,0,1
Csaba Vidáts,0,111.0,0,0,2,0,2
Cuauhtémoc Blanco,14,1983.0,0,11,23,11,34
Curtis Joseph,0,64.0,0,0,2,0,2
Custódio Pinto,0,19.0,0,0,0,1,1
Cuthbert Malajila,0,83.0,0,0,0,1,1
Cyle Larin,9,784.0,0,2,13,7,20
Cyril Mourgine,0,32.0,0,0,1,0,1
Cyrille Bayala,1,25.0,0,0,1,0,1
Cyrille Makanaky,0,78.0,0,0,0,1,1
Cyrille Mubiala Kitambala,0,21.0,0,0,1,0,1
Cyrus Christie,1,27.0,0,0,0,1,1
Cédric Amissi,0,231.0,0,0,4,0,4
Cédric Bakambu,4,213.0,0,1,0,5,5
Cédric Soares,1,86.0,0,0,1,0,1
Cédrick Fiston,1,54.0,0,0,1,0,1
Célestin Oliver,0,17.0,0,0,2,0,2
César Augusto Freire,1,47.0,0,0,0,1,1
César Azpilicueta,1,57.0,0,0,0,1,1
César Brito,0,22.0,0,0,1,0,1
César Cabrera,3,135.0,0,0,1,2,3
César Cueto,1,151.0,0,0,3,0,3
César Delgado,1,119.0,0,0,1,1,2
César Eduardo González,1,120.0,0,1,2,0,2
César García Peralta,0,41.0,0,0,0,1,1
César Garnica,0,51.0,0,0,1,0,1
César Larios,0,58.0,0,0,1,0,1
César Lolohea,0,271.0,0,0,3,1,4
César López Fretes,4,234.0,0,0,2,2,4
César Martín,0,119.0,0,0,2,0,2
César Obando,0,330.0,0,1,4,1,5
César Rostrán,0,65.0,0,0,0,1,1
César Sampaio,3,107.0,0,0,3,1,4
César Socarraz,1,53.0,0,0,0,1,1
César Yanis,1,126.0,0,0,1,1,2
César Zeoula,1,38.0,0,1,1,0,1
Cătălin Carp,0,29.0,0,0,1,0,1
Cătălin Munteanu,0,30.0,0,0,1,0,1
D'Andre Bishop,1,45.0,0,0,1,0,1
DaMarcus Beasley,1,755.0,0,0,11,2,13
Daan Schrijvers,0,48.0,0,1,1,0,1
Dadley Fichite,0,105.0,0,0,0,2,2
Dado Pršo,1,351.0,0,0,7,1,8
Dag Szepanski,0,57.0,0,1,1,0,1
Dagne Tesfaye,0,37.0,0,0,1,0,1
Dagoberto Moll,2,107.0,0,0,0,2,2
Dahi Al Naemi,1,151.0,0,0,2,2,4
Dahiru Sadi,0,18.0,0,0,1,0,1
Dahmed Ould Teguedi,0,68.0,0,0,0,1,1
Dai Davies,0,24.0,1,0,1,0,1
Daichi Kamada,0,192.0,0,0,3,0,3
Dairon Reyes,1,90.0,0,0,1,0,1
Daizen Maeda,1,43.0,0,0,1,0,1
Dale Mitchell,3,389.0,0,0,4,2,6
Daler Kuzyayev,0,3.0,0,0,0,1,1
Daley Blind,1,62.0,0,0,1,1,2
Dalibor Stevanović,0,68.0,0,0,0,1,1
Dalton Eiley,1,49.0,1,0,1,0,1
Damani Horton,0,66.0,0,0,1,0,1
Damani Ralph,0,77.0,0,0,1,0,1
Dame N'Doye,1,144.0,0,0,2,0,2
Damian Kądzior,0,84.0,0,0,1,0,1
Damian Mori,5,928.0,0,0,23,2,25
Damian Szymański,0,90.0,0,0,1,0,1
Damien Duff,1,140.0,0,0,1,2,3
Damien Kamilou,0,90.0,0,0,0,1,1
Damion Lowe,0,56.0,0,0,1,0,1
Damion Stewart,1,45.0,0,0,1,0,1
Damir Desnica,0,90.0,0,0,0,1,1
Damir Kojašević,0,36.0,0,0,0,1,1
Damián Ariel Álvarez,0,89.0,0,0,0,1,1
Damon Ming,0,151.0,0,0,3,1,4
Dan Brzokoupil,0,61.0,0,0,0,1,1
Dan Coe,0,23.0,0,0,0,1,1
Dan Corneliusson,0,215.0,0,0,4,2,6
Dan Eggen,1,126.0,0,0,1,1,2
Dan Einbinder,0,66.0,0,0,0,1,1
Dan Petrescu,1,485.0,0,0,6,2,8
Dan Wagalauka,0,75.0,0,0,1,0,1
Dane Richards,0,165.0,0,0,2,0,2
Dangelo Bautista,0,62.0,1,0,1,0,1
Dango Ouattara,1,45.0,0,0,1,0,1
Dani Alves,1,312.0,0,0,2,3,5
Dani Güiza,2,338.0,0,0,0,4,4
Dani Olmo,1,204.0,0,0,3,1,4
Dani Osvaldo,0,186.0,0,0,0,4,4
Daniar Kenzhekhanov,0,23.0,0,0,1,0,1
Daniel Addo,0,64.0,0,0,1,0,1
Daniel Agger,1,304.0,1,5,6,1,7
Daniel Alejandro Lembo,1,22.0,0,0,1,0,1
Daniel Amokachi,4,598.0,0,0,7,3,10
Daniel Anyanzwa,0,44.0,0,0,1,0,1
Daniel Arismendi,0,139.0,0,0,3,0,3
Daniel Arudhi Nicodémus,1,60.0,0,0,1,0,1
Daniel Ballard,0,20.0,0,0,0,1,1
Daniel Batista Lima,0,125.0,0,0,2,0,2
Daniel Bertoni,2,278.0,0,0,4,0,4
Daniel Borimirov,1,132.0,0,0,3,0,3
Daniel Braaten,0,87.0,0,0,2,0,2
Daniel Chitsulo,0,47.0,0,0,1,1,2
Daniel Cousin,1,297.0,0,0,3,2,5
Daniel Díaz,0,56.0,0,0,1,0,1
Daniel Ebomoa,0,19.0,0,0,0,1,1
Daniel Fonseca,1,258.0,0,0,4,1,5
Daniel Gygax,0,84.0,0,0,0,1,1
Daniel Hasler,0,123.0,1,0,0,2,2
Daniel Imbert,2,228.0,0,0,2,2,4
Daniel James,0,156.0,0,0,2,1,3
Daniel Jeandupeux,0,10.0,0,0,1,0,1
Daniel Jensen,0,119.0,0,0,0,2,2
Daniel Jimenez,1,23.0,0,0,1,0,1
Daniel Johnson,0,50.0,0,0,1,0,1
Daniel Kaufmann,0,20.0,1,0,1,0,1
Daniel Killer,0,111.0,0,0,3,0,3
Daniel Kolář,0,90.0,0,0,0,1,1
Daniel Majstorović,0,52.0,0,0,1,0,1
Daniel Niculae,0,127.0,0,0,2,0,2
Daniel Noriega,0,45.0,0,0,1,1,2
Daniel O'Shaughnessy,0,73.0,0,0,0,1,1
Daniel Osorno,3,360.0,0,0,4,2,6
Daniel Pancu,0,215.0,0,0,2,3,5
Daniel Passarella,2,231.0,0,2,4,2,6
Daniel Pinto,1,166.0,0,0,1,1,2
Daniel Prodan,0,82.0,0,0,1,0,1
Daniel Pudil,0,79.0,0,0,0,2,2
Daniel Reyes,0,88.0,0,0,0,1,1
Daniel Ruiz,2,198.0,0,1,1,3,4
Daniel Shepherd,1,55.0,0,0,0,1,1
Daniel Sjölund,0,53.0,0,0,1,0,1
Daniel Sosah,0,114.0,0,0,1,1,2
Daniel Sturridge,2,339.0,0,1,5,1,6
Daniel Ulloa,0,49.0,1,0,0,1,1
Daniel Van Buyten,0,465.0,0,0,1,6,7
Daniel Velasquez,0,3.0,0,0,0,1,1
Daniel Veyt,1,59.0,0,0,0,1,1
Daniel Wass,0,14.0,0,0,1,0,1
Daniel Xuereb,0,44.0,0,0,0,1,1
Daniel da Mota,0,159.0,0,0,2,1,3
Daniel Šmejkal,0,5.0,0,1,1,0,1
Daniele De Rossi,4,621.0,0,3,11,4,15
Daniele Massaro,1,48.0,0,0,1,0,1
Danijel Ljuboja,0,88.0,0,0,0,1,1
Danijel Pranjić,0,90.0,0,0,1,0,1
Danilo Alvim,0,79.0,0,0,1,0,1
Danilo Menezes,0,61.0,0,0,1,0,1
Danilo Montero Campos,1,108.0,0,0,0,2,2
Danilo Pereira,0,42.0,0,0,1,0,1
Danilo Popivoda,0,76.0,0,0,2,0,2
Danilo Turcios,1,264.0,0,0,3,2,5
Danival,0,132.0,0,0,1,2,3
Danko Lazović,0,301.0,0,0,2,3,5
Danny,0,140.0,0,0,1,1,2
Danny Blind,0,87.0,0,0,0,1,1
Danny Halligan,0,200.0,0,1,2,1,3
Danny Hay,1,88.0,0,0,1,0,1
Danny Koevermans,0,43.0,0,0,1,0,1
Danny Moulis,2,270.0,0,0,2,1,3
Danny Mrwanda,0,148.0,0,0,1,1,2
Danny Tiatto,1,24.0,0,0,1,0,1
Danny Wabo,0,37.0,0,0,1,0,1
Danny Ward,0,49.0,1,0,1,0,1
Danny Welbeck,1,752.0,0,0,8,4,12
Dante,0,45.0,0,0,1,0,1
Dante Leverock,2,106.0,0,0,1,2,3
Danylo Sikan,0,90.0,0,0,0,1,1
Daoud Midtadi,0,6.0,0,0,0,1,1
Dare Vršič,0,135.0,0,0,2,0,2
Darijo Srna,2,538.0,0,2,8,5,13
Darimosuvito Devaraj,0,121.0,0,0,2,0,2
Darimosuvito Tokijan,0,125.0,0,0,4,0,4
Dario Khan,2,67.0,2,0,1,1,2
Dario Pereyra,0,72.0,0,0,2,0,2
Dario Sierra,0,40.0,1,0,0,1,1
Dario Zuffi,0,64.0,0,0,0,1,1
Dario Đumić,0,82.0,0,0,1,0,1
Dario Šimić,0,91.0,0,0,0,2,2
Darius Maciulevičius,0,129.0,0,0,2,2,4
Darius Miceika,0,85.0,0,0,1,0,1
Darius Vassell,0,75.0,0,0,1,0,1
Dariusz Adamczuk,0,36.0,0,0,1,0,1
Dariusz Dudka,0,6.0,0,0,1,0,1
Dariusz Dziekanowski,0,427.0,0,0,6,3,9
Dariusz Marciniak,0,26.0,0,0,0,1,1
Darko Churlinov,0,83.0,0,0,0,1,1
Darko Kovačević,1,129.0,0,0,2,0,2
Darko Maletić,0,90.0,0,0,1,0,1
Darko Pančev,3,651.0,0,0,11,2,13
Darko Velkovski,0,205.0,2,0,2,3,5
Darren Anderton,1,20.0,0,0,0,1,1
Darren Bent,0,134.0,0,0,0,3,3
Darren Debono,0,37.0,1,0,1,0,1
Darren Fletcher,0,163.0,0,0,3,1,4
Darren Jackson,0,80.0,0,0,0,1,1
Darren Mattocks,4,401.0,0,2,4,3,7
Darren McClennan,0,297.0,0,0,6,2,8
Darren O'Dea,0,88.0,0,0,0,1,1
Darryl Gomez,0,16.0,0,0,1,0,1
Darryl Lachman,0,41.0,0,0,0,1,1
Darryl Roberts,0,76.0,0,0,0,2,2
Darvydas Šernas,0,166.0,0,1,1,3,4
Darwin Cerén,0,157.0,0,1,1,2,3
Darwin Lom,1,23.0,0,0,1,1,2
Darwin Machís,2,209.0,0,0,3,2,5
Darwin Núñez,0,73.0,0,0,0,1,1
Daryl Dike,0,73.0,0,0,2,0,2
Daryl Ferguson,0,86.0,1,0,1,0,1
Daryl Murphy,0,101.0,0,0,2,1,3
Darío Franco,2,40.0,0,0,2,0,2
Darío Lezcano,0,198.0,0,0,2,2,4
Darío Muchotrigo,0,22.0,0,0,1,0,1
Darío Rodríguez,1,137.0,0,0,3,0,3
Darío Silva,4,445.0,0,0,7,5,12
Darío Verón,0,57.0,0,0,1,0,1
Datsakorn Thonglao,0,327.0,0,0,1,4,5
Dave Bowen,0,63.0,0,0,0,1,1
Dave Clements,0,69.0,0,0,1,0,1
Dave Gibson,0,42.0,0,0,1,0,1
Dave Mitchell,0,449.0,0,0,7,1,8
Dave Taylor,0,222.0,0,0,3,0,3
Davi Banda,1,48.0,0,0,1,0,1
David Abdul,0,85.0,0,0,1,0,1
David Alaba,0,510.0,0,5,6,5,11
David Arellano,1,382.0,0,0,8,0,8
David Ayo,0,90.0,0,0,1,0,1
David Beckham,3,780.0,0,3,7,6,13
David Ben Dayan,0,65.0,0,0,1,0,1
David Brooks,0,77.0,0,0,0,1,1
David Carabott,1,273.0,0,2,1,4,5
David Carney,1,153.0,0,0,1,1,2
David Connolly,0,179.0,0,0,4,1,5
David Cotterill,0,13.0,0,0,1,0,1
David Edgar,0,168.0,0,0,2,0,2
David Edwards,0,84.0,0,0,1,1,2
David Embé,1,76.0,0,0,1,1,2
David Firisua,1,84.0,0,0,1,0,1
David Fleurival,2,80.0,0,0,0,2,2
David Giles,0,63.0,0,0,1,1,2
David Ginola,0,85.0,0,0,2,0,2
David Goodwillie,0,66.0,0,1,0,1,1
David Healy,0,1175.0,0,3,15,7,22
David Henry,0,61.0,0,0,0,1,1
David Herd,0,144.0,0,0,2,0,2
David Hopkin,0,142.0,0,0,2,0,2
David Jarolím,0,49.0,0,0,1,0,1
David Kelly,0,78.0,0,0,0,1,1
David Kipiani,1,165.0,0,0,1,1,2
David Lafata,0,242.0,0,0,2,2,4
David Limberský,0,13.0,0,0,0,1,1
David Lowery,0,31.0,0,0,1,0,1
David Luiz,0,87.0,0,0,2,0,2
David Martínez,0,7.0,0,0,1,0,1
David McCaulay,0,28.0,0,0,1,0,1
David McGoldrick,0,85.0,0,0,1,0,1
David Muchineripi,0,29.0,0,0,1,0,1
David Mulligan,0,188.0,0,0,2,1,3
David Nakhid,1,52.0,0,0,1,0,1
David Narey,1,18.0,0,0,0,1,1
David Nugent,1,90.0,0,0,0,1,1
David Nyathi,1,79.0,0,0,0,1,1
David O'Leary,0,40.0,0,0,1,0,1
David Obua,0,328.0,0,1,2,3,5
David Ospina,0,77.0,1,0,1,0,1
David Oteo,0,59.0,0,0,1,0,1
David Owino,0,6.0,0,0,1,0,1
David Paniagua,0,46.0,0,0,0,1,1
David Patiño,2,63.0,0,0,0,2,2
David Phillips,0,63.0,0,0,1,0,1
David Platt,2,568.0,0,0,7,5,12
David Powell,0,83.0,0,0,1,0,1
David Provan,0,54.0,0,0,1,0,1
David Ramírez,2,120.0,0,0,2,0,2
David Ratcliffe,0,32.0,0,0,1,0,1
David Rugamas,1,398.0,0,0,2,6,8
David Silva,5,916.0,0,0,13,7,20
David Siradze,0,340.0,0,0,4,1,5
David Stokes,0,30.0,0,0,1,0,1
David Strelec,0,123.0,0,0,2,0,2
David Suazo,2,569.0,0,0,6,5,11
David Targamadze,0,19.0,0,0,1,0,1
David Trezeguet,3,763.0,0,0,9,5,14
David Turpel,0,219.0,0,0,2,2,4
David Vaughan,0,16.0,0,0,0,1,1
David Villa,18,2063.0,0,4,26,15,41
David Watson,0,111.0,0,0,2,1,3
David Weir,0,53.0,0,0,1,0,1
David Wotherspoon,1,25.0,0,0,0,1,1
David Zdrilic,2,908.0,0,0,17,0,17
David Zeman,0,16.0,1,0,1,0,1
Davide Astori,1,24.0,0,0,0,1,1
Davide Gualtieri,1,1.0,0,0,1,0,1
Davide Simoncini,0,24.0,2,0,2,0,2
Davie Cooper,0,195.0,0,2,3,1,4
Davie Wilson,0,37.0,0,0,0,1,1
Davit Janashia,0,66.0,0,0,0,1,1
Davit Mujiri,0,16.0,0,0,0,1,1
Davor Jozić,2,130.0,0,0,1,1,2
Davor Vugrinec,0,319.0,0,0,2,2,4
Davor Šuker,8,1774.0,0,6,15,17,32
Davron Ergashev,0,81.0,0,0,0,1,1
Davy Arnaud,0,6.0,0,0,1,0,1
Davy Klaassen,1,278.0,0,0,2,4,6
Davy Pröpper,0,112.0,0,0,2,1,3
Davy Walsh,0,92.0,0,0,1,1,2
Dawa Hotessa,0,4.0,0,0,0,1,1
Dawit Fekadu,0,83.0,0,0,2,0,2
Dawood Ali,0,54.0,0,0,1,0,1
Dayro Moreno,0,82.0,0,0,1,0,1
Dean Furman,0,125.0,0,0,1,1,2
Dean Saunders,0,637.0,0,1,8,7,15
Dean Shiels,0,14.0,0,0,1,0,1
Debatik Curri,0,67.0,0,0,0,1,1
Declan Edge,0,13.0,0,0,1,0,1
Declan Rice,0,87.0,0,0,0,1,1
Deco,2,202.0,0,1,3,1,4
Dede Sulaiman,0,248.0,0,0,3,1,4
Deepak Amatya,1,19.0,0,0,0,1,1
Deepak Lama,1,67.0,0,0,0,1,1
Deividas Česnauskis,0,41.0,0,0,0,1,1
Deivydas Matulevičius,0,67.0,0,0,1,2,3
Dejan Damjanović,0,409.0,0,1,1,6,7
Dejan Govedarica,1,101.0,1,0,2,0,2
Dejan Jakovic,1,28.0,0,0,0,1,1
Dejan Lazarević,0,73.0,0,0,1,0,1
Dejan Ljubičić,0,83.0,0,0,1,0,1
Dejan Lovren,0,234.0,0,0,0,3,3
Dejan Savićević,6,642.0,0,1,10,4,14
Dejan Stanković,2,338.0,0,1,3,6,9
Dejo Fayemi,0,125.0,0,1,1,1,2
Dejvi Glavevski,0,80.0,0,0,0,3,3
Dele Alli,1,97.0,0,0,1,1,2
Delfín Benítez Cáceres,1,44.0,0,0,0,1,1
"Delio ""Maravilla"" Gamboa",3,122.0,0,1,2,1,3
Delio Gamboa,2,238.0,0,0,1,2,3
Delio Toledo,0,10.0,0,0,1,0,1
Delron Buckley,0,102.0,0,0,0,3,3
Delvin N'Dinga,0,75.0,0,0,0,1,1
Demar Phillips,3,300.0,0,0,6,0,6
Demba Camara,0,23.0,0,0,1,0,1
Demba Malick,0,45.0,0,0,0,1,1
Deme N'Diaye,1,10.0,0,0,0,1,1
Demetrio Albertini,0,88.0,0,0,1,1,2
Demetrio Angola,1,75.0,0,0,0,1,1
Demetrio Neyra,0,31.0,0,0,1,0,1
Demetris Christofi,0,326.0,0,1,3,2,5
Demis Nikolaidis,0,359.0,0,0,5,3,8
Demont Mitchell,0,52.0,0,0,1,0,1
Demóstenes Correia de Syllos,1,29.0,0,0,1,0,1
Deng Chyan,0,90.0,0,0,1,0,1
Deng Zhuoxiang,1,216.0,0,0,0,3,3
Deni Milošević,0,80.0,0,0,1,0,1
Denijal Pirić,0,60.0,0,0,0,1,1
Denil Maldonado,0,10.0,1,0,0,1,1
Denis Calincov,0,90.0,0,0,0,1,1
Denis Caniza,0,19.0,1,0,1,0,1
Denis Cheryshev,0,425.0,1,0,4,6,10
Denis Glushakov,1,258.0,0,0,3,1,4
Denis Houf,0,16.0,0,0,0,1,1
Denis Irwin,0,11.0,0,1,2,0,2
Denis Knitel,1,20.0,0,0,1,0,1
Denis Kovba,0,18.0,0,0,1,0,1
Denis Law,0,344.0,0,0,4,3,7
Denis Obua,2,185.0,0,0,0,3,3
Denis Zakaria,1,125.0,1,0,1,2,3
Denis Zmeu,0,30.0,0,0,1,0,1
Deniss Ivanovs,0,71.0,0,0,0,1,1
Deniz Bozkurt,0,16.0,0,0,1,0,1
Deniz Türüç,0,57.0,0,0,0,1,1
Denmark Casey,0,60.0,0,0,0,1,1
Dennis Alas,1,81.0,0,0,1,0,1
Dennis Bergkamp,10,1398.0,0,1,15,12,27
Dennis Bryce,0,12.0,0,0,1,0,1
Dennis Lawrence,0,120.0,0,0,1,1,2
Dennis Lota,4,297.0,0,0,5,2,7
Dennis López,0,123.0,0,0,1,1,2
Dennis Man,0,145.0,0,0,0,3,3
Dennis Marshall,1,56.0,0,0,1,0,1
Dennis Mizzi,0,23.0,0,0,0,1,1
Dennis Oliech,1,694.0,0,0,11,5,16
Dennis Praet,1,82.0,0,0,1,1,2
Dennis Purperhart,0,14.0,0,0,1,0,1
Dennis Rennie,0,90.0,0,0,1,0,1
Dennis Rommedahl,2,488.0,0,0,4,11,15
Dennis Salanović,0,85.0,0,0,0,1,1
Dennis Tindall,0,50.0,0,0,0,1,1
Dennis Tueart,0,4.0,0,0,1,0,1
Dennis Viollet,0,37.0,0,0,1,0,1
Dennis Wilshaw,0,163.0,0,0,0,3,3
Dennis Wise,0,32.0,0,0,0,1,1
Densill Theobald,0,73.0,0,0,1,0,1
Denys Harmash,0,108.0,0,0,1,1,2
Denzel Dumfries,1,281.0,0,0,4,0,4
Denílson de Oliveira Araújo,4,277.0,0,0,4,1,5
Denís Milar,0,116.0,0,1,2,0,2
Deon Burton,0,439.0,0,0,5,3,8
Deon Kavendji,0,77.0,0,0,1,0,1
Deon McCaulay,7,962.0,0,1,8,10,18
Derby Makinka,0,98.0,0,0,2,0,2
Dereck Somanje,0,53.0,0,0,1,0,1
Derek Dougan,0,139.0,0,0,2,2,4
Derek Kevan,2,140.0,0,0,1,1,2
Derek Malas,1,137.0,0,0,2,0,2
Derek Spence,0,151.0,0,0,1,1,2
Derlis González,2,229.0,0,1,1,3,4
Derlis Soto,0,165.0,0,0,2,0,2
Dermot Curtis,0,144.0,0,0,1,2,3
Derrick Edwards,0,328.0,0,0,4,2,6
Derrick Etienne,0,63.0,0,0,1,0,1
Derrik Garden,0,81.0,1,0,1,0,1
Des Palmer,0,155.0,0,0,3,0,3
Deshawon Nembhard,1,81.0,0,0,1,0,1
Desiderio Medina,0,59.0,0,0,3,0,3
Desmond Armstrong,0,31.0,1,0,1,0,1
Desmond Bleau,0,60.0,0,0,0,1,1
Desmond Fa'aiuaso,5,254.0,0,0,1,4,5
Devarr Boyles,0,6.0,0,0,1,0,1
Devaughn Elliott,0,44.0,0,0,0,1,1
Devaun DeGraff,0,43.0,0,0,0,2,2
Dever Orgill,0,56.0,0,0,2,0,2
Devi Muka,0,90.0,0,0,1,0,1
Devin Vega,0,62.0,0,0,1,0,1
Devon Jarrett,2,117.0,0,0,1,1,2
Dewan Chand,2,49.0,0,0,2,0,2
Dexter Blackstock,0,25.0,0,0,1,0,1
Dexter Walker,0,88.0,0,0,1,0,1
Dezső Molnár,0,70.0,0,0,0,1,1
Dezső Novák,2,270.0,0,1,3,0,3
Dhurgham Ismail,1,135.0,0,1,0,2,2
Diadie Samassékou,1,60.0,0,0,0,1,1
Diafra Sakho,0,93.0,0,0,0,2,2
Diamantino Miranda,1,151.0,0,0,3,0,3
Dick Kauma,1,89.0,0,0,0,1,1
Dick Nanninga,0,300.0,0,0,1,3,4
Dick Schneider,0,48.0,0,1,1,0,1
Dick Schoenaker,2,251.0,0,0,3,3,6
Dick van Dijk,0,35.0,0,0,1,0,1
Dickson Makwaza,0,83.0,0,0,1,0,1
Didargylyç Urazow,0,90.0,0,0,1,0,1
Didi,13,761.0,0,1,12,2,14
Didi Torrico,0,87.0,0,0,1,0,1
Didier Deschamps,0,51.0,0,0,2,0,2
Didier Drogba,11,1529.0,0,6,20,11,31
Didier Six,2,401.0,0,0,5,2,7
Didier Ya Konan,1,90.0,0,0,1,0,1
Didier Zokora,0,21.0,0,0,1,0,1
Diego,1,184.0,0,1,1,1,2
Diego Antonio Reyes,1,38.0,0,0,1,0,1
Diego Bejarano,0,105.0,0,0,1,1,2
Diego Calvo,0,82.0,0,0,1,0,1
Diego Costa,3,411.0,0,0,3,6,9
Diego Forlán,9,1436.0,0,3,16,12,28
Diego Fuser,1,29.0,0,0,1,1,2
Diego García,1,107.0,0,0,1,1,2
Diego Gavilán,0,77.0,0,0,0,1,1
Diego Godín,2,400.0,2,0,2,5,7
Diego Latorre,1,3.0,0,0,1,0,1
Diego Lugano,1,245.0,0,0,4,3,7
Diego Maradona,8,812.0,0,1,12,3,15
Diego Milito,1,90.0,0,0,1,0,1
Diego Pérez,1,32.0,0,0,1,1,2
Diego Reyes,0,58.0,0,0,0,1,1
Diego Rolán,0,96.0,0,0,2,0,2
Diego Simeone,5,279.0,0,0,6,2,8
Diego Tristán,0,195.0,0,0,3,0,3
Dieter Erler,0,273.0,0,0,3,1,4
Dieter Müller,3,429.0,0,0,2,4,6
Dieter Ramusch,0,78.0,0,0,0,1,1
Dietmar Hamann,0,14.0,0,0,0,1,1
Dietmar Kühbauer,0,58.0,0,0,3,0,3
Dietrich Albrecht,0,50.0,0,0,1,0,1
Dieudonné Bassanguen,0,90.0,0,0,1,0,1
Dieudonné Londo,0,55.0,0,0,1,0,1
Dieudonné Minoungou,1,50.0,0,0,1,0,1
Dieumerci Mbokani,5,653.0,0,6,9,6,15
Dieuphane Thelamour,0,83.0,0,0,1,0,1
Dikilu Bageta,0,88.0,0,1,1,0,1
Dilshod Vasiev,0,71.0,0,0,1,0,1
Dimitar Baikushev,0,27.0,0,0,1,0,1
Dimitar Berbatov,0,1396.0,0,1,14,14,28
Dimitar Makriev,0,90.0,0,0,1,0,1
Dimitar Penev,0,132.0,1,0,1,1,2
Dimitar Rangelov,0,79.0,0,0,3,0,3
Dimitar Telkiyski,0,157.0,0,0,3,0,3
Dimitar Yakimov,1,187.0,0,0,2,2,4
Dimitri Payet,0,313.0,0,0,5,0,5
Dimitri Ramothe,1,4.0,0,0,1,0,1
Dimitrij Nazarov,0,206.0,0,0,4,0,4
Dimitris Kokkinakis,0,61.0,0,0,0,1,1
Dimitris Kolovos,0,85.0,0,0,0,1,1
Dimitris Limnios,0,35.0,0,0,0,1,1
Dimitris Markos,0,23.0,0,0,1,0,1
Dimitris Mavrogenidis,0,85.0,0,0,0,1,1
Dimitris Papadopoulos,0,17.0,0,0,1,0,1
Dimitris Pelkas,0,90.0,0,0,0,1,1
Dimitris Salpingidis,2,418.0,0,1,6,4,10
Dimitris Saravakos,0,280.0,0,0,5,3,8
Dinardo Rodríguez,0,103.0,0,1,2,2,4
Diniyar Bilyaletdinov,0,231.0,0,0,3,1,4
Dinko Dermendzhiev,1,284.0,0,0,4,2,6
Dino Baggio,2,359.0,0,0,5,1,6
Dino da Costa,0,56.0,0,0,0,1,1
Dinos Kouis,0,260.0,0,0,2,3,5
Diogo Jota,0,276.0,0,0,1,5,6
Dioh Williams,0,78.0,0,0,1,0,1
Dioko Kaluyituka,0,126.0,0,0,2,2,4
Diomandé Losseni,2,94.0,0,0,0,2,2
Diomansy Kamara,1,66.0,0,0,0,1,1
Dioni Guerra,0,8.0,0,0,1,0,1
Dionisio Arce,7,280.0,0,1,2,5,7
Dionisio Fernandes,0,50.0,0,0,1,0,1
Dionisio Mejía,1,267.0,0,0,7,0,7
Diphetogo Selolwane,0,188.0,0,0,3,2,5
Dipsy Selolwane,1,153.0,0,1,3,1,4
Diquan Adamson,0,7.0,0,0,0,1,1
Dirceu,3,113.0,0,0,3,0,3
Dirk Kuyt,2,834.0,0,2,10,5,15
Divock Origi,1,147.0,0,0,2,0,2
Diógenes Domínguez,2,193.0,0,0,2,1,3
Djakaridja Koné,1,144.0,0,0,2,0,2
Djalma Campos,1,80.0,0,0,1,1,2
Djalma Santos,1,18.0,0,1,1,0,1
Djalminha,2,97.0,0,0,2,0,2
Djamel Amani,0,189.0,0,0,3,0,3
Djamel Belmadi,0,34.0,0,0,1,0,1
Djamel Menad,1,523.0,0,0,9,3,12
Djamel Zidane,2,132.0,0,0,2,1,3
Djibril Cissé,0,326.0,0,0,3,3,6
Djibril Ouattara,0,49.0,0,0,0,1,1
Djibril Sidibé,0,84.0,0,1,1,0,1
Djihad Bizimana,0,16.0,0,0,1,0,1
Djima Oyawolé,0,52.0,0,0,1,1,2
Djiman Koukou,0,62.0,0,0,0,1,1
Djimy Alexis,1,81.0,0,0,1,0,1
Djogou Akoulassi,0,53.0,0,0,0,1,1
Djumadurdy Meredov,2,186.0,0,0,2,1,3
Dmitri Alenichev,0,176.0,0,0,3,1,4
Dmitri Bulykin,1,169.0,0,0,6,0,6
Dmitri Cheryshev,0,86.0,0,0,0,1,1
Dmitri Khokhlov,0,64.0,0,0,2,0,2
Dmitri Kirichenko,1,166.0,0,0,3,0,3
Dmitri Kombarov,0,54.0,0,1,1,0,1
Dmitri Loskov,0,145.0,0,2,2,0,2
Dmitri Radchenko,1,280.0,0,0,4,2,6
Dmitri Sychev,1,604.0,0,0,4,5,9
Dmitri Torbinski,1,112.0,0,0,0,1,1
Dmitri Yurist,0,75.0,0,0,1,0,1
Dmitriy Shomko,0,90.0,1,0,1,1,2
Dmitry Byakov,0,328.0,0,0,4,3,7
Dmitry Verkhovtsov,0,203.0,0,0,2,1,3
Dobromir Tashkov,0,53.0,0,0,0,1,1
Dobromir Zhechev,1,40.0,0,0,1,0,1
Dobrosav Krstić,0,9.0,0,0,1,0,1
Doctor Khumalo,1,21.0,0,0,0,1,1
Doeur Sokhom,3,123.0,0,0,2,1,3
Dollah Kassim,0,70.0,0,0,1,0,1
Dollah Salleh,4,389.0,0,1,6,1,7
Dom Dwyer,0,50.0,0,0,1,0,1
Domagoj Vida,0,175.0,0,0,1,1,2
Domen Črnigoj,0,51.0,0,0,0,2,2
Domenic Mobilio,0,169.0,0,0,2,1,3
Domenico Berardi,0,14.0,0,0,1,0,1
Domiciano Cavém,0,97.0,0,0,1,1,2
Domingo Peralta,1,162.0,0,0,1,2,3
Domingo Pérez,1,173.0,0,0,1,2,3
Domingo Tarasconi,0,109.0,0,0,1,1,2
Domingos Paciência,1,291.0,0,0,5,3,8
Domingues,0,119.0,0,1,1,2,3
Dominic Abui Pretino,0,5.0,0,0,1,0,1
Dominic Adiyiah,0,73.0,0,0,2,0,2
Dominic Calvert-Lewin,0,74.0,0,0,2,0,2
Dominic Gabriel,1,35.0,0,0,0,1,1
Dominic Kinnear,1,52.0,0,0,1,0,1
Dominik Szoboszlai,0,229.0,0,0,4,0,4
Dominique Bathenay,0,138.0,0,0,1,1,2
Dominique Fred,1,19.0,0,0,0,1,1
Dominique Rocheteau,4,388.0,0,0,9,1,10
Dominique da Silva,0,82.0,0,1,1,0,1
Don Annacoura,0,52.0,0,0,1,0,1
Don Givens,0,552.0,0,0,10,2,12
Don Hutchison,0,173.0,0,0,1,3,4
Don Masson,1,78.0,0,1,0,1,1
Donald Peláez,1,148.0,0,0,0,3,3
Donald-Olivier Sié,3,324.0,0,0,2,2,4
Donaldo Rosales,0,66.0,0,0,1,1,2
Donatas Kazlauskas,0,79.0,0,0,1,0,1
Donatas Vencevicius,0,88.0,0,0,0,1,1
Donato Gama da Silva,0,112.0,0,0,1,1,2
Donny van de Beek,0,85.0,0,0,0,1,1
Donorovyn Lkhümbengarav,0,41.0,0,0,0,1,1
Donyell Malen,0,319.0,0,0,2,2,4
Dor Peretz,0,177.0,0,0,2,1,3
Dorel Stoica,0,118.0,1,0,1,1,2
Dorin Goian,0,164.0,0,0,3,0,3
Dorin Mateuț,0,239.0,0,0,5,1,6
Dorinel Munteanu,1,635.0,0,0,4,9,13
Dorlan Pabón,0,92.0,0,0,1,1,2
Dorny Romero,2,49.0,0,1,0,2,2
Dorset Langiagne,0,56.0,0,0,1,0,1
Dorukhan Toköz,0,40.0,0,0,0,1,1
Dossa Júnior,0,60.0,1,0,1,1,2
Doudou Diongue,1,10.0,0,0,0,1,1
Doug Utjesenovic,0,11.0,0,0,1,0,1
Dougie Freedman,0,44.0,0,0,1,0,1
Douglas Aziz,1,22.0,0,1,1,0,1
Douglas Cadeño,0,6.0,0,0,1,0,1
Douglas Costa,1,113.0,0,0,3,0,3
Douglas Sequeira,0,12.0,0,0,0,1,1
Dové Womé,1,135.0,0,0,0,2,2
Doyle Vaca,0,41.0,0,0,1,0,1
Dragan Dimitrovski,0,62.0,0,0,0,1,1
Dragan Džajić,2,673.0,0,0,8,7,15
Dragan Mladenović,0,73.0,0,0,1,0,1
Dragan Načevski,0,63.0,0,0,1,0,1
Dragan Pantelić,0,60.0,0,2,2,0,2
Dragan Stojković,4,683.0,0,2,4,7,11
Dragiša Binić,0,35.0,0,0,1,0,1
Drago Vabec,0,83.0,0,0,1,0,1
Dragoslav Šekularac,0,132.0,0,0,3,0,3
Dramane Coulibaly,0,131.0,0,1,3,0,3
Dramane Traoré,1,34.0,0,0,0,1,1
Dražan Jerković,4,501.0,0,0,1,7,8
Dražen Ladić,0,17.0,1,0,0,1,1
Dražen Mužinić,0,18.0,0,0,0,1,1
Dries Mertens,3,574.0,0,0,9,3,12
Driss Bamous,1,54.0,0,0,1,0,1
Dshon Forbes,1,78.0,0,0,0,1,1
Du Zhenyu,0,22.0,0,0,1,0,1
Duaij Naser Abdulla,1,167.0,0,0,2,0,2
Duane Muckette,1,36.0,0,0,1,0,1
Duberty Aráoz,1,30.0,1,0,0,1,1
Duckens Nazon,4,517.0,0,1,3,8,11
Duddley Hatei,0,61.0,0,0,1,0,1
Dudley Steinwall,0,81.0,0,0,1,0,1
Dudu Georgescu,0,504.0,0,2,8,1,9
Duh Deng-Sheng,0,171.0,0,0,0,2,2
Duilio Davino,1,143.0,0,0,1,1,2
Duje Ćaleta-Car,0,22.0,0,0,0,1,1
Dumisa Ngobe,1,43.0,0,0,1,0,1
Dumitru Marcu,0,50.0,0,0,2,0,2
Duncan Cole,0,36.0,0,0,1,0,1
Duncan Edwards,0,143.0,0,0,2,0,2
Duncan Oughton,2,155.0,0,0,2,0,2
Duncan Shearer,0,29.0,0,0,0,1,1
Dunga,1,11.0,0,0,1,0,1
Dusit Chalermsan,1,96.0,0,0,0,2,2
Dustin Corea,1,90.0,0,0,0,1,1
Duván Zapata,2,188.0,0,0,2,1,3
Dušan Bajević,3,243.0,0,0,3,3,6
Dušan Basta,0,19.0,0,0,1,0,1
Dušan Galis,0,47.0,0,0,1,0,1
Dušan Kabát,0,112.0,0,0,0,2,2
Dušan Savić,0,161.0,0,0,1,1,2
Dušan Tadić,0,488.0,0,5,6,4,10
Dušan Tittel,0,266.0,0,0,3,2,5
Dušan Vlahović,1,226.0,0,1,4,1,5
Dušan Švento,0,14.0,0,0,0,1,1
Duško Tošić,0,4.0,0,0,0,1,1
Dwayne De Rosario,6,678.0,0,5,12,3,15
Dwayne Stanford,0,80.0,0,0,1,0,1
Dwayne Thomas,0,2.0,0,0,0,1,1
Dwight Allers Kelley,0,141.0,0,0,2,1,3
Dwight Ferguson,0,89.0,1,0,1,0,1
Dwight Pezzarossi,0,613.0,0,0,4,4,8
Dwight Yorke,1,537.0,0,2,7,3,10
Dylan Bronn,2,173.0,1,0,2,1,3
Dylan Tavares,0,19.0,0,0,1,0,1
Dzhomikhon Mukhiddinov,0,51.0,0,0,1,0,1
Dzintars Zirnis,0,13.0,1,0,0,1,1
Dániel Böde,0,327.0,0,0,4,1,5
Dániel Gazdag,0,153.0,0,0,1,2,3
Dániel Tőzsér,0,77.0,0,0,1,0,1
Dário Monteiro,0,360.0,0,0,4,1,5
Dávid Hancko,0,85.0,0,0,0,1,1
Dávid Holman,0,71.0,0,0,0,1,1
Dölgöön Amaraa,0,17.0,0,0,1,0,1
Döwlet Baýramow,0,20.0,0,0,0,1,1
Dāvis Ikaunieks,0,90.0,0,0,1,1,2
Džemaludin Mušović,0,42.0,0,0,0,1,1
Dževdet Šainovski,0,55.0,0,0,0,1,1
Džoni Novak,0,107.0,0,0,0,2,2
E. Karitea,1,66.0,0,0,0,1,1
Eamonn Bannon,0,77.0,0,0,0,1,1
Eamonn Rogers,0,63.0,0,1,2,0,2
Earl Jean,0,158.0,0,0,3,2,5
Earnie Stewart,0,640.0,0,0,8,3,11
Ebbe Sand,1,626.0,0,0,9,4,13
Eber Moas,0,72.0,0,0,1,0,1
Eberhard Vogel,0,337.0,0,1,4,4,8
Ebi Smolarek,0,231.0,0,0,4,0,4
Ebrahim Isa,0,42.0,0,0,1,0,1
Ebrahim Taghipour,0,151.0,0,0,0,2,2
Ebrahim Zowayed,0,57.0,0,0,0,1,1
Ebrima Ebou Sillah,0,58.0,0,0,1,0,1
Ed Murphy,0,200.0,0,0,2,2,4
Eddie Gray,0,15.0,0,0,1,0,1
Eddie Hernández,0,147.0,0,0,1,1,2
Eddie Johnson,1,800.0,0,1,11,5,16
Eddie Krncevic,2,507.0,0,0,2,5,7
Eddie Lewis,0,162.0,0,0,1,3,4
Eddie McMorran,0,54.0,0,0,0,1,1
Eddie Pope,0,70.0,0,0,4,0,4
Eddie Rukumana,0,83.0,0,0,1,1,2
Eddie Theobald,0,112.0,0,1,1,1,2
Eddy Bembuana-Keve,1,48.0,0,0,1,0,1
Eddy Berdusco,0,68.0,0,0,1,0,1
Eddy Carazas,1,30.0,0,0,1,0,1
Eddy Voordeckers,0,135.0,0,0,2,0,2
Edelbert Dinha,0,82.0,0,0,1,0,1
Edema Fuludu,0,14.0,0,0,1,0,1
Eden Ben Basat,0,299.0,0,0,3,3,6
Eden Hazard,5,1267.0,0,6,16,8,24
Eder,0,109.0,0,0,0,1,1
Edgar Alvarez,0,50.0,0,0,1,0,1
Edgar Angulo,0,53.0,0,0,1,0,1
Edgar Babayan,0,79.0,0,0,0,1,1
Edgar Bernhardt,0,131.0,0,2,3,1,4
Edgar Davids,1,125.0,0,0,2,0,2
Edgar Falch,0,74.0,1,0,1,0,1
Edgar Manucharyan,0,145.0,0,0,1,1,2
Edgar Marín,0,164.0,0,0,1,2,3
Edgar Núñez,0,90.0,0,0,1,0,1
Edgar Olivares,0,10.0,0,0,1,0,1
Edgar Salli,0,40.0,0,0,0,1,1
Edgar Valencia,0,19.0,0,0,1,0,1
Edgar Çani,0,112.0,0,0,2,0,2
Edgaras Jankauskas,0,280.0,0,1,5,2,7
Edgaras Utkus,0,14.0,1,0,1,0,1
Edgaras Česnauskis,0,124.0,0,0,0,2,2
Edgard Meulens,0,65.0,0,0,0,1,1
Edgardo Adinolfi,0,51.0,0,0,1,0,1
Edgars Gauračs,0,77.0,0,0,1,0,1
Edhem Šljivo,0,7.0,0,0,1,0,1
Edibily Lunyamila,0,52.0,0,0,1,0,1
Edimilson Fernandes,0,90.0,0,0,1,0,1
Edin Džeko,3,1902.0,0,2,24,18,42
Edin Mujčin,0,19.0,0,0,1,0,1
Edin Sprečo,0,84.0,0,0,1,1,2
Edin Višća,0,353.0,0,0,6,1,7
Edinho,0,90.0,0,0,1,0,1
Edino Nazareth Filho,1,79.0,0,0,1,0,1
Edinson Cavani,10,1394.0,0,3,20,10,30
Edison Flores,3,614.0,0,0,3,7,10
Edivaldo Hermoza,0,47.0,0,0,0,1,1
Edixon Perea,2,100.0,0,0,1,1,2
Edixon Perea Valencia,0,78.0,0,0,1,0,1
Edmar Halovskyi de Lacerda,0,32.0,0,0,1,0,1
Edmond Abazi,0,77.0,0,0,1,0,1
Edmond Apéti Kaolo,3,165.0,0,1,0,3,3
Edmond Kapllani,0,253.0,0,0,2,3,5
Edmund Conen,4,250.0,0,0,0,4,4
Edmund Waterval,0,180.0,0,0,2,0,2
Edmundo,3,153.0,0,0,3,0,3
Edmundo Alves de Souza Neto,2,74.0,0,0,1,1,2
Edmílson,1,38.0,0,0,0,1,1
Edo Ophof,1,22.0,0,1,0,1,1
Edrissa Sonko,0,79.0,0,0,1,0,1
Edson Castillo,1,51.0,0,0,1,0,1
Edson Minga,0,88.0,0,0,2,0,2
Edson Puch,2,102.0,0,0,0,2,2
Edson Tortolero,1,199.0,1,2,2,1,3
Edson Álvarez,2,234.0,1,0,0,3,3
Eduard Abazi,0,65.0,0,0,1,0,1
Eduard Bello,0,64.0,0,0,1,0,1
Eduard Glieder,0,125.0,0,0,2,1,3
Eduard Kozynkevych,0,90.0,0,0,1,0,1
Eduard Malofeyev,3,300.0,0,0,1,5,6
Eduard Moss,0,42.0,0,0,0,1,1
Eduard Spertsyan,0,56.0,0,0,1,0,1
Eduard Streltsov,1,189.0,0,0,1,3,4
Eduardo Antunes Coimbra,0,138.0,0,0,1,1,2
Eduardo Bennett,7,688.0,0,5,9,3,12
Eduardo Chavarria,0,130.0,0,0,2,0,2
Eduardo Espinoza,1,76.0,0,0,1,0,1
Eduardo Fernando Gomes,0,145.0,0,1,2,1,3
Eduardo González Palmer,0,145.0,0,0,2,0,2
Eduardo González Valiño,0,3.0,0,0,1,0,1
Eduardo Guzmán,1,6.0,0,0,0,1,1
Eduardo Hurtado,0,581.0,0,0,10,0,10
Eduardo Ithurbide,0,5.0,0,0,0,1,1
Eduardo Laing,1,60.0,0,0,1,0,1
Eduardo Machado,0,83.0,0,0,0,1,1
Eduardo Malásquez,0,49.0,0,1,0,2,2
Eduardo Mario Acevedo,0,45.0,0,0,1,0,1
Eduardo Mingo,2,61.0,0,0,0,2,2
Eduardo Retat,0,75.0,0,0,0,1,1
Eduardo Ricagni,0,84.0,0,0,1,0,1
Eduardo Sebrango,2,283.0,0,0,2,3,5
Eduardo Vargas,12,1231.0,0,0,13,13,26
Eduardo Vilarete,0,58.0,0,0,0,1,1
Eduardo da Silva,0,1034.0,0,0,9,9,18
Eduvigis Rudolfo Dirksz,0,66.0,0,0,0,2,2
Edvard Lasota,1,63.0,0,0,1,0,1
Edvin Murati,0,145.0,0,0,2,1,3
Edward Acquah,0,449.0,0,0,5,2,7
Edward Aggrey-Fynn,0,116.0,0,1,2,0,2
Edward Boateng,0,44.0,0,0,1,0,1
Edward Herrera,0,77.0,0,0,1,0,1
Edward Jankowski,0,200.0,0,0,1,3,4
Edward Jildo,0,17.0,0,0,1,0,1
Edward Semwanga,1,31.0,0,0,0,1,1
Edwin Cardona,1,312.0,0,0,2,2,4
Edwin Clarcke,3,95.0,0,0,3,0,3
Edwin Congo,1,112.0,0,0,0,2,2
Edwin Gyasi,0,63.0,0,0,1,0,1
Edwin Miliano Loran,2,64.0,0,0,2,0,2
Edwin Mukenya,0,61.0,0,0,1,0,1
Edwin Rarai,1,82.0,0,0,0,1,1
Edwin Schal,0,90.0,0,0,1,0,1
Edwin Solano,1,52.0,0,0,1,0,1
Edwin Sánchez,0,78.0,0,0,0,1,1
Edwin Villatoro,0,74.0,0,0,0,1,1
Edwin Westphal,2,126.0,0,0,2,0,2
Edy Dublin,0,26.0,0,0,0,1,1
Edzai Kasinauyo,0,83.0,0,0,1,0,1
Edílson,0,78.0,0,0,1,1,2
Edú Marangón,1,33.0,0,0,1,0,1
Efe Ambrose,0,87.0,0,0,1,0,1
Efrain Chacurian,0,42.0,0,0,0,1,1
Efraín Juárez,1,55.0,0,0,1,0,1
Efstathios Aloneftis,0,445.0,0,0,7,2,9
Egil Østenstad,0,75.0,0,0,1,0,1
Egil á Bø,0,83.0,0,0,0,1,1
Egisto Pandolfini,2,104.0,0,1,2,1,3
Egor Filipenko,0,32.0,0,0,1,0,1
Egor Krimets,0,86.0,0,0,0,1,1
Egzon Bejtulai,0,86.0,1,0,0,1,1
Ehsan Hajsafi,2,186.0,0,3,3,1,4
Ehson Panjshanbe,0,9.0,0,0,0,1,1
Eimantas Poderis,0,66.0,0,0,0,1,1
Einar Daníelsson,0,28.0,0,0,0,1,1
Einar Gunnarsson,0,89.0,1,0,1,0,1
Einar Jan Aas,0,3.0,0,0,0,1,1
Eitan Tibi,0,22.0,0,0,0,1,1
Eiður Guðjohnsen,0,1018.0,0,2,13,8,21
Ekanit Panya,0,51.0,0,0,1,0,1
Eko Purdjianto,0,78.0,0,0,0,1,1
El Arbi Hababi,0,16.0,0,0,1,0,1
El Fardou Ben Nabouhane,1,4.0,0,0,0,1,1
El Hadji Diouf,1,658.0,0,1,12,3,15
El Hadji Oumar Guèye,1,37.0,0,0,0,1,1
Eladio Benítez,0,8.0,0,0,1,0,1
Eladio Rojas,0,119.0,0,0,2,0,2
Eladio Zárate,4,115.0,0,0,1,3,4
Elano,2,217.0,0,0,3,0,3
Elba de Padua Lima,1,10.0,0,0,1,0,1
Elbasan Rashani,0,90.0,0,0,0,1,1
Elcio Martina,0,90.0,0,0,0,1,1
Eldar Hansen,1,87.0,0,0,0,1,1
Eldar Ćivić,0,57.0,0,0,0,1,1
Eldor Shomurodov,5,592.0,0,0,6,6,12
Elek Nyilas,0,109.0,0,1,0,2,2
Eli Ohana,0,428.0,0,1,7,1,8
Elias Hossain,0,76.0,0,0,1,0,1
Elias Maguri,0,43.0,0,0,1,0,1
Elias Pelembe,0,63.0,0,0,1,0,1
Elias Tshimanga,1,90.0,0,0,1,0,1
Elias Uzamukunda,0,58.0,0,0,0,1,1
Elie Aiboy,1,122.0,0,0,2,1,3
Eligio Antonio Insfrán,1,30.0,0,0,0,1,1
Elijah Joseph,0,26.0,0,0,1,0,1
Elijah Just,1,71.0,0,0,1,0,1
Elijah Litana,3,124.0,0,0,3,1,4
Elijah Tana,1,49.0,0,0,2,1,3
Eliphas Shivute,2,198.0,0,0,0,5,5
Eliran Atar,0,83.0,0,0,0,1,1
Eliseo Prado,0,63.0,0,0,1,0,1
Eliseo Quintanilla,1,441.0,0,2,7,0,7
Eliseu,0,87.0,0,0,1,0,1
Eljero Elia,0,82.0,0,0,0,1,1
Eljif Elmas,0,535.0,0,0,7,1,8
Elkeson,0,313.0,0,1,2,2,4
Elkin Soto,0,134.0,0,0,1,1,2
Elly Adero,0,30.0,0,0,1,0,1
Ellyes Skhiri,0,93.0,0,0,2,0,2
Elmar Geirsson,0,44.0,0,0,0,1,1
Elmer Acevedo,0,119.0,0,0,1,1,2
Elmer Martínez,0,51.0,0,0,0,1,1
Elmo Kambindu,0,53.0,0,0,0,1,1
Elos Elonga-Ekakia,0,159.0,0,0,0,2,2
Eloy,1,70.0,0,0,0,1,1
Eloy Olaya,0,87.0,0,0,0,2,2
Elrio van Heerden,3,142.0,0,0,2,1,3
Elroy Kuylen,1,111.0,0,0,1,2,3
Elroy Smith,0,39.0,0,0,0,1,1
Elsad Zverotić,0,217.0,0,0,2,2,4
Elseid Hysaj,0,120.0,0,0,2,0,2
Elson Hooi,0,87.0,0,0,1,0,1
Elvin Mammadov,0,131.0,0,0,1,1,2
Elvir Baljić,0,583.0,0,2,4,6,10
Elvir Bolić,0,663.0,0,0,12,3,15
Elvis Kafoteka,1,38.0,0,0,2,0,2
Elvis Macedo Babanco,0,73.0,0,0,1,0,1
Elyaniv Barda,0,286.0,0,0,8,1,9
Elías Aguilar,2,99.0,0,0,2,0,2
Elías Figueroa,0,84.0,0,0,2,0,2
Elías Hernández,1,29.0,0,0,1,0,1
Elías Montes,0,84.0,0,0,3,0,3
Emad Ayoub,2,151.0,0,0,1,3,4
Emad Mohammed,3,468.0,0,0,7,3,10
Emad Moteab,2,505.0,0,0,11,0,11
Emad Suleiman,1,123.0,0,0,2,1,3
Emanuel Fabri,1,59.0,0,0,2,0,2
Emanuel Farrugia,0,62.0,0,0,1,0,1
Emanuel Pogatetz,0,32.0,0,0,0,1,1
Emanuele Giaccherini,1,83.0,0,0,0,2,2
Emeka Mamale,0,1.0,0,0,0,1,1
Emelio Caligdong,0,20.0,0,0,1,0,1
Emerich Dembrovschi,1,242.0,0,0,3,2,5
Emerson,1,40.0,0,0,1,0,1
Emerson Umaña,0,80.0,0,0,1,0,1
Emery Welshman,1,198.0,0,0,3,0,3
Emil Dumitriu,0,153.0,0,0,3,0,3
Emil Forsberg,5,581.0,0,4,11,2,13
Emil Gargorov,0,114.0,0,0,1,1,2
Emil Hallfreðsson,0,40.0,0,0,1,0,1
Emil Kenjisariev,0,86.0,0,0,1,0,1
Emil Kostadinov,1,1166.0,0,0,10,10,20
Emil Lőrincz,0,20.0,0,0,2,0,2
Emil Pažický,0,54.0,0,0,1,0,1
Emile Heskey,1,162.0,0,0,0,3,3
Emile Mbouh,0,123.0,0,0,1,1,2
Emile Ounei,0,43.0,0,1,1,0,1
Emile Pierre Diéme,0,26.0,0,0,1,0,1
Emile Saimovici,2,129.0,0,0,2,0,2
Emile Smith Rowe,0,58.0,0,0,0,1,1
Emiliano González Arqués,0,45.0,0,0,1,0,1
Emilio Butragueño,6,843.0,0,1,9,6,15
Emilio Izaguirre,1,109.0,0,0,2,0,2
Emilio Mora,1,26.0,0,0,1,0,1
Emilio Nsue,0,176.0,0,0,3,0,3
Emilio Palacios,0,97.0,0,0,1,1,2
Emin Ağayev,0,14.0,1,0,1,0,1
Emin Imamaliev,0,83.0,0,0,1,0,1
Emin Mahmudov,0,216.0,0,1,1,3,4
Emir Bajrami,0,84.0,0,0,1,0,1
Emir Spahić,0,219.0,1,0,4,1,5
Emmanuel Adebayor,6,843.0,0,0,14,3,17
Emmanuel Agyemang-Badu,2,150.0,0,0,3,0,3
Emmanuel Ake,1,51.0,0,0,0,1,1
Emmanuel Amunike,4,233.0,0,0,5,1,6
Emmanuel Chipatala,0,47.0,0,0,1,1,2
Emmanuel Duah,0,70.0,0,0,1,0,1
Emmanuel Eboué,1,33.0,0,0,1,0,1
Emmanuel Emenike,4,369.0,0,1,2,5,7
Emmanuel Feseha,0,90.0,0,0,1,0,1
Emmanuel Koum,2,123.0,0,0,2,0,2
Emmanuel Kundé,2,379.0,0,3,6,0,6
Emmanuel Maboang,3,271.0,0,0,4,0,4
Emmanuel Mayuka,4,179.0,0,0,2,2,4
Emmanuel Musonda,0,60.0,0,0,1,0,1
Emmanuel Ofei Ansah,0,59.0,0,0,0,1,1
Emmanuel Okocha,0,82.0,0,0,0,1,1
Emmanuel Okwi,2,282.0,0,0,3,2,5
Emmanuel Ola,0,41.0,0,0,1,0,1
Emmanuel Olisadebe,1,280.0,0,0,4,5,9
Emmanuel Osei Kuffour,0,44.0,0,0,1,0,1
Emmanuel Osigwe,1,114.0,0,0,1,1,2
Emmanuel Petit,0,194.0,0,0,3,0,3
Emmanuel Poila,0,90.0,0,0,1,0,1
Emmanuel Rivière,1,74.0,0,1,0,2,2
Emmanuel Sanon,2,109.0,0,0,0,2,2
Emmanuel Tiki,0,10.0,0,0,1,0,1
Emment Kapengwe,0,166.0,0,0,2,1,3
Emmerson Boyce,0,46.0,0,0,0,2,2
Emory Núñez,1,40.0,0,0,1,0,1
Emre Aşık,0,80.0,0,0,0,2,2
Emre Belözoğlu,1,284.0,0,1,3,3,6
Emre Can,0,81.0,0,0,1,0,1
Emílio da Silva,2,163.0,0,0,2,1,3
Endang Witarsa,0,70.0,0,0,0,1,1
Ender Konca,0,24.0,0,0,1,0,1
Endre Botka,0,18.0,0,0,1,0,1
Endri Çekiçi,0,73.0,0,1,1,0,1
Energio Díaz,1,61.0,0,0,0,1,1
Enes Ünal,0,38.0,0,1,0,2,2
Enis Bardhi,0,331.0,0,2,2,5,7
Enner Valencia,9,879.0,0,4,10,10,20
Enock Mwepu,0,98.0,0,0,1,1,2
Enric Gensana,0,69.0,0,0,1,0,1
Enrico Chiesa,1,107.0,0,0,1,1,2
Enrico Hernández,0,37.0,0,0,1,0,1
Enrique Alfaro Rojas,0,8.0,0,0,0,1,1
Enrique Alvarez,1,19.0,0,1,0,1,1
Enrique Borja,1,48.0,0,0,0,1,1
Enrique Cantos,2,126.0,0,0,0,3,3
Enrique Casaretto,0,107.0,0,0,0,2,2
Enrique Collar,0,75.0,0,0,2,0,2
Enrique Esqueda,0,57.0,0,0,0,1,1
Enrique Ferrer,0,62.0,0,0,0,1,1
Enrique García,2,132.0,0,0,4,1,5
Enrique Guaita,0,19.0,0,0,1,0,1
Enrique Hormazábal,4,480.0,0,0,8,2,10
Enrique Jara Saguier,0,88.0,0,0,2,0,2
Enrique Lora,0,66.0,0,0,1,0,1
Enrique Mateos,0,11.0,0,0,1,0,1
Enrique Raymondi,1,341.0,0,0,3,3,6
Enrique Raymondi Chávez,0,30.0,0,0,0,1,1
Enrique Reneau,0,117.0,0,0,1,1,2
Enrique Saura,0,155.0,0,0,1,1,2
Enrique Sesma,0,107.0,0,0,1,1,2
Enrique Sorrel,2,123.0,0,1,4,0,4
Enrique Tenemás,1,62.0,0,0,0,1,1
Enrique Vera,1,27.0,0,0,0,1,1
Enrique Ávalos,1,100.0,0,0,0,2,2
Enzo Fernández,2,164.0,1,0,1,1,2
Enzo Francescoli,3,499.0,0,3,5,5,10
Enzo Scifo,3,620.0,0,2,6,8,14
Eoin Hand,0,79.0,0,0,0,1,1
Eoin Jess,0,98.0,0,0,2,0,2
Epeli Saukuru,0,66.0,0,0,0,1,1
Epotele Bazamba,1,51.0,0,0,1,0,1
Eran Zahavi,0,1046.0,0,1,11,12,23
Erasmo Vera,0,29.0,0,0,1,0,1
Erasto Nyoni,0,87.0,0,2,2,0,2
Erastus Gariseb,0,70.0,0,0,0,1,1
Eren Derdiyok,0,247.0,0,0,3,1,4
Erhan Önal,0,80.0,0,0,1,0,1
Eric Abidal,0,20.0,1,0,1,0,1
Eric Akoto,0,86.0,0,0,1,0,1
Eric Cantona,0,553.0,0,1,8,2,10
Eric Carrière,2,231.0,0,0,2,1,3
Eric Davis,3,298.0,0,3,2,3,5
Eric Dier,1,110.0,0,0,2,0,2
Eric Etaeta,0,76.0,0,0,0,1,1
Eric Gerets,1,23.0,0,0,1,1,2
Eric Godlieb,0,2.0,0,0,1,0,1
Eric Hoffmann,0,65.0,1,0,0,1,1
Eric Komeng,0,68.0,0,0,0,1,1
Eric Lichaj,0,45.0,0,0,1,0,1
Eric Maxim Choupo-Moting,2,236.0,0,1,4,2,6
Eric McMordie,0,47.0,0,0,1,0,1
Eric Ramírez,0,11.0,0,0,1,0,1
Eric Tinkler,0,21.0,0,0,0,1,1
Eric Van Meir,0,26.0,0,0,1,0,1
Eric Wynalda,4,859.0,0,3,17,2,19
Eric Young,0,31.0,0,0,0,1,1
Erich Beer,0,178.0,0,1,2,1,3
Erich Hof,0,386.0,0,3,8,2,10
Erich Obermayer,1,80.0,0,0,1,0,1
Erich Probst,5,466.0,0,0,11,1,12
Erick Miranda,1,28.0,0,0,0,1,1
Erick Ozuna,0,283.0,0,0,3,2,5
Erick Pulgar,1,165.0,0,0,3,1,4
Erick Scott,2,88.0,0,0,1,1,2
Erik Dyreborg,0,25.0,0,0,0,1,1
Erik Edman,0,74.0,0,0,0,1,1
Erik Hagen,0,17.0,0,0,1,1,2
Erik Holmgren,0,164.0,0,0,1,1,2
Erik Huseklepp,0,162.0,0,0,3,0,3
Erik Jendrišek,0,82.0,0,0,0,1,1
Erik Johansen,0,89.0,0,0,1,1,2
Erik Just Olsen,0,54.0,0,1,0,1,1
Erik Lamela,2,84.0,0,0,2,0,2
Erik Mykland,0,74.0,0,0,1,0,1
Erik Persson,0,65.0,0,0,1,0,1
Erik Sandvad,0,87.0,1,0,1,0,1
Erik Santos de Gouveia,0,13.0,0,0,1,0,1
Erik Sorga,0,265.0,0,0,3,1,4
Eriq Zavaleta,0,61.0,0,0,1,1,2
Erixon Danso,0,54.0,0,0,2,0,2
Erjon Bogdani,0,648.0,0,0,7,4,11
Erkan Zengin,0,93.0,0,0,2,1,3
Erland Johnsen,0,89.0,0,0,0,1,1
Erling Haaland,0,196.0,0,1,4,1,5
Ermen Benítez,1,88.0,0,0,0,1,1
Ermes Muccinelli,1,154.0,0,0,1,1,2
Ermin Bičakčić,0,174.0,0,0,2,1,3
Ermin Šiljak,0,323.0,0,0,5,5,10
Ermindo Onega,1,154.0,0,0,4,0,4
Ermir Lenjani,0,79.0,0,0,1,1,2
Ernest Brenner,0,10.0,0,0,0,1,1
Ernest Ebongué,1,223.0,0,0,1,2,3
Ernest Liberati,0,80.0,0,0,0,1,1
Ernest Mengel,0,27.0,0,0,1,0,1
Ernest Pohl,0,148.0,0,0,2,1,3
Ernest Schultz,0,86.0,0,0,1,0,1
Ernest Spiteri-Gonzi,1,137.0,0,0,1,2,3
Ernesto Belis,1,4.0,0,0,1,0,1
Ernesto Betancourt,1,70.0,0,0,0,1,1
Ernesto Cisneros,0,193.0,0,0,3,1,4
Ernesto Cristaldo,1,78.0,0,0,1,0,1
Ernesto Duarte Machado da Silva,2,65.0,0,0,2,0,2
Ernesto Díaz,0,249.0,0,0,4,1,5
Ernesto Grillo,2,31.0,0,0,2,0,2
Ernesto Humberto Juárez,1,86.0,0,0,1,0,1
Ernesto Vidal,1,18.0,0,0,0,1,1
Ernie Brandts,3,194.0,1,0,2,3,5
Ernie Campbell,0,108.0,0,0,1,1,2
Ernie Tapai,1,181.0,0,0,3,1,4
Ernst Albrecht,0,24.0,0,0,0,1,1
Ernst Baumeister,0,71.0,0,0,0,1,1
Ernst Happel,0,68.0,0,1,1,0,1
Ernst Hufschmid,0,75.0,0,0,1,0,1
Ernst Kozlicek,0,71.0,0,0,1,0,1
Ernst Lehner,2,184.0,0,0,2,3,5
Ernst Lörtscher,1,22.0,1,0,1,0,1
Ernst Ocwirk,1,134.0,0,0,2,1,3
Ernst Ogris,0,83.0,0,0,0,1,1
Ernst Stojaspal,3,84.0,0,1,3,0,3
Ernst Wilimowski,4,397.0,0,0,1,4,5
Ernő Solymosi,1,128.0,1,1,2,2,4
Erol Keskin,1,143.0,0,0,1,1,2
Errol Daniels,0,225.0,0,0,3,1,4
Errol McFarlane,1,297.0,0,0,1,3,4
Errol O'Loughlin,0,86.0,0,0,1,0,1
Erroll Bennett,4,445.0,0,0,0,5,5
Ertuğrul Sağlam,0,176.0,0,0,4,0,4
Ervin Fakaj,0,90.0,0,0,1,0,1
Ervin Skela,0,159.0,0,2,1,4,5
Erwin Hochsträsser,0,80.0,0,1,1,0,1
Erwin Hoffer,0,160.0,0,0,3,0,3
Erwin Koeman,0,74.0,0,0,2,0,2
Erwin Ramírez,1,80.0,0,1,0,1,1
Erwin Romero,0,65.0,0,0,1,0,1
Erwin Saavedra,2,70.0,0,1,0,2,2
Erwin Sánchez,3,697.0,0,1,9,4,13
Erwin Vandenbergh,2,613.0,0,1,8,7,15
Esa Heiskanen,0,49.0,0,0,2,0,2
Esala Masi,11,604.0,0,1,6,8,14
Esam Dariban,0,39.0,0,0,0,1,1
Esey Tesfay,0,58.0,1,0,0,1,1
Esrom Nyandoro,1,140.0,0,0,0,2,2
Essam Abu Touk,0,179.0,0,2,4,1,5
Essam Baheeg,2,101.0,0,0,2,0,2
Essau Kanyenda,0,207.0,0,0,3,2,5
Estanislao Struway,0,45.0,0,0,1,0,1
Estanislau Basora,4,336.0,0,0,6,1,7
Esteban Cambiasso,1,187.0,0,0,1,2,3
Esteban Obiang,1,70.0,0,0,0,1,1
Esteban Paredes,1,104.0,0,0,4,0,4
Etienne Alain Djissikadie,0,10.0,0,0,1,0,1
Etienne Barbara,0,79.0,0,0,1,0,1
Etienne Bito'o,0,84.0,0,0,0,1,1
Etienne Hajason Rasoanaivo,0,67.0,0,0,0,1,1
Etienne Mermer,3,273.0,0,0,1,4,5
Etienne Olivier Rasoanaivo,0,82.0,0,0,0,1,1
Etienne Rado Rasoanaivo,0,128.0,0,0,2,1,3
Eudalio Arriaga,0,90.0,0,0,1,0,1
Eudes Dagoulou,0,7.0,0,0,0,1,1
Eugen Sidorenco,0,248.0,0,0,3,1,4
Eugen Walaschek,1,42.0,0,0,0,1,1
Eugene Kirwan,1,23.0,0,0,1,0,1
Eugene Martha,2,123.0,1,0,1,1,2
Eugene Ssepuuya,0,15.0,0,0,1,1,2
Eugenio Dolmo Flores,2,177.0,0,0,1,2,3
Eugenio Fernando Bila,0,6.0,0,0,0,1,1
Eugenio La Rosa,3,151.0,0,0,3,0,3
Eugenio Leal,0,75.0,0,0,1,0,1
Eugenio Morel,0,229.0,0,0,3,2,5
Eugenio Méndez,0,85.0,0,0,2,0,2
Eugeniu Cebotaru,0,85.0,0,0,1,0,1
Eugène Ekéké,1,65.0,0,0,1,0,1
Eugène Kabongo,1,249.0,0,0,3,3,6
Euller,0,20.0,0,0,0,1,1
Euloge Placca Fessou,1,187.0,0,0,1,2,3
Euloge Sacramento,0,43.0,0,0,0,1,1
Eulogio Martínez,1,122.0,0,0,0,2,2
Eurico Gomes,0,31.0,0,0,1,0,1
Eusebio Escobar,0,27.0,0,0,1,0,1
Eustache Manglé,4,243.0,0,0,1,3,4
Eustacio Rizo,1,89.0,0,0,0,1,1
Eustaquio Barreiro,1,63.0,0,0,0,1,1
Eusébio,9,1325.0,0,5,9,17,26
Euzebiusz Smolarek,0,540.0,0,0,8,4,12
Evagoras Christofi,0,28.0,0,0,1,0,1
Evair Aparecido Paulino,0,31.0,0,0,1,0,1
Evan Dimas,1,60.0,0,0,0,1,1
Evan Welsh,0,89.0,0,0,0,1,1
Evani Esperance,0,81.0,0,0,1,0,1
Evans Sakala,1,38.0,0,0,1,0,1
Evaristo de Macedo,8,470.0,0,0,8,0,8
Everad Sam,0,75.0,0,0,0,1,1
Everon Espacia,0,73.0,0,0,1,0,1
Everton Soares,0,132.0,0,0,3,0,3
Evgeny Boldygin,0,103.0,0,0,1,1,2
Evidence Makgopa,0,90.0,0,0,0,1,1
Ewald Hoeseb,0,28.0,0,0,1,0,1
Eyal Berkovic,0,218.0,0,0,3,2,5
Eyjólfur Sverrisson,0,426.0,0,0,6,3,9
Eyvind Clausen,0,58.0,0,0,2,0,2
Ezechiel N'Douassel,0,158.0,0,1,2,0,2
Ezequiel Jerez,0,87.0,0,0,0,1,1
Ezequiel Lavezzi,1,169.0,0,0,5,1,6
Ezgjan Alioski,1,246.0,0,1,2,4,6
Ezio Pascutti,0,38.0,0,0,1,0,1
Ezz El-Din Yaqoub,1,56.0,0,0,1,0,1
Ezzedine Chakroun,0,229.0,0,0,1,3,4
Ezzeldin Osman,0,40.0,0,0,1,0,1
Ezzewdin Bezan,0,8.0,0,0,1,0,1
Fabian Frei,0,20.0,0,0,1,0,1
Fabian Johnson,0,29.0,0,0,1,0,1
Fabian Schär,1,273.0,0,1,3,5,8
Fabio Baudo Franco,3,82.0,0,0,0,3,3
Fabio Cannavaro,0,52.0,1,0,1,0,1
Fabio Capello,1,167.0,0,0,1,2,3
Fabio Celestini,0,87.0,0,0,0,1,1
Fabio D'Elia,0,49.0,0,0,1,0,1
Fabio Francini,0,90.0,1,0,1,0,1
Fabio Grosso,0,289.0,0,0,2,2,4
Fabio Quagliarella,1,327.0,0,2,3,3,6
Fabián Estay,0,171.0,0,0,3,0,3
Fabián Estoyanoff,2,9.0,0,0,0,2,2
Fabián Orellana,0,113.0,0,0,1,1,2
Fabián Ruiz,0,8.0,0,0,1,0,1
Fabrice Do Marcolino,1,190.0,0,0,3,0,3
Fabrice N'Guessi,0,66.0,0,0,0,1,1
Fabrice Noël,1,14.0,0,0,1,0,1
Fabrice Ondama,1,150.0,0,0,1,1,2
Fabrice Reuperné,1,90.0,0,0,0,1,1
Fabricio Coloccini,0,66.0,0,0,0,1,1
Fabrizio Ravanelli,0,305.0,0,0,5,2,7
Fadel Keïta,0,162.0,0,0,1,1,2
Fadi Alloush,0,80.0,0,1,1,0,1
Fadi Lafi,1,58.0,0,0,1,0,1
Fadil Vokrri,0,183.0,0,0,2,2,4
Fahad Al Ansari,0,127.0,0,0,2,0,2
Fahad Al Enezi,0,50.0,0,0,1,0,1
Fahad Al Hajeri,0,13.0,0,0,1,0,1
Fahad Al Hamad,0,82.0,0,0,1,0,1
Fahad Al Kuwari,2,182.0,0,1,1,2,3
Fahad Al-Bishi,5,312.0,0,2,5,2,7
Fahad Al-Ghesheyan,1,85.0,0,0,1,0,1
Fahad Al-Mehallel,8,471.0,0,0,7,3,10
Fahad Al-Musaibeah,1,13.0,0,0,1,0,1
Fahad Al-Muwallad,2,576.0,0,0,8,2,10
Fahad Al-Rashidi,0,81.0,0,0,1,0,1
Fahad Bayo,0,152.0,0,0,2,1,3
Fahad Fallata,0,65.0,0,0,1,0,1
Fahad Khamees,2,183.0,0,0,4,1,5
Fahad Khamis Mubarak,0,61.0,0,0,0,1,1
Fahad Yousef Al-Sovayed,0,26.0,0,0,1,0,1
Fahd Ali,0,45.0,0,0,1,0,1
Fahed Masoud,0,90.0,0,0,0,1,1
Fahid Ben Khalfallah,0,43.0,0,0,1,0,1
Fahreddin Cansever,0,115.0,0,0,3,0,3
Fahrudin Mustafić,0,75.0,0,1,2,0,2
Faisal Agab,1,139.0,0,1,2,1,3
Faisal Ajab Al-Azemi,0,81.0,0,0,1,0,1
Faisal Al Badri,1,53.0,0,2,2,0,2
Faisal Al Otaibi,0,7.0,0,0,0,1,1
Faisal Al-Dakhil,4,969.0,0,1,16,4,20
Faisal Antar,2,86.0,0,0,0,3,3
Faisal Aziz Rashed,1,43.0,0,0,0,1,1
Faisal Bushaala,0,45.0,0,0,0,1,1
Faisal Khalil,1,272.0,0,0,2,2,4
Faisal Zayid,1,108.0,0,0,2,0,2
Faitalia Hamilton-Pama,1,18.0,0,0,1,0,1
Faiz Nasir,0,78.0,0,0,1,0,1
Fakhreddine Ben Youssef,1,140.0,0,0,0,2,2
Falah Hassan,1,85.0,0,0,1,0,1
Falimery Ramanamahefa,0,108.0,0,0,2,0,2
Famara Diédhiou,4,271.0,0,0,2,4,6
Fan Zhiyi,2,536.0,1,4,6,4,10
Fandi Ahmad,1,227.0,0,0,2,2,4
Faneva Imà Andriatsima,1,280.0,0,1,6,0,6
Fanis Theofanous,0,21.0,0,0,1,0,1
Fanny Hangunyu,0,44.0,0,0,1,0,1
Fantamady Keita,4,274.0,0,0,3,2,5
Faouzi Ghoulam,1,154.0,0,1,3,0,3
Faouzi Mansouri,0,14.0,0,0,1,0,1
Faouzi Mubarak Aaish,2,186.0,0,2,3,1,4
Faouzi Rouissi,0,103.0,0,2,3,0,3
Faraj Al-Bor'osi,0,89.0,0,0,1,0,1
Faraj Laheeb,0,247.0,0,0,3,0,3
Fares Aouni,0,175.0,0,0,0,4,4
Fares Juma,0,70.0,1,0,1,0,1
Farhad Majidi,2,322.0,0,0,3,2,5
Farhat Haitbaev,2,136.0,0,0,0,2,2
Farhat Musabekov,1,34.0,0,0,0,1,1
Farhod Tadjiyev,0,132.0,0,0,3,0,3
Farid Al Masori,1,78.0,0,0,0,1,1
Farid Ghazi,1,12.0,0,0,1,0,1
Faris Ramli,0,68.0,0,0,2,0,2
Farkhod Vosiyev,0,57.0,0,0,0,1,1
Farlen Ilama,0,16.0,0,0,1,0,1
Faroug Jabra,0,8.0,0,0,1,0,1
Farouk Gaafar,0,55.0,0,1,2,0,2
Farouk Ibrahim Al Awadi Al Saleh,0,24.0,0,0,0,1,1
Farouk Miya,1,212.0,0,0,4,1,5
Farrukh Ismayilov,0,268.0,0,0,3,0,3
Farshad Noor,1,27.0,0,0,1,0,1
Farshad Pious,2,296.0,0,0,4,2,6
Faruk Hadžibegić,0,216.0,0,3,3,1,4
Faruq Ibrahim,1,11.0,0,0,0,1,1
Fashion Sakala,0,290.0,0,1,4,1,5
Fat'hi Kameel Fayaz Matar Marzouq,1,127.0,0,0,1,2,3
Fatai Amoo,0,12.0,0,0,0,1,1
Fathi Jaber,0,76.0,0,0,0,1,1
Fathi Kameel,3,412.0,0,0,3,4,7
Fatih Tekke,0,382.0,0,0,3,4,7
Fatih Terim,0,128.0,0,1,2,0,2
Fatkhullo Fatkhuloev,0,88.0,0,0,0,1,1
Fatos Bećiraj,0,484.0,0,1,6,6,12
Faustino Asprilla,2,556.0,0,0,8,4,12
Faustino Delgado,0,3.0,0,1,1,0,1
Fausto De Amicis,1,144.0,0,0,2,0,2
Fausto Klinger,0,77.0,0,0,0,1,1
Fawaz Al Ahmad,0,114.0,0,0,2,0,2
Fawzi Al-Issawi,0,76.0,0,0,1,0,1
Fawzi Bashir,0,171.0,0,0,3,0,3
Fawzi Bashir Doorbeen,0,52.0,0,0,1,0,1
Fawzi El-Aisawi,0,22.0,0,1,1,0,1
Fawzi Moussouni,1,53.0,0,0,0,1,1
Fayad Mahmoud,1,44.0,0,1,0,1,1
Fayez Al-Felaij,1,90.0,0,0,1,0,1
Fayez Marzouq,0,87.0,0,0,0,1,1
Faysal Shayesteh,1,78.0,0,0,0,1,1
Fayçal Fajr,0,80.0,0,0,1,0,1
Fazrul Nawaz,1,215.0,0,0,2,2,4
Federico Bernardeschi,0,163.0,0,0,2,1,3
Federico Bikoro,0,82.0,0,0,0,1,1
Federico Chiesa,2,252.0,0,0,4,0,4
Federico Magallanes,0,82.0,0,2,3,0,3
Federico Peluso,0,90.0,0,0,1,0,1
Federico Vairo,1,51.0,0,0,1,0,1
Federico Valverde,0,197.0,0,0,1,2,3
Fedor Černych,0,425.0,0,0,7,2,9
Feisal Salum,0,53.0,0,0,1,0,1
Feiz Shamsin,0,75.0,0,0,0,1,1
Fekri Al-Hubaishi,0,66.0,0,0,1,0,1
Felicien Minde,0,74.0,0,0,1,0,1
Felipe Baloy,1,236.0,1,0,3,1,4
Felipe Buffoni,1,43.0,0,0,0,1,1
Felipe Caicedo,2,859.0,0,6,8,9,17
Felipe Cata Edson,0,55.0,0,0,0,1,1
Felipe Gutiérrez,0,101.0,0,0,2,0,2
Felipe Melo,1,71.0,0,0,1,1,2
Felipe Rosas,0,72.0,0,0,1,0,1
Felitciano Zschusschen,0,39.0,0,1,1,0,1
Felix Aboagye,1,110.0,0,0,1,1,2
Felix Gasselich,0,123.0,0,0,1,1,2
Felix Katongo,1,90.0,0,0,1,1,2
Felix Khojoyan,0,50.0,0,0,0,1,1
Felix Magath,0,33.0,0,0,1,1,2
Felix Michel Melki,1,27.0,0,0,1,0,1
Felix Owolabi,0,49.0,0,0,1,1,2
Felix Tagawa,7,422.0,0,0,0,7,7
Fenedy Masauvakalo,1,41.0,0,0,0,1,1
Feng Ji-zhi,1,78.0,1,0,1,1,2
Feras Esmaeel,0,17.0,0,0,0,1,1
Feras Shelbaieh,0,56.0,0,1,1,0,1
Ferdinando Riva,0,35.0,0,0,0,1,1
Ferenc Bene,5,933.0,0,0,12,13,25
Ferenc Horváth,0,206.0,0,0,3,1,4
Ferenc Machos,0,118.0,0,0,4,0,4
Ferenc Mészáros,0,79.0,0,0,1,1,2
Ferenc Orosz,0,15.0,0,0,1,0,1
Ferenc Puskás,4,124.0,0,0,2,2,4
Ferenc Sipos,0,24.0,0,0,1,0,1
Ferhan Hasani,0,59.0,0,0,1,0,1
Ferjani Sassi,2,87.0,0,1,1,1,2
Fernand Brosius,0,50.0,1,0,1,0,1
Fernand Coulibaly,0,25.0,0,0,0,1,1
Fernandinho,1,97.0,1,0,1,1,2
Fernando Amorebieta,0,62.0,0,0,1,0,1
Fernando Arce,1,205.0,0,0,4,0,4
Fernando Astengo,2,161.0,0,0,1,1,2
Fernando Baldeón,0,60.0,0,0,0,2,2
Fernando Cabrita,0,36.0,0,0,0,1,1
Fernando Chalana,0,71.0,0,0,1,1,2
Fernando Consul,1,83.0,0,0,1,0,1
Fernando Cornejo,0,52.0,0,0,0,1,1
Fernando Couto,1,252.0,0,0,4,0,4
Fernando Cáceres,0,69.0,0,0,1,0,1
Fernando Fiorillo,0,69.0,0,0,1,0,1
Fernando Francisco,0,90.0,0,0,0,1,1
Fernando Gomes,0,503.0,0,0,4,5,9
Fernando Gómez Colomer,0,63.0,0,0,1,0,1
Fernando Hierro,6,1275.0,1,10,20,6,26
Fernando Jiménez,0,40.0,0,0,1,0,1
Fernando Kanapkis,1,181.0,0,0,3,1,4
Fernando Llorente,0,254.0,0,0,2,2,4
Fernando Manuel Co,0,47.0,0,0,0,1,1
Fernando Manuel Sousa,0,51.0,0,0,1,0,1
Fernando Marcos,0,55.0,0,0,1,0,1
Fernando Meira,0,21.0,0,0,1,0,1
Fernando Morena,0,242.0,0,3,5,1,6
Fernando Morientes,6,690.0,0,0,10,2,12
Fernando Navarro Morán,1,72.0,0,0,0,1,1
Fernando Ochoaizpur,0,48.0,0,0,1,0,1
Fernando Peres,0,176.0,0,1,2,0,2
Fernando Peyroteo,1,72.0,0,1,0,1,1
Fernando Quirarte,0,77.0,0,0,2,0,2
Fernando Redondo,0,65.0,0,0,0,1,1
Fernando Riera,4,227.0,0,0,2,2,4
Fernando Saucedo,0,83.0,0,0,1,0,1
Fernando Silva,0,143.0,0,0,0,2,2
Fernando Torres,17,1369.0,0,3,14,14,28
Fernando Varela,1,81.0,0,0,1,0,1
Fernando Vergara,1,52.0,0,0,1,0,1
Ferran Torres,3,452.0,0,1,5,3,8
Ferydoon Zandi,1,53.0,0,0,0,2,2
Fevzi Davletov,0,5.0,0,0,0,1,1
Fevzi Zemzem,0,46.0,0,0,1,1,2
Feyyaz Uçar,0,433.0,0,1,3,4,7
Fidel Escobar,0,22.0,0,0,0,1,1
Fidel Martínez,0,74.0,0,0,1,1,2
Fikru Tefera,0,130.0,0,1,2,0,2
Filip Hološko,0,312.0,0,0,3,2,5
Filip Ivanovski,0,86.0,0,0,1,0,1
Filip Kostić,0,141.0,0,0,2,1,3
Filip Novák,0,71.0,0,0,1,0,1
Filip Stojković,0,89.0,1,0,1,0,1
Filip Đorđević,0,8.0,0,0,0,1,1
Filip Đuričić,0,163.0,0,0,3,0,3
Filip Šebo,0,112.0,0,0,2,1,3
Filipe Duarte,0,52.0,0,0,1,0,1
Filipe Luís,0,114.0,0,0,2,0,2
Filipo Bureta,0,81.0,1,0,1,0,1
Filippo Berardi,0,77.0,0,0,1,0,1
Filippo Fabbri,0,15.0,1,0,0,1,1
Filippo Inzaghi,3,901.0,0,2,12,10,22
Fillisione Taufahema,1,78.0,0,0,1,0,1
Finidi George,1,177.0,0,0,2,2,4
Finn Laudrup,0,71.0,0,0,2,0,2
Finn Seemann,0,9.0,0,0,1,0,1
Firas Al-Buraikan,0,191.0,0,0,3,0,3
Firas Al-Khatib,1,254.0,0,2,2,3,5
Firas Issmael,1,64.0,0,0,0,1,1
Firmin Ndombe Mubele,2,370.0,0,0,1,4,5
Firmin Sanou,0,42.0,0,1,0,1,1
Fiston Abdul Razak,0,212.0,0,1,2,2,4
Fitzroy Simpson,1,62.0,0,0,1,0,1
Fivos Vrahimis,0,158.0,0,0,1,2,3
Flavio Maestri,0,268.0,0,0,3,2,5
Flavius Domide,0,74.0,0,0,1,0,1
Flemming Povlsen,1,594.0,0,0,7,5,12
Fleury Di Nallo,0,255.0,0,0,2,3,5
Florea Dumitrache,2,592.0,0,2,6,6,12
Florea Martinovici,0,15.0,0,0,1,0,1
Florea Văetuș,0,16.0,0,0,1,0,1
Florencio Amarilla,2,174.0,0,1,3,2,5
Florent Hadergjonaj,0,29.0,0,0,0,1,1
Florent Malouda,0,188.0,0,0,1,4,5
Florent Rouamba,0,75.0,0,0,0,1,1
Florentin Petre,0,187.0,0,0,2,2,4
Florian Bohnert,0,90.0,0,0,0,1,1
Florian Jozefzoon,1,70.0,0,0,0,1,1
Florian Myrtaj,0,53.0,0,0,1,0,1
Florian Thauvin,0,45.0,0,0,0,1,1
Florin Andone,0,59.0,0,0,1,0,1
Florin Bratu,0,77.0,0,0,1,0,1
Florin Cernat,0,18.0,0,0,0,2,2
Florin Răducioiu,10,1174.0,0,2,7,14,21
Florin Tănase,0,28.0,0,0,1,0,1
Floros Nicolaou,0,62.0,0,0,0,1,1
Floyd Ayité,0,71.0,0,0,1,0,1
Floyd Guthrie,1,10.0,0,0,0,1,1
Flávio Amado,5,547.0,0,1,8,5,13
Flávio Conceição,1,28.0,0,0,1,0,1
Flávio Minuano,3,234.0,0,0,3,2,5
Flórián Albert,4,312.0,0,0,5,6,11
Flórián Urbán,0,77.0,0,0,0,1,1
Fodé Camara,0,224.0,0,1,5,0,5
Fodé Mansaré,0,132.0,0,0,2,0,2
Fortunato Castillo,0,131.0,0,0,4,0,4
Fotis Papoulis,0,46.0,0,0,1,1,2
Fouad Bushegir,1,90.0,0,0,0,1,1
Foxi Kéthévoama,0,68.0,0,0,2,0,2
Fran,0,104.0,0,0,1,1,2
Fran Karačić,1,38.0,0,0,0,1,1
Fran Núñez,0,52.0,0,0,1,0,1
Francesco Acerbi,0,21.0,0,0,0,1,1
Francesco Graziani,1,340.0,0,0,6,2,8
Francesco Totti,2,368.0,0,2,5,3,8
Franchel Ibara,0,67.0,0,0,1,0,1
Francileudo Santos,8,851.0,0,0,14,4,18
Francis Doe,0,15.0,0,0,0,1,1
Francis Dupont,0,81.0,0,0,1,0,1
Francis Kahata,0,35.0,0,0,0,1,1
Francis Kasonde,0,56.0,0,0,0,1,1
Francis Lee,0,206.0,0,0,3,0,3
Francis N'Ganga,0,104.0,0,0,2,0,2
Francis Niakuam,0,80.0,0,0,1,0,1
Francis Ouma,0,70.0,0,0,0,1,1
Francis Oumar,0,210.0,0,0,3,0,3
Francis Were,0,44.0,0,0,0,1,1
Francisco Antonio Pavón,0,40.0,0,0,1,0,1
Francisco Arce,1,93.0,0,1,1,2,3
Francisco Atura,1,43.0,0,0,1,0,1
Francisco Calvo,1,43.0,0,0,2,0,2
Francisco Flores,0,155.0,0,0,4,0,4
Francisco Fonseca,4,718.0,0,0,8,5,13
Francisco Gento,0,231.0,0,0,2,1,3
Francisco González,1,33.0,0,0,1,0,1
Francisco Higuera,0,18.0,0,0,0,1,1
Francisco Hormazábal,0,45.0,0,0,1,0,1
Francisco Javier Aguilar García,0,63.0,0,0,1,0,1
Francisco Javier Cruz,0,84.0,0,0,0,1,1
Francisco Javier Rodríguez,1,83.0,0,0,0,1,1
Francisco José Carrasco,1,254.0,0,1,1,3,4
Francisco Llorente Gento,0,67.0,0,0,1,0,1
Francisco Lojacono,0,53.0,0,1,0,1,1
Francisco López Contreras,0,112.0,0,0,1,1,2
Francisco Massinga,0,59.0,0,0,1,0,1
Francisco Molina,7,345.0,0,0,5,2,7
Francisco Palacios,0,90.0,0,0,1,0,1
Francisco Palencia,4,557.0,0,0,4,5,9
Francisco Ramírez,0,137.0,0,0,2,3,5
Francisco Rodrigues,2,69.0,0,0,0,2,2
Francisco Rojas,0,33.0,0,0,1,0,1
Francisco Rui Marcos,0,55.0,0,1,1,0,1
Francisco Socorro,0,37.0,0,0,0,1,1
Francisco Uribe,0,401.0,0,0,4,3,7
Francisco Valdés,1,193.0,0,0,3,0,3
Francisco Varallo,1,189.0,0,0,4,0,4
Francisco Vital,0,58.0,0,0,1,0,1
Francisco Zuluaga,1,19.0,0,1,1,0,1
Franck Doté,1,26.0,0,0,0,1,1
Franck Kessié,2,88.0,0,1,2,0,2
Franck Pangop,0,88.0,0,0,1,0,1
Franck Ribéry,1,536.0,0,1,5,5,10
Franck Sauzée,0,201.0,0,0,4,2,6
Franco Causio,1,94.0,0,0,1,1,2
Franco Navarro,1,332.0,0,0,3,3,6
Franco Paonessa,0,6.0,0,0,1,0,1
Francois Croes,1,27.0,1,0,0,1,1
Francois Sakama,0,109.0,0,0,1,1,2
Frane Matošić,0,71.0,0,0,1,0,1
Franjo Vladić,0,50.0,0,0,1,0,1
Frank Arnesen,3,356.0,0,4,7,3,10
Frank Fabra,2,40.0,1,0,1,1,2
Frank Farina,0,45.0,0,0,1,0,1
Frank Feltscher,0,78.0,0,0,0,1,1
Frank Klopas,1,20.0,0,0,0,1,1
Frank Lampard,2,861.0,0,8,10,9,19
Frank Leboeuf,1,214.0,0,1,2,1,3
Frank McAvennie,0,59.0,0,0,1,0,1
Frank O'Farrell,0,88.0,0,0,1,0,1
Frank O'Neill,0,60.0,0,0,1,0,1
Frank Odoi,1,223.0,0,0,1,2,3
Frank Pingel,1,245.0,0,0,3,2,5
Frank Rijkaard,2,254.0,0,0,4,0,4
Frank Seator,0,10.0,0,0,0,1,1
Frank Sinalo,0,91.0,0,0,2,0,2
Frank Stapleton,0,642.0,0,1,10,5,15
Frank Strandli,0,59.0,0,0,1,0,1
Frank Sturing,1,6.0,0,0,0,1,1
Frank Wallace,3,118.0,0,0,1,2,3
Frank de Boer,0,529.0,0,1,6,2,8
Frankie Beauchamp,2,124.0,0,0,0,2,2
Frankie Hejduk,1,175.0,0,0,1,2,3
Frankie Oviedo,0,125.0,0,0,1,2,3
Franklin Salas,1,139.0,0,0,1,1,2
Franklyn Baptiste,0,44.0,0,0,1,0,1
Franky Vercauteren,2,394.0,0,0,4,5,9
Frans Geurtsen,0,87.0,0,0,0,1,1
Frans Janssens,0,28.0,0,0,1,0,1
Frans Thijssen,0,115.0,0,0,2,1,3
František Karkó,0,172.0,0,0,0,2,2
František Knebort,0,164.0,0,0,2,2,4
František Pelcner,0,77.0,0,0,0,1,1
František Svoboda,1,24.0,0,0,1,0,1
František Veselý,2,263.0,0,0,3,0,3
František Vlk,0,108.0,0,0,1,2,3
František Šafránek,0,38.0,0,1,0,1,1
František Štambachr,0,140.0,0,0,1,1,2
Frantz Bertin,0,90.0,0,0,1,0,1
Frantzdy Pierrot,2,372.0,0,0,2,3,5
Franz Aigner,0,22.0,0,0,0,1,1
Franz Beckenbauer,5,297.0,0,0,4,1,5
Franz Binder,0,33.0,0,0,1,0,1
Franz Burgmeier,0,391.0,1,0,3,3,6
Franz Hasil,0,58.0,0,1,1,0,1
Franz Schiemer,0,159.0,0,0,0,3,3
Franz Schädler,0,78.0,0,0,1,0,1
Franz Wolny,0,54.0,0,0,0,1,1
François Amégasse,0,37.0,0,0,1,0,1
François Heutte,0,182.0,0,0,2,1,3
François Kamano,2,73.0,0,1,1,1,2
François M'Pelé,3,171.0,0,0,3,0,3
François N'Doumbé,0,67.0,0,0,1,0,1
François Omam-Biyik,5,360.0,0,1,6,5,11
François Tahi,0,89.0,0,0,0,1,1
François Van der Elst,0,472.0,0,0,5,5,10
François Vanden Eynde,2,107.0,0,0,0,2,2
François de Vries,0,59.0,0,0,0,1,1
Frazer Kamwandi,0,88.0,0,0,2,0,2
Fred,2,474.0,0,0,8,0,8
Fred Masella,0,35.0,0,0,0,1,1
Freddie Ljungberg,2,601.0,0,1,5,7,12
Freddie Mwila,0,179.0,0,0,3,0,3
Freddy,0,52.0,0,0,1,0,1
Freddy Adu,0,76.0,0,0,2,0,2
Freddy Eastwood,0,22.0,0,0,0,1,1
Freddy Elie,0,89.0,0,0,1,0,1
Freddy Fernández,0,30.0,0,0,0,1,1
Freddy García,1,409.0,0,0,7,2,9
Freddy Grisales,0,81.0,0,0,3,1,4
Freddy Góndola,0,52.0,0,0,1,0,1
Freddy Rincón,5,549.0,0,0,3,8,11
Freddy Vava,1,90.0,0,0,1,0,1
Frederic Remi,0,3.0,0,0,0,1,1
Frederick Gomez,0,120.0,0,0,1,1,2
Frederico Rosa,0,176.0,1,0,1,2,3
Fredi Bobić,0,266.0,0,0,2,3,5
Fredrik Jensen,0,45.0,0,0,1,1,2
Fredrik Strømstad,0,105.0,0,0,1,1,2
Fredy Bareiro,1,71.0,0,0,0,1,1
Fredy Guarín,0,11.0,0,0,1,0,1
Fredy Thompson,0,77.0,0,0,0,1,1
Frenkie de Jong,0,108.0,0,0,0,2,2
Friaça,0,47.0,0,0,1,0,1
Fricis Kaņeps,0,203.0,0,1,3,2,5
Frickson Erazo,0,81.0,0,0,0,1,1
Friday Ekpo,1,75.0,0,0,0,1,1
Friedrich Scherfke,1,23.0,0,1,0,1,1
Friso Mando,0,36.0,0,2,1,1,2
Fritz Künzli,0,524.0,0,0,7,3,10
Fritz Szepan,0,8.0,0,0,1,0,1
Fritz Walter,3,304.0,0,2,2,3,5
Frode Johnsen,0,87.0,0,0,1,0,1
Froylán Ledezma,1,140.0,0,0,3,0,3
Frédéric Chassot,0,87.0,0,0,0,1,1
Frédéric Kanouté,6,897.0,0,2,8,9,17
Frédéric Mendy,0,11.0,0,0,0,1,1
Fróði Benjaminsen,0,114.0,1,1,2,2,4
Fu Weng Lei,0,87.0,0,0,1,0,1
Fuad Abou Shaqr,1,105.0,0,0,1,1,2
Fuad Anwar,2,63.0,0,0,1,1,2
Fulgencio Berdugo,3,133.0,0,0,1,2,3
Fulvio Collovati,0,40.0,0,0,1,1,2
Fulvio Nesti,0,67.0,0,0,0,1,1
Fung Chi Ming,1,15.0,0,0,0,1,1
Fung Hing Wa,1,11.0,1,0,0,1,1
Fyodor Cherenkov,1,140.0,0,0,3,0,3
Fyodor Kudryashov,0,117.0,1,0,2,0,2
Fyodor Smolov,0,371.0,0,0,5,1,6
Fábio Abreu,0,68.0,0,0,1,0,1
Fábio Coentrão,0,153.0,0,0,1,1,2
Fábio César Montezine,0,212.0,0,0,4,0,4
Fábio Virginio de Lima,0,289.0,0,0,5,0,5
Félix Arambulo,1,50.0,0,0,0,1,1
Félix Castillo,6,310.0,0,0,1,6,7
Félix Lasso,0,127.0,0,0,1,1,2
Félix Loustau,6,417.0,0,0,7,0,7
Félix Ricardo Torres,0,68.0,0,0,1,0,1
Félix Rodríguez,0,36.0,0,0,0,1,1
Félix Torres,0,163.0,0,0,2,0,2
Férébory Doré,1,79.0,0,0,2,0,2
Gabadinho Mhango,3,179.0,0,0,2,2,4
Gabino Sosa,6,225.0,0,0,6,0,6
Gabriel Achilier,0,30.0,0,0,0,1,1
Gabriel Barbosa,1,316.0,0,1,3,1,4
Gabriel Batistuta,26,1635.0,0,7,28,9,37
Gabriel Cedrés,0,184.0,0,0,2,1,3
Gabriel Cichero,1,80.0,0,0,0,1,1
Gabriel Enrique Gómez,2,192.0,0,2,3,1,4
Gabriel Gnimassou,0,65.0,0,0,1,0,1
Gabriel González,0,30.0,0,0,1,0,1
Gabriel Heinze,2,64.0,1,0,1,2,3
Gabriel Jaime Gómez Jaramillo,0,8.0,0,0,0,1,1
Gabriel Jesus,0,495.0,0,0,5,4,9
Gabriel Mendes,0,55.0,1,0,1,0,1
Gabriel Mercado,1,93.0,0,0,1,2,3
Gabriel Michel,0,76.0,0,0,3,0,3
Gabriel Milito,0,16.0,0,0,0,1,1
Gabriel Miranda,1,88.0,0,0,1,1,2
Gabriel Nzeyimana,0,90.0,0,0,0,1,1
Gabriel Riera,0,36.0,0,0,0,1,1
Gabriel Tamaş,0,105.0,0,0,1,1,2
Gabriel Torje,0,227.0,0,1,1,4,5
Gabriel Torres,8,890.0,0,5,14,4,18
Gabriel Urdaneta,1,111.0,0,1,1,2,3
Gabriel Wajoka,2,90.0,0,0,2,0,2
Gabriel Ávalos,1,90.0,0,0,0,1,1
Gadi Brumer,0,65.0,0,0,1,0,1
Gaetano Scirea,0,81.0,0,0,0,1,1
Gafurzhan Suyumbayev,0,104.0,0,0,1,2,3
Gagny Coulibaly,1,68.0,0,1,0,1,1
Gahrymanberdi Çoňkaýew,0,87.0,0,0,0,1,1
Gaizka Mendieta,3,470.0,0,2,5,2,7
Gaku Shibasaki,1,81.0,0,0,1,0,1
Galabgwe Moyana,0,22.0,0,0,0,1,1
Galimzyan Khusainov,1,17.0,0,0,1,1,2
Galo Fidean Vásquez,0,68.0,0,0,1,0,1
Gamal Abdel Azim,0,4.0,0,0,1,0,1
Gamal Abdelhamid,2,150.0,0,0,3,0,3
Gao Feng,1,235.0,0,0,1,3,4
Gao Hongbo,1,378.0,0,0,4,2,6
Gao Lin,3,280.0,1,3,1,3,4
Gao Sheng,1,13.0,0,0,1,0,1
Gao Wei-jie,1,62.0,0,0,0,1,1
Garath McCleary,2,85.0,0,0,1,1,2
Garba Lawal,3,214.0,0,0,3,1,4
Garba Okoye,0,168.0,0,0,3,1,4
Gareth Bale,7,1614.0,0,6,18,14,32
Gareth Barry,0,40.0,0,0,0,1,1
Gareth McAuley,2,492.0,2,0,5,6,11
Gareth Southgate,0,88.0,0,0,0,1,1
Garfield Gonsalves,0,22.0,1,0,0,1,1
Garnik Avalyan,0,127.0,0,1,2,0,2
Garra Dembélé,1,56.0,0,0,0,1,1
Garrincha,3,194.0,0,0,3,2,5
Garry Lund,0,56.0,1,0,0,1,1
Garry O'Connor,0,120.0,0,0,1,1,2
Garry Rodrigues,1,260.0,0,0,0,4,4
Gary Breen,1,236.0,0,0,2,2,4
Gary Byrne,0,68.0,0,1,1,0,1
Gary Cahill,0,74.0,0,0,1,1,2
Gary Caldwell,0,67.0,0,0,1,0,1
Gary Cole,0,477.0,0,1,7,2,9
Gary Doherty,0,196.0,0,0,1,2,3
Gary Gillespie,0,58.0,1,0,1,0,1
Gary Kelly,0,80.0,0,0,0,1,1
Gary Lineker,10,1012.0,0,3,17,5,22
Gary Mabbutt,0,21.0,0,0,1,0,1
Gary Mackay,0,86.0,0,0,0,1,1
Gary McAllister,1,186.0,0,2,2,1,3
Gary McSwegan,0,50.0,0,0,1,0,1
Gary Medel,0,329.0,1,0,3,3,6
Gary Naysmith,0,63.0,0,0,0,1,1
Gary Neville,0,68.0,1,0,1,0,1
Gary Ngassebe,1,78.0,0,0,0,1,1
Gary Speed,0,307.0,0,0,3,4,7
Gary Waddock,0,23.0,0,0,1,1,2
Garðar Árnason,0,59.0,0,0,1,0,1
Gaston Bawa,1,36.0,0,0,0,1,1
Gaston Taument,1,86.0,0,0,1,0,1
Gastón Giménez,0,85.0,0,0,0,1,1
Gastón Pereiro,0,90.0,0,0,1,0,1
Gastón Silva,0,24.0,1,0,0,1,1
Gatoch Panom,0,47.0,0,1,1,0,1
Gavi,1,74.0,0,0,1,0,1
Gavin Glinton,0,74.0,0,0,1,0,1
Gavril Balint,2,395.0,0,0,6,2,8
Gavril Serfözö,0,27.0,0,0,0,1,1
Gayson Gregory,0,185.0,0,0,2,2,4
Gaël Kakuta,0,6.0,0,0,0,1,1
Gbassay Sessay,1,11.0,0,0,1,0,1
Gebremedhin Haile,0,9.0,0,0,1,0,1
Gedo,5,435.0,0,0,3,2,5
Geir Frigård,0,88.0,0,0,1,0,1
Geir Karlsen,0,69.0,1,0,0,1,1
Gelson,0,2.0,0,0,1,0,1
Gelson Fernandes,1,142.0,0,0,0,2,2
Genar Andrinúa,0,3.0,0,0,0,1,1
Genc Tomorri,0,22.0,0,0,0,1,1
Genki Haraguchi,3,440.0,0,1,3,6,9
Gennadi Bliznyuk,0,78.0,0,0,2,0,2
Gennadi Gusarov,0,45.0,0,0,0,2,2
Gennady Yevryuzhikhin,0,77.0,0,0,2,1,3
Genrich Fedosov,1,75.0,0,0,0,1,1
Geny Catamo,0,158.0,0,1,1,1,2
Geoff Aunger,1,151.0,0,0,3,0,3
Geoff Brand,0,90.0,0,0,1,0,1
Geoff Cameron,0,86.0,0,0,2,0,2
Geoff Hurst,2,768.0,0,0,11,2,13
Geoffrey Sserunkuma,0,107.0,0,0,2,0,2
Geofrey Massa,0,107.0,0,0,3,0,3
Geofrey Munshya,2,93.0,0,0,0,2,2
Georg Hammer,0,10.0,0,0,0,1,1
Georg Siimenson,0,36.0,0,0,0,2,2
George Alhassan,2,311.0,0,0,3,4,7
George Best,0,380.0,0,1,5,2,7
George Borba,1,12.0,0,0,1,0,1
George Cummins,0,120.0,0,0,0,2,2
George Dangler,0,42.0,0,0,1,0,1
George Dublin,0,77.0,0,0,0,2,2
George Isaac,0,359.0,0,0,5,1,6
George Kiriau,0,100.0,0,0,1,1,2
George Mallia,0,81.0,0,0,0,2,2
George Mbwando,0,81.0,0,0,0,1,1
George McCartney,0,61.0,0,0,1,0,1
George Moussis,0,29.0,0,0,0,1,1
George Mouyémé,1,82.0,0,0,0,1,1
George Ngoma Nanitelamio,0,15.0,0,0,0,1,1
George Onyango,0,24.0,0,0,1,0,1
George Pușcaș,0,220.0,0,0,2,3,5
George Robledo,1,141.0,0,0,4,0,4
George Suri,0,42.0,0,0,1,0,1
George Weah,2,336.0,0,0,5,2,7
Georges Aeby,1,24.0,0,0,1,0,1
Georges Akieremy,0,73.0,0,0,0,1,1
Georges Bereta,0,61.0,0,0,1,0,1
Georges Bregy,0,400.0,0,2,6,3,9
Georges Gertrude,1,53.0,0,0,0,1,1
Georges Gope-Fenepej,4,529.0,0,0,1,7,8
Georges Grün,2,179.0,0,0,2,3,5
Georges Lech,0,312.0,0,0,3,2,5
Georges Verriest,1,116.0,0,1,0,1,1
Georges Vuilleumier,0,56.0,0,0,0,2,2
Georgi Asparuhov,4,770.0,0,1,11,3,14
Georgi Bachev,1,88.0,1,0,1,0,1
Georgi Chilikov,0,37.0,0,0,1,0,1
Georgi Denev,0,196.0,0,0,5,1,6
Georgi Dimitrov,0,287.0,0,0,2,4,6
Georgi Dzhikiya,0,111.0,0,0,1,1,2
Georgi Georgiev,1,131.0,0,0,1,1,2
Georgi Iliev,0,69.0,0,0,1,0,1
Georgi Ivanov,0,157.0,0,0,2,1,3
Georgi Kinkladze,0,258.0,0,1,3,2,5
Georgi Kondratiev,3,147.0,0,0,3,0,3
Georgi Kostadinov,0,192.0,0,0,1,2,3
Georgi Markov,0,18.0,0,0,1,0,1
Georgi Milanov,0,66.0,0,0,1,0,1
Georgi Panchediev,0,89.0,0,1,1,0,1
Georgi Slavkov,0,163.0,0,0,3,1,4
Georgi Sokolov,1,64.0,0,0,1,0,1
Georgi Tkavadze,0,18.0,0,0,1,0,1
Georgi Yomov,0,89.0,0,0,1,0,1
Georgi Yordanov,0,39.0,0,0,1,0,1
Georgina Tura,1,77.0,0,0,0,1,1
Georginio Wijnaldum,0,1055.0,0,0,10,8,18
Georgios Delikaris,0,161.0,0,0,3,1,4
Georgios Efrem,0,211.0,0,0,5,0,5
Georgios Fotakis,0,79.0,0,0,0,1,1
Georgios Georgiadis,0,204.0,0,0,2,2,4
Georgios Kamaras,0,83.0,0,0,0,1,1
Georgios Karagounis,0,30.0,0,0,0,1,1
Georgios Kostikos,0,141.0,0,1,1,2,3
Georgios Samaras,2,441.0,0,2,4,2,6
Georgios Tzavellas,0,90.0,0,0,1,0,1
Geovani Faria da Silva,0,36.0,0,1,1,0,1
Gerald Asamoah,0,51.0,0,0,1,0,1
Gerald Delmas,1,90.0,0,0,1,0,1
Gerald Díaz,0,3.0,0,0,1,0,1
Gerald Phiri Jr.,0,81.0,0,1,1,0,1
Gerald Quennet,3,93.0,0,0,3,0,3
Gerald Vanenburg,0,19.0,0,0,1,0,1
Gerald Willfurth,0,71.0,0,0,1,0,1
Geraldo,0,41.0,0,0,1,0,1
Geraldo José da Silva,1,106.0,0,0,0,2,2
Gerard Cieślik,0,93.0,0,0,2,0,2
Gerard Ellie,0,149.0,0,1,2,0,2
Gerard López,0,59.0,0,0,1,1,2
Gerard Maki,1,38.0,0,0,0,1,1
Gerard Moreno,0,222.0,0,0,4,0,4
Gerard Piqué,1,277.0,1,0,4,1,5
Gerard Plessers,0,12.0,0,0,1,0,1
Gerard Williams,1,13.0,0,0,0,1,1
Gerardo Arce,0,11.0,1,0,1,0,1
Gerardo Bedoya,0,170.0,0,0,1,2,3
Gerardo Galindo,1,54.0,0,0,1,0,1
Gerardo Gordillo,1,119.0,0,0,2,0,2
Gerardo Rivas,5,222.0,0,0,1,5,6
Gerardo Torrado,4,269.0,0,1,4,1,5
Gerardo Yecerotte,0,85.0,0,0,1,0,1
Gerd Kische,0,18.0,0,0,1,0,1
Gerd Müller,12,2147.0,0,3,24,15,39
Gerd Weber,0,196.0,0,1,2,2,4
Geremi,2,121.0,0,1,2,0,2
Geremi Njitap,3,250.0,0,0,4,2,6
Geremy Lombardi,0,71.0,0,0,1,0,1
Gergely Rudolf,0,395.0,0,0,4,3,7
Gergő Lovrencsics,0,26.0,0,0,0,1,1
Gerhard Hanappi,0,72.0,0,0,2,1,3
Gerhard Körner,0,35.0,0,1,1,0,1
Gerhard Rodax,1,63.0,0,0,1,0,1
Gerhard Siedl,0,55.0,0,0,0,1,1
Gerhard Strack,0,79.0,0,0,1,0,1
Gerhard Vogt,0,47.0,0,0,0,1,1
Germaine van Dijk,0,11.0,0,0,0,1,1
Germán Aceros,3,104.0,0,0,2,1,3
Germán Carty,0,69.0,0,0,2,0,2
Germán Leguía,0,6.0,0,0,1,0,1
Gernot Jurtin,0,65.0,0,0,1,0,1
Gerry Armstrong,2,501.0,0,1,7,4,11
Gerry Baker,0,81.0,0,0,2,0,2
Gerry Daly,0,413.0,0,1,6,2,8
Gerry Hitchens,1,38.0,0,0,0,1,1
Gerry McMahon,0,49.0,0,0,0,1,1
Gerry Taggart,0,140.0,0,0,1,3,4
Gerson Díaz,0,78.0,0,0,0,1,1
Gerson Mayen,1,131.0,0,0,3,0,3
Gerson Rodrigues,0,520.0,1,1,3,6,9
Gerson Tinoco,0,94.0,0,0,1,1,2
Gerson Torres,0,90.0,0,0,1,0,1
Gert Claessens,0,32.0,0,0,1,0,1
Gert Dörfel,0,142.0,0,0,0,3,3
Gert Verheyen,0,220.0,0,0,2,3,5
Gervais Batota,0,96.0,0,0,1,1,2
Gervatius Uri Khob,2,237.0,0,0,0,4,4
Gervinho,8,528.0,0,0,8,3,11
Gerónimo Barbadillo,0,64.0,0,0,2,1,3
Getaneh Kebede,2,580.0,1,1,8,2,10
Gevorg Ghazaryan,0,580.0,0,0,6,4,10
Ghafour Jahani,0,207.0,0,0,4,1,5
Ghailene Chaalali,0,47.0,0,0,1,0,1
Ghanem Al-Hajri,1,58.0,0,0,0,1,1
Ghanem Hamarsheh,0,176.0,0,0,2,0,2
Ghanem Sultan,1,53.0,1,0,0,1,1
Gharib Amzine,0,46.0,0,0,0,1,1
Gharib Hareb,0,33.0,0,1,1,0,1
Ghazi Al Kuwari,0,82.0,0,0,1,0,1
Gheorghe Andronic,0,87.0,0,0,1,0,1
Gheorghe Boghiu,0,43.0,0,0,0,1,1
Gheorghe Bucur,0,237.0,0,0,4,0,4
Gheorghe Constantin,0,138.0,0,0,2,0,2
Gheorghe Craioveanu,0,113.0,0,0,1,2,3
Gheorghe Grozav,0,45.0,0,0,0,1,1
Gheorghe Hagi,3,1108.0,0,4,17,10,27
Gheorghe Mulţescu,0,40.0,0,0,1,0,1
Gheorghe Ovseannicov,0,25.0,0,0,0,1,1
Gheorghe Popescu,0,612.0,0,1,8,5,13
Ghislain Akassou,0,45.0,0,0,0,1,1
Gholam Ali,0,20.0,0,0,1,0,1
Gholam Hossein Farzami,0,57.0,0,0,1,0,1
Gholam Hossein Mazloumi,0,311.0,0,0,3,2,5
Gholam Vafakhah,0,23.0,0,0,1,0,1
Gholamreza Rezaei,1,304.0,0,0,2,3,5
Giacinto Facchetti,0,162.0,0,0,2,1,3
Giacomo Bulgarelli,2,181.0,0,0,3,0,3
Giacomo Raspadori,0,24.0,0,0,1,0,1
Giampaolo Pazzini,0,226.0,0,0,2,1,3
Giampiero Boniperti,0,195.0,0,0,2,1,3
Giancarlo Antognoni,0,96.0,0,0,1,2,3
Giancarlo De Sisti,0,124.0,0,1,2,1,3
Giancarlo Maldonado,0,511.0,0,0,8,2,10
Gianfranco Zola,0,454.0,0,0,6,3,9
Gianluca Lapadula,3,203.0,0,0,4,2,6
Gianluca Vialli,1,343.0,0,0,7,1,8
Gianluca Zambrotta,1,6.0,0,0,1,0,1
Gianni Rivera,2,573.0,0,1,8,2,10
Giannis Gianniotas,0,78.0,0,0,1,0,1
Gianpetro Zappa,0,121.0,0,0,1,1,2
Gibby Mbasela,0,11.0,0,0,1,0,1
Gideon Omokirio,3,216.0,1,1,3,2,5
Gideon Tish,0,38.0,0,0,1,0,1
Gidi Damti,0,94.0,0,0,1,1,2
Giedrius Arlauskis,0,101.0,2,0,1,1,2
Gift Kampamba,1,112.0,0,0,0,3,3
Gigi Riva,1,1085.0,0,2,12,8,20
Gijsberta Gersley,0,40.0,0,0,0,1,1
Gil Guiambe,0,73.0,0,0,0,2,2
Gil Reece,0,113.0,0,0,1,1,2
Gil Vermouth,0,36.0,0,0,1,0,1
Gilbert Agius,0,103.0,0,0,0,2,2
Gilbert Chirwa,0,3.0,0,0,1,0,1
Gilbert Dussier,0,245.0,0,1,3,2,5
Gilbert Mushangazhike,0,95.0,0,0,2,0,2
Gilbert Nyhime,0,90.0,0,0,0,1,1
Gilbert Van Binst,0,15.0,0,0,1,0,1
Gilbert Zender,0,52.0,0,0,0,1,1
Gilbert Álvarez,0,72.0,0,0,0,1,1
Gilberto,1,59.0,0,0,0,1,1
Gilberto Alves,2,107.0,0,0,1,1,2
Gilberto Murgas,1,34.0,0,1,0,1,1
Gilberto Silva,0,78.0,1,0,0,1,1
Gilberto Yearwood,1,89.0,0,0,0,1,1
Gilberto dos Santos,2,185.0,0,1,1,2,3
Giles Barnes,1,41.0,0,0,0,2,2
Gill Swerts,0,88.0,0,0,0,1,1
Gilles Bettmer,0,27.0,0,0,1,0,1
Gilles De Bilde,0,86.0,0,0,1,1,2
Gilles Malinowski,1,90.0,0,0,0,1,1
Gilles Rampillon,0,75.0,0,0,1,0,1
Gilles Sunu,0,71.0,0,0,1,0,1
Gilles Yapi Yapo,0,96.0,0,0,2,0,2
Gilli Rólantsson,0,32.0,0,0,1,0,1
Gino Brandon,0,82.0,0,0,0,1,1
Gino Colaussi,3,101.0,0,0,0,4,4
Gino Iorgulescu,0,49.0,1,0,1,1,2
Gino Pariani,1,17.0,0,0,0,1,1
Gino Pivatelli,0,84.0,0,0,1,0,1
Ginter Gawlik,0,2.0,0,0,1,0,1
Gints Freimanis,0,40.0,0,0,0,1,1
Giora Spiegel,3,331.0,0,0,3,3,6
Giorgi Demetradze,0,352.0,0,0,2,4,6
Giorgi Gakhokidze,0,169.0,0,0,2,0,2
Giorgi Kharaishvili,0,10.0,0,0,0,1,1
Giorgi Kvilitaia,0,84.0,0,0,0,1,1
Giorgi Merebashvili,0,66.0,0,0,0,1,1
Giorgi Papunashvili,0,59.0,0,0,1,0,1
Giorgi Shashiashvili,0,26.0,0,0,1,0,1
Giorgian de Arrascaeta,2,234.0,0,1,4,3,7
Giorgio Chiellini,1,438.0,1,0,6,2,8
Giorgio Chinaglia,0,29.0,0,1,0,2,2
Giorgos Dedes,0,93.0,0,0,2,0,2
Giorgos Donis,0,191.0,0,0,1,2,3
Giorgos Karagounis,1,280.0,0,1,4,1,5
Giorgos Koudas,0,89.0,0,0,2,0,2
Giorgos Masouras,0,77.0,0,0,2,0,2
Giorgos Merkis,0,9.0,0,0,1,0,1
Giorgos Savvidis,0,41.0,0,0,1,0,1
Giorgos Sideris,0,471.0,0,1,8,2,10
Giorgos Skartados,0,54.0,0,0,0,1,1
Giourkas Seitaridis,0,29.0,0,0,1,0,1
Giovane Élber,2,177.0,0,0,0,2,2
Giovani Lo Celso,1,74.0,0,0,0,1,1
Giovani dos Santos,5,494.0,0,0,3,6,9
Giovanni Di Lorenzo,0,90.0,0,0,2,0,2
Giovanni Drenthe,0,57.0,0,0,0,1,1
Giovanni Ferrari,0,176.0,0,0,3,0,3
Giovanni Gayle,1,25.0,0,0,1,0,1
Giovanni Hernández,3,282.0,0,0,3,1,4
Giovanni Moreno,0,63.0,0,0,1,0,1
Giovanni Regales,1,38.0,0,0,1,0,1
Giovanni Savarese,0,138.0,0,0,3,0,3
Giovanni Sio,0,51.0,0,0,2,0,2
Giovanni Trigueros,0,88.0,0,0,1,0,1
Giovanni van Bronckhorst,2,267.0,0,0,2,2,4
Giovanny Espinoza,0,5.0,0,0,1,0,1
Girma Tekle,1,290.0,0,0,4,0,4
Girma Tesfaye,1,90.0,0,0,1,0,1
Giuseppe Bergomi,0,9.0,0,0,1,0,1
Giuseppe Giannini,0,98.0,0,0,2,0,2
Giuseppe Meazza,1,276.0,0,1,4,1,5
Giuseppe Rossi,2,169.0,0,0,1,2,3
Giuseppe Signori,0,187.0,0,0,2,1,3
Given Singuluma,1,2.0,0,0,1,0,1
Givi Nodia,2,86.0,0,0,2,0,2
Gjergji Muzaka,0,87.0,0,0,0,1,1
Gjorgji Hristov,0,391.0,0,0,6,3,9
Gladys Bokese,0,72.0,0,0,0,1,1
Glen Johnson,1,49.0,1,0,1,0,1
Glenn Hoddle,0,193.0,0,0,3,1,4
Glenn Hysén,0,100.0,0,0,1,1,2
Glenn Strömberg,1,316.0,0,0,2,4,6
Glenn Whelan,1,78.0,0,0,1,1,2
Glensworth Elizee,0,45.0,0,0,1,0,1
Gleofilo Vlijter,2,142.0,0,0,3,0,3
Glyn Hodges,0,28.0,0,0,1,0,1
Goce Sedloski,0,192.0,0,1,2,2,4
Gocha Gogrichiani,0,59.0,0,0,1,0,1
Gocha Jamarauli,0,53.0,0,0,1,0,1
Godfred Karikari,0,156.0,0,0,2,0,2
Godfrey Chitalu,0,443.0,0,0,6,2,8
Godfrey Katerega,0,73.0,0,0,1,0,1
Godfrey Kisitu,2,94.0,0,0,0,2,2
Godfrey Oboabona,0,82.0,0,0,0,1,1
Godfrey Walusimbi,0,87.0,0,1,1,0,1
Godwin Attram,0,87.0,0,0,0,1,1
Godwin Emenako,0,28.0,0,0,1,0,1
Godwin Iwelumo,0,93.0,0,0,1,1,2
Godwin Odiye,0,61.0,1,0,0,1,1
Gogie Stewart,0,82.0,0,0,1,1,2
Gohar Zaman,3,210.0,0,0,3,0,3
Gohi Bi Zoro Cyriac,0,44.0,0,0,0,1,1
Golman Pierre,1,773.0,0,0,8,7,15
Gonzalo Castañeda,0,78.0,0,0,1,1,2
Gonzalo Farfán,1,9.0,0,0,1,0,1
Gonzalo Galindo,1,122.0,0,0,1,2,3
Gonzalo Higuaín,9,973.0,0,0,18,5,23
Gonzalo Jara,0,98.0,0,0,1,1,2
Gonzalo Martínez,1,15.0,0,0,1,0,1
Gonzalo Pineda,1,65.0,0,0,1,0,1
Gonzalo Plata,1,314.0,0,0,3,1,4
Gonzalo Romero,3,255.0,0,0,2,3,5
Gonzalo de los Santos,0,29.0,0,0,1,0,1
Gonçalo Guedes,0,147.0,0,0,1,1,2
Gonçalo Paciência,0,56.0,0,0,1,0,1
Gonçalo Ramos,3,135.0,0,0,3,0,3
Goran Maznov,0,180.0,0,0,3,1,4
Goran Pandev,1,504.0,0,2,4,9,13
Goran Stavrevski,0,93.0,1,0,2,0,2
Goran Vlaović,3,250.0,0,0,2,3,5
Gordon Braun,0,11.0,0,0,1,0,1
Gordon Durie,0,269.0,0,0,2,3,5
Gordon Kinsaini,0,55.0,0,0,2,0,2
Gordon McQueen,0,207.0,0,0,0,3,3
Gordon Schildenfeld,0,87.0,0,0,1,0,1
Gordon Smith,0,79.0,0,0,0,1,1
Gordon Strachan,1,153.0,0,1,0,3,3
Gorgonio Ibarrola,1,62.0,0,0,0,1,1
Gouramangi Singh,1,99.0,0,0,1,1,2
Goçguly Goçgulyýew,1,5.0,0,1,0,1,1
Graeme Rutjes,0,13.0,0,0,0,1,1
Graeme Souness,1,86.0,0,0,0,1,1
Graham Arnold,0,422.0,0,0,7,1,8
Graham Williams,1,48.0,1,0,1,0,1
Graham Zusi,0,300.0,0,0,3,1,4
Granit Xhaka,2,466.0,0,0,5,4,9
Grant Hanley,0,116.0,0,0,2,0,2
Grant McCann,0,166.0,0,0,1,2,3
Grant Turner,0,528.0,0,0,8,2,10
Graziano Pellè,2,369.0,0,0,3,3,6
Grațian Sepi,0,18.0,0,0,0,1,1
Greg Brown,0,85.0,0,0,1,0,1
Greg Vanney,0,90.0,0,0,1,0,1
Gregorio Benito,0,5.0,1,0,1,0,1
Gregorio Gómez,0,27.0,0,0,1,0,1
Gregory Goodridge,0,161.0,0,0,2,2,4
Gregory Richardson,0,1.0,0,0,1,0,1
Grenddy Perozo,1,90.0,0,0,0,1,1
Grover Harmon,1,35.0,0,0,0,1,1
Grzegorz Krychowiak,1,228.0,0,0,3,2,5
Grzegorz Lato,10,926.0,0,0,9,10,19
Grégoire M'Bida,2,220.0,0,0,3,1,4
Grétar Steinsson,0,9.0,0,0,0,1,1
Gu Guangming,5,359.0,0,0,3,3,6
Gu Sang-Bum,0,85.0,0,0,1,0,1
Gualberto Mojica,0,26.0,0,0,1,0,1
Gudmundur Thorbjornsson,0,35.0,0,0,0,1,1
Guedes Lupapa,0,2.0,0,0,1,0,1
Guido Alvarenga,1,75.0,0,1,0,2,2
Guido Andrade,1,49.0,0,0,0,1,1
Guido Buchwald,0,44.0,0,0,1,0,1
Guido Burgstaller,0,99.0,0,0,2,0,2
Guido Gratton,0,108.0,0,0,2,0,2
Guido Rodríguez,1,13.0,0,0,1,0,1
Guilherme Afonso,0,112.0,0,0,2,0,2
Guilherme de Cássio Alves,1,9.0,0,0,1,0,1
Guilherme de Paula Lucrécio,1,72.0,0,1,1,0,1
Guillaume Gillet,0,45.0,0,0,1,0,1
Guillermo Albornoz,1,49.0,0,0,0,1,1
Guillermo Amor,1,228.0,0,0,2,2,4
Guillermo Barbadillo,0,62.0,0,0,0,1,1
Guillermo Cantu,0,79.0,0,0,1,0,1
Guillermo Clavero,0,149.0,0,0,4,0,4
Guillermo Díaz,0,128.0,0,0,3,0,3
Guillermo Díaz Carmona,1,52.0,0,0,0,1,1
Guillermo Escalada,3,263.0,0,0,4,4,8
Guillermo Franco,1,261.0,0,0,2,3,5
Guillermo La Rosa,1,208.0,0,0,0,3,3
Guillermo Ochoa,0,53.0,1,0,1,0,1
Guillermo Ramírez,1,249.0,0,0,2,4,6
Guillermo Rivera,0,311.0,0,0,5,1,6
Guillermo Riveros,1,40.0,0,0,0,1,1
Guillermo Saavedra,0,25.0,0,0,1,0,1
Guillermo Stábile,7,323.0,0,0,7,1,8
Guillermo Subiabre,2,161.0,0,1,3,1,4
Guillermo Torres,1,16.0,0,0,1,0,1
Gulzhigit Alykulov,1,68.0,0,0,1,2,3
Gunnar Aase,0,77.0,0,0,0,1,1
Gunnar Gren,0,81.0,0,0,1,0,1
Gunnar Halle,0,129.0,0,0,3,0,3
Gunnar Heiðar Þorvaldsson,0,40.0,0,0,1,1,2
Gunnar Thoresen,0,3.0,0,0,1,0,1
Gunther Schepens,0,74.0,0,0,1,1,2
Guram Kashia,0,56.0,0,0,0,1,1
Gurban Gurbanov,2,298.0,0,1,2,3,5
Gurbangeldi Durdyýew,0,110.0,0,0,0,2,2
Gustav Josefsson,0,48.0,0,0,2,0,2
Gustav Wetterström,3,337.0,0,0,3,3,6
Gustave Bebbe,0,87.0,0,0,0,1,1
Gustave Kemp,0,33.0,0,0,1,0,1
Gustavo Adolfo Cabrera,0,49.0,1,0,0,2,2
Gustavo Adrián López,0,83.0,0,0,1,0,1
Gustavo Cuéllar,1,31.0,0,0,1,0,1
Gustavo Gómez,2,272.0,3,0,3,2,5
Gustavo Morínigo,0,107.0,0,0,2,0,2
Gustavo Moscoso,1,90.0,0,0,0,1,1
Gustavo Neffa,3,134.0,0,0,3,1,4
Gustavo Peña,0,14.0,0,1,1,0,1
Gustavo Poyet,0,161.0,0,0,1,1,2
Gustavo Sangaré,0,24.0,0,0,0,1,1
Gustavo Vassallo,0,11.0,0,0,1,0,1
Guti,0,120.0,0,0,2,0,2
Guus Til,0,80.0,0,0,1,0,1
Guvanch Ovekov,0,77.0,0,1,1,0,1
Guwanç Abylow,0,24.0,0,0,2,0,2
Guwançmuhammet Öwekow,0,81.0,0,0,3,0,3
Guy Feutchine,0,82.0,0,0,1,0,1
Guy François,0,216.0,0,0,2,1,3
Guy Hellers,0,179.0,1,0,1,2,3
Guy Mamihasindrahona,0,90.0,0,0,1,0,1
Guy Mbenza,0,125.0,0,0,2,0,2
Guy Nzeng,1,59.0,0,0,1,0,1
Guy Roger Nzamba,0,214.0,0,0,3,2,5
Guy Saint-Vil,0,188.0,0,0,3,1,4
Guðmundur Torfason,0,62.0,0,0,0,1,1
Guðni Bergsson,0,61.0,0,0,1,0,1
Gyasi Zardes,0,484.0,0,0,8,0,8
Gylfi Sigurðsson,3,1129.0,0,6,12,10,22
Gyula Hajszán,0,109.0,0,0,2,0,2
Gyula Rákosi,0,129.0,0,0,1,1,2
Gyula Zsengellér,5,533.0,0,1,10,0,10
György Bognár,0,131.0,0,1,1,3,4
György Garics,0,82.0,0,0,1,0,1
György Sárosi,6,381.0,0,1,5,2,7
György Tatar,0,90.0,0,0,1,1,2
Győző Burcsa,0,65.0,0,0,1,0,1
Gábor Egressy,0,51.0,0,0,1,0,1
Gábor Gyepes,0,80.0,1,0,1,0,1
Gábor Halmai,0,89.0,0,0,3,0,3
Gábor P. Szabó,0,128.0,0,1,2,1,3
Gábor Pölöskei,2,137.0,0,0,1,2,3
Gérard Hausser,1,62.0,0,0,1,0,1
Gérard Soler,1,69.0,0,0,2,1,3
Gérson,1,65.0,0,0,1,0,1
Géza Toldi,3,195.0,0,0,1,3,4
Gökdeniz Karadeniz,1,240.0,0,0,2,3,5
Gökhan Gönül,0,78.0,0,0,1,0,1
Gökhan Inler,0,256.0,0,3,3,1,4
Gökhan Ünal,0,123.0,0,0,1,1,2
Gösta Dunker,1,82.0,0,0,0,1,1
Gösta Sandberg,0,22.0,0,0,1,0,1
Gøran Sørloth,0,413.0,0,0,5,3,8
Gündüz Kılıç,0,72.0,0,0,1,0,1
Günter Netzer,0,101.0,0,1,1,1,2
Günther Wirth,0,39.0,0,0,1,1,2
Güýçmyrat Annagulyýew,1,85.0,0,0,1,0,1
Ha Seok-ju,5,570.0,0,0,6,5,11
Habib Bamogo,1,59.0,0,0,0,1,1
Habib Beye,1,45.0,0,0,1,0,1
Habib Diallo,0,90.0,0,0,0,1,1
Habib Fardan,0,25.0,0,0,1,0,1
Habib Jafar,1,167.0,0,0,2,1,3
Habib Khabiri,0,59.0,0,0,0,1,1
Habib Shareefi,0,84.0,0,0,1,0,1
Hacène Lalmas,3,110.0,0,0,3,0,3
Hadi Aghily,0,88.0,0,0,1,1,2
Hadi Ahmed,1,26.0,0,0,1,0,1
Hadi Ismanto,0,75.0,0,0,1,0,1
Hady Khashaba,0,100.0,0,2,1,1,2
Hafiz Nor,1,52.0,0,0,0,1,1
Haidar Abdullah,0,56.0,0,0,0,1,1
Haidar Mahmoud,3,169.0,0,0,3,1,4
Haidar Najim,0,36.0,0,0,1,0,1
Haidar Obeid,2,115.0,0,0,1,1,2
Haim Bar,0,57.0,0,0,1,0,1
Haim Revivo,1,376.0,0,0,5,5,10
Hairuddin Omar,2,139.0,0,0,1,1,2
Haitham Al-Shboul,0,83.0,0,0,0,1,1
Haitham Elrasheed,0,30.0,0,0,1,0,1
Haitham Thabit,0,80.0,0,0,1,0,1
Haitham Zein,1,211.0,0,0,4,1,5
Haji Wright,1,76.0,0,0,0,1,1
Hajime Hosogai,1,97.0,0,0,1,0,1
Hakan Balta,0,79.0,0,0,1,0,1
Hakan Yakin,0,385.0,0,1,7,2,9
Hakan Çalhanoğlu,0,404.0,0,1,3,4,7
Hakan Şükür,4,1892.0,0,2,26,13,39
Hakim Abdallah,0,74.0,0,0,1,0,1
Hakim Braham,0,24.0,0,0,1,0,1
Hakim Ziyech,1,83.0,0,1,2,1,3
Hakob Ter-Petrosyan,0,90.0,0,0,0,1,1
Hal Robson-Kanu,2,313.0,0,0,3,2,5
Halil Altıntop,0,239.0,0,0,2,2,4
Halil Dervişoğlu,0,133.0,0,0,2,1,3
Hallgrímur Jónasson,0,116.0,0,0,0,2,2
Hallur Hansson,0,73.0,0,0,2,0,2
Hallvar Thoresen,0,258.0,0,2,3,2,5
Hamad Al Harbi,0,87.0,0,0,0,1,1
Hamad Al-Montashari,1,147.0,0,0,2,0,2
Hamad Khalid Bo Hamad,2,214.0,0,0,0,4,4
Hamada Sedki,0,9.0,1,0,1,0,1
Hamdan Abdulla Al-Moamari,0,57.0,0,0,0,1,1
Hamdan Al-Kamali,0,85.0,1,1,2,0,2
Hamdi Al Masri,0,17.0,1,0,1,0,1
Hamdi Salihi,0,334.0,0,1,4,2,6
Hamdou Elhouni,1,36.0,0,0,1,0,1
Hamed Al-Saleh,3,286.0,0,0,1,4,5
Hamed Snousi,1,90.0,0,0,1,0,1
Hameed Darwish,0,84.0,0,0,1,0,1
Hameur Bouazza,1,92.0,0,0,0,1,1
Hami Mandıralı,0,168.0,0,0,1,1,2
Hamid Alidousti,3,89.0,0,0,2,1,3
Hamid Derakhshan,2,59.0,0,0,0,3,3
Hamid Estili,5,425.0,0,0,1,7,8
Hamid Ismail,0,90.0,0,0,0,1,1
Hamilton Cuvi,1,126.0,0,0,0,2,2
Hamilton Ricard,2,196.0,0,0,1,3,4
Haminu Draman,1,106.0,0,0,2,0,2
Hamit Altıntop,2,236.0,0,0,3,1,4
Hamlet Mkhitaryan,0,66.0,0,0,1,0,1
Hammadi Ahmed,1,86.0,0,0,1,0,1
Hamoud Al-Shemmari,1,84.0,0,0,1,0,1
Hamza Abourazzouk,0,89.0,0,0,1,0,1
Hamza Al-Dardour,4,604.0,0,0,7,4,11
Hamza El-Gamal,1,22.0,0,0,1,0,1
Hamza Mathlouthi,1,4.0,0,0,1,0,1
Hamza Yacef,0,48.0,0,0,1,0,1
Hamzah Idris,1,64.0,0,0,1,0,1
Hamzah Idris Falatah,0,118.0,0,0,3,0,3
Han Bong-Zin,2,153.0,0,0,2,0,2
Han Hyong-Il,0,148.0,0,0,3,0,3
Han Kwang-song,0,90.0,0,0,0,1,1
Han Peng,0,70.0,0,0,0,2,2
Hani Al Saqer,1,102.0,0,0,0,2,2
Hani Al-Dhabit,0,463.0,0,2,9,2,11
Hannes Löhr,0,165.0,0,0,3,0,3
Hannes Reinmayr,0,96.0,0,0,1,2,3
Hannu Tihinen,0,185.0,0,0,3,1,4
Hannu Turunen,0,41.0,0,0,0,1,1
Hans Buzek,0,127.0,0,0,1,1,2
Hans Cieslarczyk,1,18.0,0,0,0,1,1
Hans Fróði Hansen,0,86.0,0,0,1,0,1
Hans Gillhaus,0,157.0,0,0,0,2,2
Hans Holmqvist,0,68.0,0,0,0,1,1
Hans Krankl,5,938.0,0,2,14,5,19
Hans Maldonado,0,133.0,0,1,1,1,2
Hans Nordahl,0,26.0,0,0,0,1,1
Hans Persson,0,23.0,0,0,0,1,1
Hans Pirkner,0,106.0,0,1,2,0,2
Hans Richter,0,45.0,0,0,1,0,1
Hans Schäfer,6,388.0,0,0,3,5,8
Hans Vanaken,0,128.0,0,0,2,1,3
Hans-Jörg Pfister,0,148.0,0,0,0,2,2
Hans-Jürgen Kreische,0,454.0,0,0,3,6,9
Hans-Jürgen Riediger,0,29.0,0,0,1,0,1
Hans-Peter Briegel,0,26.0,0,0,0,1,1
Hans-Peter Friedländer,0,59.0,0,0,0,1,1
Hans-Peter Schild,0,18.0,0,0,0,1,1
Hans-Peter Zwicker,0,2.0,0,0,0,1,1
Hansi Müller,1,30.0,0,0,1,0,1
Hany Ramzy,1,169.0,0,0,1,1,2
Hao Haidong,2,709.0,0,0,9,7,16
Hao Junmin,1,473.0,0,1,5,2,7
Harald Berg,0,183.0,0,0,2,1,3
Harald Brattbakk,0,24.0,0,0,1,0,1
Harald Cerny,0,186.0,0,0,1,2,3
Harald Hennum,0,98.0,0,0,3,0,3
Harald Sunde,0,119.0,0,0,1,1,2
Haraldur Ingólfsson,0,61.0,0,0,1,0,1
Hardy Binguila,0,81.0,0,0,0,1,1
Hared Robleh,0,29.0,0,0,0,1,1
Hari Khadka,3,134.0,0,1,2,1,3
Harib Al-Maazmi,0,54.0,0,0,1,0,1
Haris Medunjanin,0,363.0,0,0,4,4,8
Haris Mohammed,0,81.0,0,0,0,1,1
Haris Seferovic,4,587.0,0,0,7,7,14
Haris Škoro,0,83.0,0,0,1,0,1
Harold Amaru,3,214.0,0,0,2,1,3
Harold Hassall,0,70.0,0,0,2,0,2
Harold Legodi,0,86.0,0,0,0,1,1
Harold Lozano,1,90.0,0,0,0,1,1
Harold Ng Fok,1,90.0,0,0,0,1,1
Harold Wallace,1,54.0,0,0,1,0,1
Haroldo Domingues,2,164.0,0,0,3,0,3
Haron Shakava,0,49.0,0,0,0,1,1
Harouna Traoré,0,76.0,0,0,1,0,1
Harris Tchilimbou,0,69.0,0,0,0,1,1
Harrison Róchez,2,125.0,0,0,2,2,4
Harry Andersson,3,179.0,0,0,0,3,3
Harry Bild,0,72.0,0,0,1,0,1
Harry Duggan,1,88.0,0,0,1,0,1
Harry Elyse Randrianaivo,0,102.0,0,0,2,0,2
Harry Hestad,0,160.0,0,0,2,0,2
Harry Kane,10,2228.0,0,13,23,21,44
Harry Keough,0,35.0,0,1,0,1,1
Harry Kewell,5,735.0,0,1,6,7,13
Harry Lubse,0,48.0,0,0,1,0,1
Harry Maguire,2,245.0,0,0,2,4,6
Harry Milanzi,0,193.0,0,0,3,2,5
Harry Panayiotou,0,148.0,0,1,0,3,3
Harry Randrianaivo,0,185.0,0,0,3,0,3
Harry Souttar,2,333.0,0,0,4,2,6
Harry Waya,1,91.0,0,1,2,0,2
Harry Wilson,0,45.0,0,0,0,2,2
Harry Winks,0,32.0,0,0,0,1,1
Harry Zech,0,53.0,0,0,0,1,1
Hartmut Schade,0,68.0,0,0,1,1,2
Haruhisa Hasegawa,1,88.0,0,0,1,0,1
Harun Jusoh,1,89.0,0,0,0,1,1
Haruna Ilerika,2,97.0,0,0,0,2,2
Harutyun Vardanyan,0,56.0,0,0,1,0,1
Hasabu El Sagheir,0,9.0,0,0,0,1,1
Hasan Ali Kaldırım,0,24.0,0,0,1,0,1
Hasan Salihamidžić,1,135.0,0,0,1,3,4
Hasan Şaş,2,51.0,0,0,1,1,2
Hasan Şengün,0,124.0,0,0,0,2,2
Hashim Saleh,0,29.0,0,0,0,1,1
Hashim Sayed Isa,0,124.0,0,1,2,0,2
Hassan Abbas,1,85.0,1,0,1,0,1
Hassan Abdel-Fattah,1,987.0,0,2,10,7,17
Hassan Akesbi,0,14.0,0,0,0,1,1
Hassan Al-Haydos,2,674.0,0,4,10,4,14
Hassan Amcharrat,2,87.0,0,0,1,2,3
Hassan Ayoub,1,41.0,0,0,0,1,1
Hassan Bashir,2,84.0,0,2,1,1,2
Hassan Chaito,0,126.0,0,0,2,0,2
Hassan El-Shazly,10,412.0,0,1,11,1,12
Hassan Fallatah,0,34.0,0,0,0,1,1
Hassan Korongo,0,45.0,0,1,1,0,1
Hassan Maatouk,2,356.0,0,3,6,3,9
Hassan Mili,0,46.0,0,0,1,0,1
Hassan Mohamed,0,35.0,0,0,0,1,1
Hassan Mostafa,0,80.0,0,0,0,1,1
Hassan Mubarak,1,42.0,0,0,1,1,2
Hassan Mubiru,0,94.0,0,0,2,0,2
Hassan Mudhafar,0,21.0,0,1,1,0,1
Hassan Myuter Saied Al Suwaidi,0,62.0,0,0,1,0,1
Hassan Nader,1,114.0,0,0,2,0,2
Hassan Rowshan,2,491.0,0,0,5,3,8
Hassan Saeed Ahmed,0,137.0,0,0,3,0,3
Hassan Shehata,1,156.0,0,0,3,1,4
Hassane Bandé,1,39.0,0,0,0,1,1
Hasse Borg,0,119.0,0,3,3,0,3
Hasse Jeppson,2,130.0,0,0,1,2,3
Hassen Gabsi,1,245.0,0,0,1,2,3
Hassouneh Al-Sheikh,1,33.0,0,0,1,0,1
Hatem Aqel,0,91.0,0,1,2,0,2
Hatem Ben Arfa,0,90.0,0,0,0,1,1
Hattan Bahebri,2,51.0,0,0,1,1,2
Hawar Mulla Mohammed,4,155.0,0,2,4,1,5
Hayao Kawabe,0,71.0,0,0,1,0,1
Hayden Foxe,0,125.0,0,0,2,0,2
Hayden Tinto,0,45.0,0,0,0,1,1
Hayk Hakobyan,0,72.0,0,0,1,0,1
Haykel Guemamdia,1,79.0,0,1,2,2,4
Haytham Tambal,1,400.0,0,0,5,2,7
Hazem Emam,2,153.0,0,0,3,0,3
He Jia,1,61.0,0,0,1,0,1
Heath Dickinson,1,18.0,1,0,1,0,1
Hector Sam,0,84.0,0,0,1,0,1
Hector Wright,1,248.0,0,1,4,2,6
Hedgardo Marín,1,8.0,0,0,1,0,1
Heiko Herrlich,0,42.0,0,0,1,0,1
Heiko Westermann,0,114.0,0,0,1,1,2
Heimana Paama,1,13.0,1,0,1,0,1
Heimano Bourebare,1,25.0,0,0,1,0,1
Heimo Pfeifenberger,0,199.0,0,0,5,1,6
Heiner Mora,1,47.0,0,0,1,0,1
Heini Vatnsdal,0,72.0,0,0,1,0,1
Heinrich Isaacks,0,17.0,0,0,1,0,1
Heinrich Schmidtgal,0,46.0,0,0,0,1,1
Heinrich Uukkivi,0,3.0,0,0,0,1,1
Heinz Flohe,2,197.0,0,0,2,1,3
Heinz Hermann,0,211.0,0,0,2,2,4
Heinz Lüdi,0,2.0,1,0,1,0,1
Heinz Schneiter,2,179.0,0,0,1,2,3
Heinz Strehl,0,69.0,0,0,1,0,1
Heitor,0,22.0,0,0,1,0,1
Heiðar Helguson,0,144.0,0,0,3,1,4
Heleno de Freitas,8,289.0,0,0,6,3,9
Helgi Sigurðsson,0,142.0,0,0,2,1,3
Helman Mkhalele,3,171.0,0,1,3,1,4
Helmut Bicek,0,90.0,0,1,2,0,2
Helmut Haller,5,352.0,0,1,7,2,9
Helmut Köglberger,0,106.0,0,0,0,2,2
Helmut Müller,0,35.0,0,0,1,0,1
Helmut Rahn,10,618.0,0,0,7,4,11
Helmut Redl,0,147.0,0,0,3,1,4
Helmut Schön,0,111.0,0,0,2,0,2
Helmut Senekowitsch,0,66.0,0,0,0,1,1
Helmut Siber,0,175.0,0,0,2,1,3
Hendrik Isemborghs,0,91.0,0,0,1,1,2
Hendrik Somaeb,0,64.0,0,0,1,0,1
Hendry Thomas,0,90.0,0,0,1,0,1
Henk Groot,0,195.0,0,0,1,2,3
Henk Wery,0,20.0,0,0,0,1,1
Henk van Spaandonck,0,37.0,0,0,0,1,1
Hennadiy Lytovchenko,2,327.0,0,0,3,3,6
Hennadiy Zubov,0,95.0,0,0,2,1,3
Hennie van Nee,0,8.0,0,0,0,2,2
Henning Berg,0,278.0,1,0,4,1,5
Henning Enoksen,0,120.0,0,0,2,0,2
Henning Frenzel,0,484.0,0,0,5,2,7
Henning Jarnskor,0,12.0,0,0,1,0,1
Henning Jensen,0,83.0,0,0,1,1,2
Henning Munk Jensen,0,124.0,0,1,2,0,2
Henok Goitom,0,9.0,0,0,0,1,1
Henri Anier,1,246.0,0,0,2,3,5
Henri Baillot,0,63.0,0,0,1,1,2
Henri Camara,7,859.0,0,0,7,9,16
Henri Coppens,1,289.0,0,1,4,3,7
Henri Klein,0,74.0,0,0,2,0,2
Henri Konan,1,90.0,0,1,0,1,1
Henri Mbazumutima,0,72.0,0,0,0,2,2
Henri Saivet,1,13.0,0,0,1,0,1
Henrico Botes,0,75.0,0,0,1,0,1
Henrik Andersen,0,85.0,0,0,1,0,1
Henrik Dalsgaard,0,90.0,0,0,0,1,1
Henrik Larsen,3,97.0,0,0,0,4,4
Henrik Larsson,9,1558.0,0,6,19,8,27
Henrikh Mkhitaryan,0,986.0,0,4,10,8,18
Henrique Tembe,0,44.0,0,0,0,1,1
Henry Fa'arodo,1,482.0,0,4,6,5,11
Henry Koto,1,88.0,0,0,1,0,1
Henry Martín,1,218.0,0,0,1,2,3
Henry McKop,0,62.0,0,0,0,1,1
Henry Morris,0,160.0,0,0,0,3,3
Henry Motego,0,73.0,0,1,2,0,2
Henry Nwosu,1,103.0,0,0,1,1,2
Henryk Bałuszyński,0,4.0,0,0,1,0,1
Henryk Kasperczak,0,12.0,0,0,1,0,1
Henryk Martyna,0,52.0,0,0,1,0,1
Henryk Wieczorek,0,77.0,0,0,1,0,1
Herbert Binkert,0,16.0,0,0,0,1,1
Herbert Hermann,0,27.0,0,0,1,0,1
Herbert Marquez,0,58.0,0,0,1,0,1
Herbert Martin,0,68.0,0,1,1,0,1
Herbert Pankau,0,132.0,0,0,2,0,2
Herbert Prohaska,0,345.0,0,2,5,2,7
Herbert Sandin,0,56.0,0,0,1,0,1
Herbert Sosa,0,88.0,0,1,1,0,1
Herbert Wimmer,1,135.0,0,0,1,1,2
Herbert Zimmermann,0,119.0,0,0,1,1,2
Herculez Gomez,0,127.0,0,0,2,0,2
Herfried Sabitzer,0,80.0,0,0,1,0,1
Heribert Weber,0,66.0,0,0,1,0,1
Heriberto Morales,0,11.0,1,0,1,0,1
Herilia Rafanodina,0,57.0,0,0,1,0,1
Herman Soliz,0,27.0,1,0,1,0,1
Hermann Hreiðarsson,0,183.0,0,0,1,4,5
Hermenegildo Segrera,0,269.0,0,0,1,3,4
Herminio Masantonio,8,584.0,0,0,8,3,11
Hernando Bolados,0,30.0,0,0,1,0,1
Hernando Salazar,1,85.0,0,0,0,1,1
Hernán Crespo,7,1111.0,0,2,17,9,26
Hernán Darío Herrera,0,223.0,0,1,3,2,5
Hernán Gaviria,1,101.0,0,0,0,2,2
Hernán Medford,5,688.0,0,1,5,7,12
Hernán Rengifo,0,175.0,0,0,1,1,2
Hernâni Ferreira da Silva,0,30.0,0,0,2,0,2
Herry Kiswanto,0,188.0,0,0,2,1,3
Herry Risdianto,0,178.0,0,0,2,0,2
Hervé Bazile,1,70.0,0,1,1,0,1
Hervé Revelli,0,238.0,0,0,0,5,5
Hesham Hanafy,0,24.0,0,0,1,0,1
Hesham Mohammed,0,369.0,0,0,9,0,9
Hesham Shaban,0,81.0,0,0,1,0,1
Heston Munthali,0,76.0,0,0,1,1,2
Hicham Aboucherouane,1,72.0,0,0,1,1,2
Hicham Mahdoufi,0,43.0,1,0,1,0,1
Hicham Zerouali,2,108.0,0,0,0,2,2
Hichem Essifi,0,73.0,0,0,2,0,2
Hideaki Kitajima,1,79.0,0,0,1,0,1
Hideki Maeda,1,80.0,0,1,1,0,1
Hidemasa Morita,0,90.0,0,0,2,0,2
Hidetoshi Nakata,1,320.0,0,0,7,1,8
Hilaire Kédigui,0,83.0,0,0,2,0,2
Hilal El-Helwe,2,367.0,0,1,4,2,6
Hillal Soudani,2,291.0,0,0,5,1,6
Hillary Makasa,1,90.0,0,0,1,0,1
Himson Teleda,0,108.0,0,0,2,0,2
Hipólito Rincón,0,382.0,0,0,7,0,7
Hiro Labaste,0,55.0,0,0,0,1,1
Hiroaki Morishima,4,329.0,0,0,3,3,6
Hiromi Hara,0,200.0,0,0,3,1,4
Hiroshi Kiyotake,0,123.0,0,1,2,1,3
Hiroshi Nanami,5,228.0,0,0,4,3,7
Hirving Lozano,1,407.0,0,0,4,3,7
Hisashi Kato,0,84.0,0,0,0,1,1
Hisashi Kurosaki,0,69.0,0,0,1,0,1
Hisham Abdul-Munam,0,90.0,0,0,1,0,1
Hla Htay,1,64.0,0,0,1,1,2
Hlaing Bo Bo,1,86.0,0,0,2,0,2
Hlynur Birgisson,0,70.0,1,0,1,0,1
Hocine Achiou,2,159.0,0,0,2,0,2
Hocine Benmiloudi,1,62.0,0,0,1,0,1
Hocine Yahi,1,168.0,0,0,2,0,2
Hok Sochetra,0,77.0,0,0,2,0,2
Holger Badstuber,0,86.0,0,0,1,0,1
Hollies Vato,1,143.0,0,0,1,1,2
Homam Ahmed,1,25.0,0,0,0,1,1
Homayoun Behzadi,0,249.0,0,0,4,0,4
Homos,1,39.0,0,0,1,0,1
Hong Jeong-ho,0,4.0,0,0,1,0,1
Hong Myung-bo,4,234.0,0,2,0,4,4
Hong Sung-Ho,1,33.0,0,0,1,0,1
Hong Yong-jo,1,495.0,0,1,5,3,8
Honorato Gonzabay,2,117.0,2,0,0,2,2
Horacio Casarín,1,286.0,0,0,5,0,5
Horst Hrubesch,3,108.0,0,0,1,2,3
Horst Kohle,0,72.0,0,0,0,1,1
Horst Köppel,0,73.0,0,0,0,1,1
Horst Nemec,0,120.0,0,0,3,0,3
Horst Schade,0,70.0,0,0,1,0,1
Horst Siegl,1,330.0,0,0,5,0,5
Horst Szymaniak,0,78.0,0,1,0,2,2
Horst-Dieter Höttges,0,51.0,0,0,1,0,1
Hosny Abd Rabo,5,440.0,0,6,6,3,9
Hossam Ghaly,0,38.0,0,0,1,0,1
Hossam Hassan,8,1101.0,0,2,11,9,20
Hossein Faraki,2,232.0,0,0,2,1,3
Hossein Kalani,5,372.0,0,0,7,0,7
Hossein Kanaanizadegan,0,18.0,0,0,1,0,1
Hossein Kazerani,0,41.0,0,0,1,1,2
Hossein Zamani,1,81.0,0,0,0,1,1
Hotaru Yamaguchi,0,90.0,0,0,1,0,1
Houmane Jarir,2,236.0,0,0,2,2,4
Housain Al-Mogahwi,1,67.0,0,0,0,1,1
Houssam Wadi,0,12.0,0,0,1,0,1
Houssine Kharja,1,555.0,0,2,4,4,8
Hovhannes Goharyan,0,23.0,0,0,1,0,1
Hovhannes Hambardzumyan,0,116.0,0,0,2,0,2
Hrayr Mkoyan,0,120.0,1,0,2,0,2
Hristo Bonev,2,952.0,0,6,10,9,19
Hristo Iliev,0,345.0,0,0,4,2,6
Hristo Kolev,0,169.0,0,0,2,1,3
Hristo Stoichkov,9,1244.0,0,13,17,11,28
Hristo Yanev,0,109.0,0,0,1,1,2
Hsu Te Ming,1,90.0,0,0,1,0,1
Huang Bowen,0,57.0,0,0,1,0,1
Huang Che-ming,1,62.0,0,0,0,1,1
Huang Wei-yi,1,203.0,0,0,1,2,3
Huang Xiangdong,5,341.0,0,0,2,3,5
Hubert Hien,1,50.0,0,0,0,1,1
Hubert Robson,0,74.0,0,0,0,1,1
Hubert Sambo,1,21.0,0,0,1,0,1
Hubert Suda,0,66.0,0,1,2,0,2
Hughton Hector,0,90.0,0,0,1,0,1
Hugo Almeida,1,402.0,0,0,3,5,8
Hugo Brizuela,0,166.0,0,0,2,1,3
Hugo Coscia,0,29.0,0,0,0,1,1
Hugo Eduardo Rubio,0,99.0,0,0,6,0,6
Hugo Galeano,0,30.0,1,0,1,0,1
Hugo González,0,56.0,1,0,0,1,1
Hugo Hovenkamp,1,49.0,0,0,1,1,2
Hugo Kiesse,0,103.0,0,0,0,2,2
Hugo Morales,0,86.0,0,0,0,1,1
Hugo Pérez,0,49.0,0,1,1,0,1
Hugo Rodallega,0,88.0,0,0,0,2,2
Hugo Sotil,1,179.0,0,0,3,1,4
Hugo Sánchez,0,174.0,0,1,2,2,4
Hugo Talavera,0,57.0,0,0,1,1,2
Hugo Viana,0,86.0,0,0,1,0,1
Hugues Guillaume,0,113.0,0,0,2,0,2
Huh Jung-Moo,1,294.0,0,0,5,1,6
Humam Tariq,1,60.0,0,0,1,0,1
Humberto Coelho,0,112.0,0,0,3,0,3
Humberto Francisco Scovino,0,46.0,0,0,1,0,1
Humberto Maschio,9,471.0,0,2,9,0,9
Humberto Moreno,0,47.0,0,0,1,0,1
Humberto Recanatini,2,80.0,0,2,2,0,2
Humberto Scovino,1,59.0,0,0,0,1,1
Humberto Suazo,4,779.0,0,4,6,9,15
Humberto Álvarez,1,19.0,0,1,1,0,1
Humphrey Edobor,1,35.0,0,0,2,1,3
Hung Kai-chun,0,65.0,0,0,0,1,1
Husain Ali,1,475.0,0,0,4,5,9
Hussain Al-Hadhri,0,8.0,0,0,1,0,1
Hussain Al-Musawi,0,90.0,0,0,1,0,1
Hussain Ali Baba,1,31.0,0,1,0,1,1
Hussain Fadhel,0,62.0,0,0,1,1,2
Hussain Seraj,0,12.0,0,0,1,0,1
Hussam Fawzi,2,263.0,0,0,3,3,6
Hussein Abdulghani,0,102.0,0,0,2,1,3
Hussein Ahmad Satter,2,81.0,0,0,2,0,2
Hussein Ali Al-Saedi,1,53.0,0,0,1,0,1
Hussein Hamdan,0,90.0,0,0,1,0,1
Hussein Saeed,2,452.0,0,0,3,4,7
Hussein Yassin,0,84.0,0,0,1,0,1
Hutson Charles,0,146.0,0,0,1,1,2
Huub Stevens,0,65.0,0,0,1,0,1
Huỳnh Quang Thanh,0,152.0,0,0,1,2,3
Hwang Hee-chan,2,312.0,0,1,5,1,6
Hwang In-beom,0,47.0,0,0,1,0,1
Hwang Jae-won,1,120.0,0,0,0,1,1
Hwang Sang-hoi,2,158.0,0,0,1,1,2
Hwang Seok-keun,0,47.0,0,0,0,1,1
Hwang Sun-hong,9,632.0,0,0,13,4,17
Hwang Ui-jo,2,162.0,0,1,4,0,4
Hwangbo Kwan,4,236.0,0,0,2,3,5
Hysen Zmijani,0,173.0,1,0,2,1,3
Hà Vương Ngầu Nại,1,61.0,0,0,1,0,1
Håkan Mild,1,97.0,0,0,1,1,2
Håkan Sandberg,0,31.0,0,0,1,0,1
Håvard Flo,1,46.0,0,0,0,1,1
Håvard Nielsen,0,72.0,0,0,1,0,1
Håvard Nordtveit,0,111.0,1,0,0,2,2
Héctor Altamirano,2,140.0,0,2,3,1,4
Héctor Bailetti,1,40.0,0,0,0,1,1
Héctor Castro,7,643.0,0,0,2,10,12
Héctor Chumpitaz,1,135.0,1,0,1,1,2
Héctor De Bourgoing,1,15.0,0,1,1,0,1
Héctor Demarco,2,89.0,0,0,0,3,3
Héctor Facundo,1,4.0,0,0,1,0,1
Héctor González,1,250.0,0,0,2,2,4
Héctor Hernández,1,305.0,0,1,1,3,4
Héctor Herrera,2,402.0,0,0,4,1,5
Héctor Hurtado,1,79.0,0,0,1,0,1
Héctor Magliano,4,189.0,0,0,0,4,4
Héctor Marchena,0,59.0,1,0,1,0,1
Héctor Moreno,1,316.0,1,0,0,5,5
Héctor Ortiz,1,103.0,0,1,2,0,2
Héctor Puebla,0,21.0,0,0,1,0,1
Héctor Ramos,0,158.0,0,0,4,0,4
Héctor Scarone,9,552.0,0,0,4,10,14
Héctor Silva,0,216.0,0,0,4,1,5
Héctor Socorro,3,264.0,0,0,3,2,5
Héctor Tapia,0,70.0,0,0,0,1,1
Héctor Yazalde,2,83.0,0,0,2,0,2
Héctor Zelaya,0,8.0,0,0,0,1,1
Hédi Berkhissa,1,41.0,0,0,2,0,2
Hélder,0,74.0,0,0,1,0,1
Hélder Costa,0,25.0,0,0,1,0,1
Hélder Cristóvão,0,75.0,0,0,0,1,1
Hélder Pelembe,0,54.0,0,0,1,0,1
Hélder Postiga,2,1206.0,0,0,12,6,18
Hélder Vicente,0,18.0,0,0,1,0,1
Hélder Vicente de Jesus Serafin,1,90.0,1,0,0,1,1
Héldon Ramos,2,278.0,0,1,4,1,5
Hérita Ilunga,0,44.0,0,0,0,1,1
Hörður Björgvin Magnússon,0,163.0,0,0,1,1,2
Hồ Tấn Tài,1,89.0,0,0,1,1,2
I Kadek Agung Widnyana,1,39.0,0,0,0,1,1
I. M. Vijayan,2,157.0,0,0,1,3,4
Iago Aspas,1,204.0,0,0,1,2,3
Iain Dowie,0,388.0,0,3,7,4,11
Iain Hume,0,353.0,0,0,0,5,5
Iain Ramsay,1,216.0,0,0,1,2,3
Iamel Kabeu,0,30.0,0,0,1,0,1
Ian Azzopardi,0,82.0,1,0,0,1,1
Ian Edwards,0,164.0,0,0,4,0,4
Ian Evans,0,53.0,1,0,2,0,2
Ian Gaynair,0,40.0,0,0,0,1,1
Ian Goodison,0,206.0,0,0,3,0,3
Ian Gray,0,149.0,0,0,2,0,2
Ian Harte,1,198.0,0,3,3,4,7
Ian Hunter,3,450.0,0,0,3,2,5
Ian Lake,0,488.0,0,0,6,4,10
Ian Rush,0,871.0,0,0,13,5,18
Ian St. John,2,129.0,0,0,1,2,3
Ian Stewart,0,72.0,0,0,2,0,2
Ian Walsh,0,199.0,0,0,1,2,3
Ian Wright,4,468.0,0,0,2,5,7
Ianis Hagi,0,95.0,0,0,1,1,2
Ianis Zicu,0,78.0,0,0,1,0,1
Iau Tuan Naukoot,1,37.0,0,0,0,1,1
Iban Iyanga,0,169.0,0,0,2,1,3
Iban Salvador,0,144.0,0,1,2,0,2
Ibrahim Afellay,0,223.0,0,0,3,1,4
Ibrahim Al Duraihem,3,186.0,0,1,0,3,3
Ibrahim Al Farhan,0,73.0,0,1,0,1,1
Ibrahim Al-Harbi,0,73.0,0,0,1,0,1
Ibrahim Al-Hardan,0,65.0,0,0,1,1,2
Ibrahim Al-Maadani,0,61.0,0,0,1,0,1
Ibrahim Al-Rumaihi,1,52.0,1,0,1,0,1
Ibrahim Al-Shahrani,3,256.0,0,0,1,3,4
Ibrahim Amada,1,9.0,0,0,1,0,1
Ibrahim Aoudou,1,60.0,0,1,2,0,2
Ibrahim Bayesh,0,22.0,0,0,0,1,1
Ibrahim Din,2,113.0,0,0,2,0,2
Ibrahim Farhan,0,59.0,0,0,0,2,2
Ibrahim Fazeel,0,169.0,0,0,3,0,3
Ibrahim Hassan,0,96.0,0,0,2,0,2
Ibrahim Kargbo,0,38.0,0,1,1,0,1
Ibrahim Kassum,0,57.0,0,0,1,0,1
Ibrahim Koroma,0,58.0,0,0,1,0,1
Ibrahim Mahudhee,0,27.0,0,0,0,1,1
Ibrahim Said,0,89.0,0,0,0,1,1
Ibrahim Sangaré,2,124.0,0,0,1,1,2
Ibrahim Sekagya,0,131.0,0,0,2,0,2
Ibrahim Sowed,0,94.0,0,0,2,1,3
Ibrahim Sunday,4,256.0,0,0,3,2,5
Ibrahim Suwayed,0,93.0,0,0,0,2,2
Ibrahim Yahia El-Kawarty,1,90.0,0,0,0,1,1
Ibrahima Bakayoko,2,632.0,0,1,9,4,13
Ibrahima Baldé,0,33.0,0,0,1,0,1
Ibrahima Diawara,1,82.0,0,0,0,1,1
Ibrahima Koné,6,355.0,0,4,4,4,8
Ibrahima Sonko,0,8.0,0,0,1,0,1
Ibrahima Sory Touré,0,66.0,0,1,1,0,1
Ibrahima Tallé,0,86.0,0,0,1,0,1
Ibrahima Traoré,2,190.0,0,0,1,3,4
Ibraime Cassamá,0,45.0,0,0,1,0,1
Ibroihim Djoudja,0,49.0,0,0,1,0,1
Ich Narding,0,96.0,0,0,2,0,2
Idan Tal,0,26.0,0,0,1,1,2
Idris Abdul Karim,0,87.0,0,0,1,0,1
Idrissa Gueye,2,156.0,0,0,2,1,3
Idrissa Sylla,1,43.0,0,0,1,0,1
Ifeanyi Onyedika,0,35.0,0,0,1,0,1
Igli Tare,0,345.0,0,0,5,2,7
Ignace Muwawa,1,19.0,0,0,0,1,1
Ignacio Ambríz,0,157.0,0,0,4,0,4
Ignacio Jáuregui,0,81.0,0,0,0,1,1
Ignacio Prieto,0,204.0,0,1,3,1,4
Ignatius Lwipa,0,132.0,0,0,0,2,2
Igor Armaș,0,141.0,1,0,2,1,3
Igor Avdeyev,1,217.0,1,0,4,0,4
Igor Belanov,4,391.0,0,3,7,1,8
Igor Bugaiov,0,165.0,0,1,3,2,5
Igor Chislenko,3,346.0,0,0,4,4,8
Igor Demo,0,297.0,0,0,4,0,4
Igor Diveyev,0,28.0,0,0,0,1,1
Igor Dobrovolski,4,285.0,0,3,4,2,6
Igor Kolyvanov,0,545.0,0,0,4,5,9
Igor Korneev,0,87.0,0,0,1,0,1
Igor Mitreski,0,68.0,1,0,0,1,1
Igor Netto,1,68.0,0,0,1,1,2
Igor Nikolovski,0,111.0,0,0,0,2,2
Igor Oprea,0,62.0,0,0,0,3,3
Igor Picușceac,0,1.0,0,0,1,0,1
Igor Semshov,0,77.0,0,0,1,1,2
Igor Sergeyev,1,335.0,0,0,3,3,6
Igor Shalimov,0,229.0,0,1,1,3,4
Igor Shitov,0,57.0,1,0,1,0,1
Igor Shkvyrin,1,201.0,0,0,4,1,5
Igor Simutenkov,0,90.0,0,0,1,1,2
Igor Tudor,2,231.0,1,0,2,2,4
Igor Yanovsky,0,45.0,0,0,1,0,1
Igor Štimac,0,56.0,0,0,1,0,1
Igoris Morinas,0,79.0,0,0,0,2,2
Igors Stepanovs,0,90.0,0,0,0,1,1
Igors Tarasovs,0,116.0,1,0,2,0,2
Ihaab Boussefi,2,89.0,0,0,2,0,2
Ihar Hurynovich,0,88.0,0,0,0,1,1
Ihar Stasevich,0,90.0,0,0,0,2,2
Ikechi Anya,0,126.0,0,0,0,2,2
Ikechukwu Uche,0,247.0,0,0,4,1,5
Ikhsan Fandi,1,91.0,0,0,2,1,3
Ildar Amirov,0,158.0,1,0,2,0,2
Ildefons Lima,0,390.0,2,4,5,3,8
Ildefonso López,7,386.0,0,0,1,6,7
Ildefonso Sanabria,1,11.0,0,0,0,1,1
Ildemaro Fernández,0,65.0,0,0,1,0,1
Ildo Maneiro,1,23.0,0,0,0,1,1
Ilham Jaya Kesuma,0,184.0,0,0,4,1,5
Ilhomjon Suyunov,0,89.0,0,0,0,1,1
Ilia Gruev,0,68.0,0,0,0,1,1
Ilia Kovalenko,1,160.0,0,0,1,1,2
Ilian Iliev,0,70.0,0,0,0,1,1
Ilias Chair,0,49.0,0,0,1,0,1
Ilias Yfantis,0,48.0,0,0,0,1,1
Ilie Balaci,0,56.0,0,0,1,0,1
Ilie Dumitrescu,3,356.0,0,0,7,1,8
Ilija Najdoski,0,21.0,0,0,1,0,1
Ilija Nestorovski,0,343.0,0,1,3,2,5
Ilija Petković,1,100.0,0,0,3,0,3
Ilija Vukotić,0,82.0,0,0,1,0,1
Ilir Kepa,0,67.0,0,0,1,0,1
Ilir Përnaska,0,144.0,0,0,2,1,3
Iliyan Mitsanski,0,31.0,0,0,1,1,2
Ilja Antonov,0,75.0,0,0,1,0,1
Ilya Tsymbalar,1,154.0,0,0,1,2,3
Ilčo Naumoski,0,281.0,0,1,4,2,6
Im Seung-Hwi,1,58.0,0,0,1,0,1
Imad Zatara,1,71.0,0,0,0,1,1
Iman Mobali,1,84.0,0,0,0,1,1
Imants Bleidelis,0,249.0,0,0,5,1,6
Imed Ben Younes,3,142.0,0,0,2,1,3
Imed Mhedhebi,0,210.0,0,0,2,2,4
Imowa Malgbanga,0,149.0,0,0,1,1,2
Imran Louza,0,135.0,0,1,2,0,2
Imre Boda,0,171.0,0,1,1,2,3
Imre Garaba,0,44.0,0,0,1,0,1
Imre Markos,0,89.0,0,0,0,1,1
Imre Szabics,0,405.0,0,0,5,2,7
Imrich Stacho,0,4.0,0,1,1,0,1
Imthyas Raheem,3,115.0,0,0,0,3,3
Imtiaz Ahmed Nakib,1,90.0,0,0,0,1,1
Inder Singh,2,102.0,0,0,1,1,2
Indra Putra Mahayuddin,0,74.0,0,0,1,0,1
Indra Sahdan Daud,0,135.0,0,0,2,0,2
Indrek Zelinski,0,322.0,0,0,4,2,6
Indriði Sigurðsson,0,132.0,0,0,0,2,2
Inge Danielsson,0,156.0,0,0,1,2,3
Ingemar Erlandsson,0,70.0,0,1,1,0,1
Ingemar Teever,0,86.0,0,0,1,1,2
Ingi Björn Albertsson,0,33.0,0,0,1,0,1
Ingvar Svensson,0,90.0,0,0,1,0,1
Iniesta,0,12.0,0,0,0,1,1
Inoel Navarro,0,77.0,0,0,3,0,3
Inyong Lolumbuman,0,73.0,0,0,0,1,1
Ioan Andone,0,25.0,0,0,1,0,1
Ioan Lupescu,0,131.0,0,0,4,0,4
Ioan Sabău,0,124.0,0,0,3,0,3
Ioannis Amanatidis,0,140.0,0,0,1,1,2
Ioannis Fetfatzidis,0,72.0,0,0,2,0,2
Ioannis Kousoulos,0,188.0,0,0,1,3,4
Ioannis Okkas,0,895.0,0,0,11,6,17
Ioannis Pittas,0,42.0,0,0,1,0,1
Ion Dumitru,0,18.0,0,0,1,1,2
Ion Geolgău,0,148.0,0,0,0,2,2
Ion Ionescu,0,133.0,0,0,2,0,2
Ion Nicolaescu,0,159.0,0,0,1,2,3
Ion Nunweiller,0,81.0,1,0,1,0,1
Ion Pârcălab,0,1.0,0,0,1,0,1
Ion Testemițanu,0,61.0,0,1,1,1,2
Ion Vlădoiu,0,50.0,0,0,1,0,1
Ionel Augustin,0,30.0,0,0,0,1,1
Ionel Ganea,1,573.0,0,1,4,5,9
Ionuţ Mazilu,0,87.0,0,0,1,0,1
Iosif Petschovsky,0,51.0,0,1,1,0,1
Iosif Vigu,0,2.0,0,0,1,0,1
Ipojucan Lins de Araújo,1,87.0,0,0,1,0,1
Iraj Danaeifard,2,117.0,0,0,2,0,2
Ireneo Hermosilla,0,70.0,0,0,1,0,1
Ireneusz Jeleń,0,78.0,0,0,1,1,2
Irfan Bachdim,0,84.0,0,0,1,0,1
Irfan Fandi,1,88.0,1,0,1,0,1
Irvin Herrera,0,41.0,0,0,0,1,1
Irwan Fadzli Idrus,1,56.0,0,0,1,0,1
Isa Bakar,2,36.0,0,0,2,0,2
Isa Halim,1,27.0,0,0,0,1,1
Isaac Andrade,1,61.0,0,0,0,1,1
Isaac Angking,1,56.0,0,1,1,1,2
Isaac Boakye,2,396.0,0,0,2,3,5
Isaac Boelua Lokuli,0,123.0,0,0,2,0,2
Isaac Chauvet,0,220.0,0,0,4,0,4
Isaac Kiese Thelin,0,78.0,0,0,1,0,1
Isaac Mina,0,12.0,0,0,0,1,1
Isaac Ngoma,1,72.0,0,0,0,2,2
Isaac Terrazas,1,74.0,0,0,0,1,1
Isaac Tondo,0,245.0,0,0,2,1,3
Isabelino Gradín,4,281.0,0,0,0,5,5
Isco,1,219.0,0,0,6,1,7
Ishmael Addo,0,89.0,0,0,1,0,1
Ishmael Wadi,1,38.0,0,0,0,1,1
Isiah Lagutang,0,23.0,0,0,1,0,1
Isidoro Díaz,1,284.0,0,0,5,2,7
Isidro Gutiérrez,0,26.0,0,0,1,1,2
Isidro Lángara,1,295.0,0,1,5,3,8
Isidro Matute,3,131.0,0,0,3,0,3
Islam Batran,0,85.0,0,0,1,0,1
Islam Slimani,8,1212.0,0,2,12,11,23
Islambek Kuat,0,328.0,0,0,3,2,5
Islom Inomov,0,79.0,0,0,0,1,1
Islom Tukhtakhujaev,0,72.0,0,0,1,0,1
Ismaeel Mohammad,0,75.0,0,0,1,0,1
Ismaeil Bakhit,0,157.0,0,0,2,0,2
Ismael Alassane,0,3.0,0,0,1,0,1
Ismael Alvariza,0,53.0,0,0,0,1,1
Ismael Dyfan,0,134.0,0,0,1,1,2
Ismael Díaz,1,49.0,0,0,1,0,1
Ismael Fuentes,0,48.0,0,0,1,0,1
Ismael Rivero,3,119.0,0,0,0,3,3
Ismael Sylla,0,77.0,0,0,1,0,1
Ismael Urzaiz,0,206.0,0,0,5,1,6
Ismail Abdullatif,5,917.0,0,3,13,3,16
Ismail Al Hammadi,0,270.0,0,0,3,1,4
Ismail Al-Ajmi,0,197.0,0,0,2,2,4
Ismail Al-Amour,1,88.0,0,0,0,1,1
Ismail Isa,0,3.0,0,0,0,1,1
Ismail Matar,0,524.0,0,1,4,6,10
Ismail Mohammed Sharif,0,108.0,0,0,1,1,2
Ismail Naseem,0,67.0,0,0,0,1,1
Ismail Rashid Ismail,0,89.0,0,0,1,0,1
Ismaël Bangoura,1,263.0,0,0,5,1,6
Ismaël Bennacer,0,48.0,0,0,0,1,1
Ismaël Diakité,0,90.0,0,0,1,0,1
Ismaël Koudou,1,10.0,0,0,0,1,1
Ismaïla Sarr,3,332.0,0,1,3,4,7
Ismed Sofyan,0,101.0,0,0,0,2,2
Ismo Lius,0,71.0,0,0,1,0,1
Israel Castro,0,19.0,0,0,1,0,1
Issa Ba,1,80.0,0,0,0,1,1
Issa Djibrilla,0,172.0,0,0,2,0,2
Issa Kaboré,1,51.0,0,0,0,1,1
Issah Gabriel Ahmed,1,60.0,1,0,0,1,1
Issam Al Sabhi,0,133.0,0,0,1,1,2
Issam El Adoua,0,10.0,0,0,0,1,1
Issam Jemâa,2,414.0,0,0,4,5,9
Issam Mahrous,1,66.0,1,0,1,0,1
Issam Said Saleh,0,83.0,0,0,1,0,1
Issey Nakajima-Farran,0,32.0,0,0,0,1,1
Issiaga Sylla,1,35.0,0,0,1,0,1
Issiaka Ouédraogo,1,90.0,0,0,0,1,1
Issouf Traoré,1,53.0,0,0,1,0,1
Issoufou Dayo,3,246.0,0,2,3,2,5
István Halász,0,43.0,0,0,0,1,1
István Juhász,0,75.0,0,0,1,0,1
István Pisont,0,88.0,0,0,0,1,1
István Szőke,1,94.0,0,0,1,1,2
István Vincze,0,147.0,0,0,2,2,4
Isuru Perera,0,47.0,0,0,1,0,1
Iswadi Idris,1,127.0,0,0,0,3,3
Isâad Bourahli,0,21.0,0,0,1,1,2
Italo Vassalo,0,101.0,0,0,1,0,1
Itamunua Keimuine,1,89.0,1,0,1,0,1
Itay Shechter,0,154.0,0,0,2,0,2
Itumeleng Duiker,0,37.0,0,0,0,1,1
Itzhak Peretz,0,54.0,0,0,1,0,1
Itzhak Shum,2,131.0,0,0,2,0,2
Itzik Zohar,0,290.0,0,0,0,5,5
Iulian Apostol,0,16.0,0,0,1,0,1
Iuliu Barátky,1,88.0,0,0,0,1,1
Iurie Miterev,0,85.0,0,0,2,0,2
Ivan Bek,3,157.0,0,0,0,3,3
Ivan Buljan,0,102.0,0,0,0,2,2
Ivan Davidov,1,43.0,1,0,0,1,1
Ivan Gudelj,0,37.0,0,0,1,1,2
Ivan Hašek,1,141.0,0,0,0,5,5
Ivan Iliev,0,84.0,0,0,0,1,1
Ivan Ivanov,0,86.0,0,0,1,1,2
Ivan Klasnić,2,299.0,0,0,3,2,5
Ivan Kolev,0,203.0,0,1,1,3,4
Ivan Matteoni,0,83.0,1,0,0,1,1
Ivan Mráz,0,18.0,0,0,2,0,2
Ivan Obradović,0,24.0,0,0,0,1,1
Ivan Perišić,10,1201.0,0,0,12,13,25
Ivan Rakitić,2,486.0,0,2,5,4,9
Ivan Schranz,0,75.0,0,0,1,1,2
Ivan Tričkovski,0,65.0,0,0,1,1,2
Ivan Vicelich,0,227.0,0,0,4,1,5
Ivan Vutsov,2,82.0,2,0,1,1,2
Ivan Yaremchuk,1,66.0,0,0,1,0,1
Ivaylo Chochev,0,229.0,0,0,2,1,3
Ivaylo Petkov,0,68.0,0,0,1,0,1
Ivaylo Yordanov,0,104.0,0,0,1,1,2
Ivelin Popov,0,429.0,0,0,6,4,10
Iver Fossum,0,8.0,0,0,1,0,1
Ivica Grlić,0,68.0,0,0,0,1,1
Ivica Horvat,1,9.0,1,0,1,0,1
Ivica Olić,3,502.0,0,0,5,7,12
Ivica Osim,0,192.0,0,0,3,0,3
Ivica Vastić,1,560.0,0,1,6,3,9
Ivica Šurjak,2,306.0,0,1,2,6,8
Ivo Basay,4,306.0,0,0,5,0,5
Ivo Knoflíček,0,149.0,0,0,2,1,3
Ivo Raimundo Traça,0,57.0,0,0,1,0,1
Ivor Allchurch,2,542.0,0,0,5,5,10
Ivor Broadis,2,102.0,0,0,0,3,3
Iván Córdoba,1,117.0,0,2,2,1,3
Iván Guerrero,0,158.0,0,0,1,2,3
Iván Helguera,0,89.0,0,0,2,0,2
Iván Hurtado,1,137.0,1,0,1,1,2
Iván Kaviedes,3,528.0,0,0,4,5,9
Iván Valenciano,0,171.0,0,0,3,1,4
Iván Zamorano,3,1338.0,0,5,19,6,25
Izet Hajrović,0,239.0,0,0,1,3,4
Iļja Vestermans,0,123.0,0,0,1,2,3
J. P. Rodrigues,0,51.0,1,0,1,0,1
Jaap Stam,0,32.0,0,0,1,0,1
Jaba Kankava,1,175.0,0,0,0,5,5
Jabarry Chandler,0,90.0,0,0,0,1,1
Jabra Al-Zarqa,0,70.0,0,0,1,0,1
Jabu Pule,0,71.0,0,0,0,1,1
Jacek Bąk,0,3.0,0,0,1,0,1
Jacek Góralski,0,81.0,0,0,1,0,1
Jacek Krzynówek,0,593.0,0,0,2,6,8
Jacek Ziober,0,85.0,0,0,0,1,1
Jacinto Barquín,1,42.0,0,0,0,1,1
Jacinto João,0,73.0,0,0,1,1,2
Jacinto Santos,0,93.0,0,0,2,0,2
Jack Chamangwana,0,88.0,1,0,1,0,1
Jack Charlton,0,168.0,0,0,2,0,2
Jack Froggatt,0,25.0,0,0,1,0,1
Jack Grealish,1,176.0,0,0,1,1,2
Jack Michael Morillo,0,79.0,0,0,1,0,1
Jack Rowley,0,167.0,0,0,4,0,4
Jack Samani,2,249.0,0,0,3,1,4
Jack Wilshere,0,130.0,0,0,0,2,2
Jackie Henderson,0,89.0,0,0,0,1,1
Jackie Milburn,0,129.0,0,0,0,3,3
Jackie Mudie,1,280.0,0,0,4,2,6
Jackner Louis,0,90.0,0,0,0,1,1
Jackson Irvine,1,155.0,0,0,1,4,5
Jackson Martínez,2,296.0,0,0,2,3,5
Jacky Novi,0,43.0,1,0,0,1,1
Jacky Valette,1,90.0,0,0,0,1,1
Jacob Bruun Larsen,0,63.0,0,0,1,0,1
Jacob Ewane,0,90.0,0,0,1,0,1
Jacob Mulenga,3,256.0,0,0,5,2,7
Jacob Ngwira,0,64.0,0,0,1,0,1
Jacob Xowie,0,62.0,0,0,1,0,1
Jacobo Kouffati,0,2.0,0,0,1,0,1
Jacques Faivre,0,47.0,0,0,2,0,2
Jacques Fatton,0,341.0,0,0,3,3,6
Jacques Foix,0,57.0,0,0,1,0,1
Jacques Haeko,6,478.0,0,0,5,2,7
Jacques Mamounoubala,1,80.0,0,0,1,0,1
Jacques Ndomba,1,65.0,0,0,1,0,1
Jacques Stockman,0,277.0,0,0,1,4,5
Jacques Teugels,0,87.0,0,1,0,1,1
Jacques Tuyisenge,0,108.0,0,0,3,0,3
Jacques Vergnes,0,33.0,0,0,0,1,1
Jacques Zimako,0,164.0,0,0,1,1,2
Jacques-Désiré Périatambée,0,45.0,0,0,0,1,1
Jadallah Kheirelseid,0,43.0,0,0,0,1,1
Jaden Servania,0,66.0,0,0,1,0,1
Jadon Sancho,0,89.0,0,0,2,0,2
Jafar Irismetov,3,489.0,0,0,8,3,11
Jafet Soto,4,301.0,0,2,4,2,6
Jaffar Omran,1,90.0,0,0,1,0,1
Jagajeet Shrestha,0,89.0,0,0,1,0,1
Jagdoul,0,80.0,0,0,1,0,1
Jahid Hasan Ameli,0,138.0,0,0,3,0,3
Jahn Ivar Jakobsen,0,46.0,0,0,1,0,1
Jahongir Ergashev,0,17.0,0,0,0,1,1
Jaime Alas,0,96.0,0,0,1,1,2
Jaime Arrascaita,0,47.0,0,0,1,0,1
Jaime Ayoví,1,35.0,0,0,2,0,2
Jaime Belmonte,1,166.0,0,0,2,0,2
Jaime Castrillón,3,149.0,0,0,1,2,3
Jaime Colomé,1,156.0,0,1,1,3,4
Jaime González,0,90.0,0,0,2,0,2
Jaime Graça,0,138.0,0,0,3,0,3
Jaime Gutiérrez,1,32.0,0,0,2,0,2
Jaime Lozano,2,551.0,0,0,6,5,11
Jaime Moreno,1,241.0,0,0,3,3,6
Jaime Morón,0,86.0,0,0,1,0,1
Jaime Patricio Ramírez,1,10.0,0,0,0,1,1
Jaime Pizarro,1,68.0,0,1,0,1,1
Jaime Ramírez,4,443.0,0,1,7,2,9
Jaime Riveros,0,39.0,0,0,0,1,1
Jaime Vera,2,260.0,0,0,3,0,3
Jaime Vladimir Cubías,0,89.0,0,0,0,1,1
Jaime de Almeida,1,38.0,0,0,1,0,1
Jaimes McKee,0,76.0,0,0,2,0,2
Jair,4,556.0,0,1,15,0,15
Jair Catuy,1,155.0,0,0,2,0,2
Jair García,1,31.0,0,0,0,1,1
Jairo Arreola,0,55.0,0,0,1,0,1
Jairo Arrieta,1,71.0,0,0,1,0,1
Jairo Castillo,0,173.0,0,0,1,2,3
Jairo Henríquez,1,43.0,0,0,0,3,3
Jairo Jiménez,1,85.0,0,0,1,0,1
Jairo Patiño,3,194.0,0,0,2,1,3
Jairo Quinteros,1,40.0,1,0,0,1,1
Jairzinho,9,707.0,0,0,9,3,12
Jaka Ihbeisheh,2,176.0,0,0,3,0,3
Jake Gosling,0,87.0,0,0,0,1,1
Jakkaphan Kaewprom,0,18.0,0,0,1,0,1
Jakob Johansson,0,61.0,0,0,1,0,1
Jakob Poulsen,0,165.0,0,0,2,0,2
Jakub Brabec,0,68.0,0,0,2,0,2
Jakub Błaszczykowski,2,388.0,0,3,4,6,10
Jakub Jankto,1,74.0,0,0,1,1,2
Jakub Kosecki,0,90.0,0,0,1,0,1
Jakub Moder,0,58.0,0,0,0,1,1
Jakub Pešek,0,38.0,0,0,1,0,1
Jakub Wawrzyniak,0,81.0,0,0,1,0,1
Jalal Hosseini,1,179.0,0,0,2,3,5
Jaloliddin Masharipov,4,99.0,0,1,2,2,4
Jamal Abu Abed,0,146.0,0,0,1,1,2
Jamal Al-Holi,1,29.0,0,1,0,1,1
Jamal Ballantyne,0,9.0,0,0,0,1,1
Jamal Chandler,0,25.0,0,0,0,1,1
Jamal Charles,0,80.0,0,0,1,0,1
Jamal Kazem,0,6.0,0,0,1,0,1
Jamal Keshek,2,93.0,0,0,1,1,2
Jamal Mohamed,0,44.0,0,1,1,0,1
Jamal Mubarak,0,67.0,0,0,1,0,1
Jamal Musiala,0,83.0,0,0,0,1,1
Jamal Rashid,1,90.0,0,1,0,1,1
Jamal Taha,0,53.0,0,0,1,0,1
Jamal Willer,0,65.0,0,0,1,0,1
Jamal Yaqoub,0,88.0,0,0,1,0,1
Jameleddine Limam,0,245.0,0,0,4,1,5
James Chamanga,4,159.0,0,0,1,3,4
James Chewitt,0,412.0,0,0,3,4,7
James Collins,0,160.0,0,0,1,2,3
James Debbah,1,258.0,0,1,3,1,4
James Ha,0,20.0,0,0,1,0,1
James Lawrence,0,17.0,1,0,1,0,1
James Marcelin,2,225.0,0,0,2,2,4
James McArthur,0,204.0,0,0,2,1,3
James McClean,0,349.0,0,0,2,4,6
James McFadden,0,594.0,0,0,7,3,10
James Milner,0,74.0,0,0,0,1,1
James Moga,0,166.0,0,0,2,1,3
James Morrison,0,27.0,0,0,0,1,1
James Murphy,0,80.0,0,0,1,0,1
James Rodríguez,6,984.0,0,4,8,11,19
James Troisi,1,237.0,0,0,2,1,3
James Ward-Prowse,0,93.0,0,0,1,1,2
James Wong,4,164.0,0,0,4,0,4
James Wong Chye Fook,1,6.0,0,0,0,1,1
Jamie Browne,0,65.0,0,0,1,1,2
Jamie Lawrence,0,14.0,0,0,0,1,1
Jamie Lowery,1,83.0,0,0,1,0,1
Jamie Maclaren,2,289.0,0,2,5,3,8
Jamie Pace,0,44.0,0,0,1,1,2
Jamie Thomas,0,86.0,0,0,1,0,1
Jamie Vardy,1,122.0,0,0,2,0,2
Jamie Ward,0,148.0,0,0,3,1,4
Jamil Joseph,0,114.0,0,0,3,0,3
Jamil Kyambadde,0,89.0,0,0,1,0,1
Jamiro Monteiro,1,52.0,0,0,0,1,1
Jamiru Amidu,0,14.0,0,0,0,1,1
Jamshed Ismailov,0,2.0,0,0,1,0,1
Jamshid Iskanderov,0,53.0,0,0,1,0,1
Jan Allan Müller,0,163.0,0,0,2,1,3
Jan Banaś,0,6.0,0,0,0,1,1
Jan Bartram,0,58.0,0,1,1,1,2
Jan Bednarek,1,59.0,0,0,0,1,1
Jan Berger,0,77.0,0,1,1,0,1
Jan Ceulemans,6,672.0,0,0,8,7,15
Jan Domarski,0,110.0,0,0,1,1,2
Jan Eriksson,0,125.0,0,0,3,0,3
Jan Fuglset,0,55.0,0,1,1,0,1
Jan Furtok,0,147.0,0,0,2,0,2
Jan Heintze,0,74.0,0,0,1,1,2
Jan Koller,4,1675.0,0,2,18,15,33
Jan Kopic,0,62.0,0,0,1,1,2
Jan Kristian Fjærestad,0,32.0,0,0,0,1,1
Jan Liberda,0,54.0,0,0,1,0,1
Jan Michaelsen,0,90.0,0,0,1,0,1
Jan Mulder,0,10.0,0,0,0,1,1
Jan Mølby,0,69.0,0,0,1,1,2
Jan Olsson,0,62.0,0,0,1,0,1
Jan Peters,0,89.0,0,0,1,0,1
Jan Polák,0,294.0,0,0,5,0,5
Jan Rezek,0,128.0,0,0,1,2,3
Jan Ríha,0,44.0,0,0,0,1,1
Jan Suchopárek,1,90.0,0,0,0,2,2
Jan Svensson,0,128.0,0,0,1,1,2
Jan Szmidt,0,29.0,0,0,1,0,1
Jan Sýkora,0,85.0,0,0,1,0,1
Jan Urban,0,86.0,0,0,1,0,1
Jan Vertonghen,2,380.0,0,0,2,4,6
Jan Åge Fjørtoft,0,278.0,0,0,5,2,7
Janek Meet,0,97.0,2,0,2,0,2
Jang Hyun-soo,0,104.0,0,1,1,1,2
Jang Kuk-chol,0,83.0,0,0,1,1,2
Jang Song-Hyok,0,54.0,0,1,0,1,1
Janne Lindberg,0,78.0,0,0,0,1,1
Janne Salli,0,63.0,0,0,1,0,1
Jannick Buyla,1,57.0,0,0,0,1,1
Jannik Vestergaard,0,90.0,0,0,1,0,1
Jano Ananidze,0,78.0,0,0,1,0,1
Janus Guðlaugsson,0,61.0,0,0,1,1,2
Janusz Kupcewicz,1,118.0,0,0,1,1,2
Janusz Żmijewski,0,147.0,0,0,0,3,3
Janício Martins,0,73.0,0,0,0,1,1
Jaouad Zairi,1,261.0,0,0,4,0,4
Jarchinio Antonia,0,45.0,0,0,1,0,1
Jared Borgetti,12,1795.0,0,1,29,8,37
Jari Litmanen,0,1007.0,0,4,8,10,18
Jari Rantanen,0,43.0,0,0,2,0,2
Jari Vanhala,0,60.0,0,0,1,0,1
Jarkko Hurme,0,55.0,0,0,1,0,1
Jarmo Manninen,0,88.0,0,0,1,0,1
Jaromír Zmrhal,0,47.0,0,0,1,0,1
Jaroslav Plašil,1,304.0,0,0,1,4,5
Jaroslav Pollák,0,16.0,0,0,0,1,1
Jaroslav Timko,0,147.0,0,0,3,0,3
Jarvin Skeete,0,104.0,0,0,2,0,2
Jasem Al-Huwaidi,13,959.0,0,0,11,10,21
Jasem Yaqoub,1,535.0,0,3,6,5,11
Jasim Al-Shaikh,0,51.0,0,0,1,0,1
Jason Culina,0,20.0,0,0,1,0,1
Jason Cunliffe,0,199.0,0,0,3,0,3
Jason Davidson,0,14.0,0,0,1,0,1
Jason Demetriou,0,80.0,0,0,0,1,1
Jason François,0,87.0,0,0,2,0,2
Jason Koumas,0,208.0,0,2,4,0,4
Jason Mayélé,0,108.0,0,0,3,0,3
Jason McAteer,0,141.0,0,0,2,1,3
Jason Roberts,0,119.0,0,1,4,1,5
Jason Scotland,0,49.0,0,0,1,0,1
Jason de Vos,1,166.0,0,0,2,1,3
Jasse Tuominen,0,21.0,0,0,1,0,1
Jassem Al-Tamimi,1,165.0,0,0,2,0,2
Jassim Mohammed Ghulam,0,71.0,0,0,0,1,1
Jassim Swadi,1,68.0,0,0,1,0,1
Jasur Khasanov,0,12.0,0,0,0,1,1
Javad Kazemian,1,78.0,0,0,1,0,1
Javad Manafi,1,90.0,0,0,0,1,1
Javad Nekounam,3,1032.0,0,2,12,5,17
Javain Brown,0,43.0,1,0,1,0,1
Javi Moreno,0,76.0,0,0,1,0,1
Javid Huseynov,0,4.0,0,0,1,0,1
Javier Ambrois,6,555.0,0,1,1,11,12
Javier Astúa,0,210.0,0,0,4,0,4
Javier Balboa,0,334.0,0,2,4,0,4
Javier Chevantón,1,302.0,0,1,3,3,6
Javier Delgado,0,127.0,1,0,2,0,2
Javier Ferreira,0,115.0,0,0,2,0,2
Javier Fragoso,0,148.0,0,0,3,0,3
Javier Guzmán,0,25.0,1,0,0,1,1
Javier Hernández,17,1430.0,0,2,10,14,24
Javier Manjarín,1,84.0,0,0,1,1,2
Javier Margas,0,154.0,0,0,1,2,3
Javier Mascherano,2,154.0,0,0,2,0,2
Javier Pastore,1,26.0,0,0,1,0,1
Javier Patiño,0,66.0,0,0,2,0,2
Javier Saviola,5,377.0,0,0,6,0,6
Javier Tamayo,0,61.0,0,0,0,1,1
Javier Valdivia,0,91.0,0,0,2,0,2
Javier Zanetti,1,89.0,0,0,2,0,2
Javokhir Sidikov,1,17.0,0,0,0,1,1
Jawad Khalaf,0,42.0,0,0,0,1,1
Jawdat Suleiman,1,90.0,0,0,1,0,1
Jawhar Mnari,1,73.0,0,0,1,1,2
Jay-Jay Okocha,3,394.0,0,2,8,3,11
Jaycee John Okwunwanne,1,68.0,0,0,1,1,2
Jaylee Hodgson,3,188.0,0,0,2,1,3
Jaylon Bather,1,40.0,0,0,1,0,1
Je-Vaughn Watson,1,132.0,1,0,2,1,3
Jean Alexandre,0,143.0,0,0,2,0,2
Jean Beausejour,2,167.0,0,0,2,1,3
Jean Capelle,1,15.0,0,0,0,1,1
Jean Desgranges,0,90.0,0,0,2,0,2
Jean Djorkaeff,0,41.0,0,1,1,0,1
Jean Dockx,0,60.0,0,0,1,0,1
Jean Foutika,2,121.0,0,0,2,0,2
Jean Gallice,0,89.0,0,0,1,0,1
Jean Hmae,2,180.0,0,0,2,0,2
Jean Jacques Radonamahafalison,0,15.0,0,0,0,1,1
Jean Janssens,0,31.0,0,0,0,1,1
Jean Kalala N'Tumba,3,283.0,0,0,3,4,7
Jean Klein,0,85.0,0,0,0,1,1
Jean Lomami,0,95.0,0,0,1,1,2
Jean Luciano,1,83.0,0,0,1,0,1
Jean Ludivion,1,82.0,0,0,0,1,1
Jean Makoun,0,292.0,0,0,5,0,5
Jean Maleb,3,299.0,0,0,0,4,4
Jean Manga Onguéné,1,228.0,0,0,2,2,4
Jean Meneses,0,56.0,0,0,0,1,1
Jean Michaël Seri,1,90.0,0,0,1,0,1
Jean Monuma,0,61.0,0,0,1,0,1
Jean Márquez,0,83.0,0,0,1,0,1
Jean Nako Naprapol,2,122.0,0,0,3,0,3
Jean Nicolas,1,370.0,0,1,2,5,7
Jean Paul Farrugia,0,14.0,0,0,1,0,1
Jean Petit,0,38.0,0,0,1,0,1
Jean Seri,0,64.0,0,0,1,0,1
Jean Sony Alcénat,0,40.0,0,0,1,0,1
Jean Tigana,1,62.0,0,0,0,1,1
Jean Tsaralaza,0,79.0,0,0,1,0,1
Jean Vincent,2,528.0,0,0,12,0,12
Jean Xowie,1,216.0,0,0,2,1,3
Jean-Alain Boumsong,0,42.0,0,0,1,0,1
Jean-Baptiste N'Doga,0,49.0,0,0,2,0,2
Jean-Brice Wadriako,1,53.0,0,0,1,0,1
Jean-Charles Castelletto,1,29.0,0,0,1,0,1
Jean-Claude Bras,0,82.0,0,0,2,0,2
Jean-Claude Désir,0,20.0,0,0,0,1,1
Jean-Claude Iranzi,0,70.0,0,0,1,0,1
Jean-Eudes Maurice,2,301.0,0,2,2,6,8
Jean-François Domergue,0,138.0,0,0,2,0,2
Jean-François Larios,0,196.0,0,2,1,2,3
Jean-Jacques Marcel,0,104.0,0,0,1,1,2
Jean-Jacques Missé-Missé,0,63.0,0,0,0,1,1
Jean-Jacques N'Domba,0,141.0,0,0,0,2,2
Jean-Kasongo Banza,0,88.0,0,0,0,1,1
Jean-Louis Bozon,1,15.0,0,0,0,1,1
Jean-Louis Straetmans,0,37.0,0,0,0,1,1
Jean-Loup Rousseau,6,339.0,0,1,6,1,7
Jean-Marc Ferreri,1,27.0,0,0,1,0,1
Jean-Marc Guillou,0,173.0,0,0,3,0,3
Jean-Marie Mbuyi,0,30.0,0,0,0,1,1
Jean-Marie Tsébo,1,55.0,0,0,1,1,2
Jean-Michel Larqué,0,66.0,0,0,0,1,1
Jean-Michel M'Bono,5,251.0,0,0,5,1,6
Jean-Paul,0,119.0,0,0,2,0,2
Jean-Paul Akono,0,4.0,0,1,1,0,1
Jean-Paul Brigger,0,149.0,0,1,2,1,3
Jean-Paul Girres,0,57.0,0,0,1,0,1
Jean-Philippe Durand,0,89.0,0,0,1,0,1
Jean-Philippe Peguero,2,56.0,0,0,2,0,2
Jean-Philippe Saïko,1,95.0,0,0,0,2,2
Jean-Pierre Fiala,0,88.0,0,0,1,0,1
Jean-Pierre Fiedler,0,5.0,0,0,0,1,1
Jean-Pierre Guede Akenon,0,71.0,0,1,1,0,1
Jean-Pierre Papin,4,968.0,0,4,10,10,20
Jean-Pierre Tokoto,0,40.0,0,0,0,1,1
Jean-Pierre Vanek,0,82.0,0,0,1,0,1
Jean-Robert Menelas,0,151.0,0,0,4,0,4
Jean-Sebastien Bax,0,88.0,0,0,0,1,1
Jean-Silvestre N'Keoua,0,29.0,0,0,0,1,1
Jean-Yves Randriamarozaka,0,61.0,0,0,1,0,1
Jeannot Reiter,0,60.0,0,0,1,1,2
Jeff Agoos,1,171.0,1,0,2,1,3
Jeff Campbell,0,325.0,0,0,5,0,5
Jeff Gellineau,0,2.0,0,0,1,0,1
Jeff Hendrick,0,52.0,0,0,0,2,2
Jeff Strasser,0,75.0,0,0,1,2,3
Jeff Whitley,0,69.0,0,0,0,2,2
Jefferson Farfán,1,975.0,0,1,14,4,18
Jefferson Lerma,0,6.0,0,0,0,1,1
Jefferson Montero,0,214.0,0,0,3,2,5
Jeffrey Bruma,0,78.0,0,0,1,0,1
Jeffrey Edmond,0,66.0,0,0,0,1,1
Jeffrey Kwaomae,1,43.0,0,0,0,1,1
Jeffrey Talan,0,71.0,0,0,1,0,1
Jehad Al-Hussain,0,236.0,0,1,3,2,5
Jehad Muntasser,0,21.0,0,0,1,1,2
Jeison Murillo,1,36.0,0,0,0,1,1
Jeje Lalpekhlua,1,182.0,0,0,1,2,3
Jelle Vossen,0,85.0,0,0,2,0,2
Jens Erik Rasmussen,0,9.0,0,0,1,0,1
Jens Jeremies,0,31.0,0,0,1,0,1
Jens Jørn Bertelsen,0,68.0,0,0,1,0,1
Jens Kristian Hansen,0,135.0,0,0,2,1,3
Jens Petersen,0,18.0,0,1,1,0,1
Jens Stryger Larsen,0,35.0,0,0,1,0,1
Jensy Muñoz,0,31.0,0,0,0,1,1
Jenílson Ângelo de Souza,1,64.0,0,0,0,1,1
Jenő Vincze,1,79.0,0,0,1,1,2
Jeong Gang-Ji,0,57.0,0,0,2,0,2
Jeong Sang-bin,0,77.0,0,0,1,0,1
Jeong Woo-yeong,1,80.0,0,0,0,1,1
Jeremain Lens,0,193.0,0,0,2,3,5
Jeremy Bokila,2,141.0,0,0,1,1,2
Jeremy Charles,0,72.0,0,0,1,0,1
Jeremy Christie,0,69.0,0,0,1,0,1
Jeris Tadrus,3,147.0,0,0,3,1,4
Jerko Leko,0,76.0,0,0,1,0,1
Jermain Defoe,1,698.0,0,0,9,5,14
Jermaine Anderson,0,90.0,0,0,1,0,1
Jermaine Beckford,0,89.0,0,0,1,0,1
Jermaine Hue,2,92.0,0,0,1,1,2
Jermaine Jones,1,150.0,0,0,3,0,3
Jerome Ramatlhakwane,0,110.0,0,1,1,1,2
Jerren Nixon,2,242.0,0,0,3,2,5
Jerry Akaminko,0,90.0,0,0,1,0,1
Jerry Alexander,0,315.0,0,0,4,3,7
Jerry Bengtson,4,598.0,0,0,8,5,13
Jerry Donga,1,64.0,0,0,0,2,2
Jerry Louis,0,89.0,0,0,1,0,1
Jerry Sitoe,0,45.0,0,0,1,0,1
Jerry Tondelua,3,249.0,0,2,2,2,4
Jerson Tegete,0,90.0,0,0,1,2,3
Jersson González,0,68.0,0,0,1,0,1
Jerzy Brzęczek,0,46.0,0,0,1,1,2
Jerzy Gorgoń,1,31.0,0,0,0,1,1
Jerzy Sadek,0,287.0,0,0,3,1,4
Jerzy Wilim,0,64.0,0,0,1,0,1
Jerzy Wostal,0,59.0,0,0,1,0,1
Jesdaporn Na Phatalung,3,121.0,0,1,1,2,3
Jesper Blomqvist,0,64.0,1,0,1,0,1
Jesper Grønkjær,1,95.0,0,0,1,1,2
Jesper Olsen,3,334.0,0,2,5,0,5
Jesse August,1,47.0,0,0,1,0,1
Jesse John,0,15.0,0,0,1,0,1
Jesse Lingard,1,132.0,0,0,3,0,3
Jesus Correia,0,53.0,0,0,1,0,1
Jesús Arellano,1,142.0,0,0,1,3,4
Jesús Dátolo,0,65.0,0,0,1,0,1
Jesús Ferreira,0,27.0,0,0,1,0,1
Jesús Julio,1,30.0,0,0,0,1,1
Jesús Julián Lucendo,0,85.0,0,1,0,1,1
Jesús Manuel Corona,2,386.0,0,0,2,4,6
Jesús María Zamora,0,82.0,0,0,1,0,1
Jesús Navas,1,192.0,0,0,1,2,3
Jesús Peláez Miranda,0,2.0,0,0,0,1,1
Jesús Reynaldo,0,179.0,0,0,3,0,3
Jesús Zavala,0,112.0,0,0,0,2,2
Jevgeni Novikov,0,86.0,0,0,1,0,1
Jevgeņijs Miļevskis,0,87.0,0,0,1,0,1
Jevon Francis,0,12.0,0,0,0,1,1
Jeyab Bashafal,0,55.0,0,0,1,0,1
Jhasmani Campos,2,192.0,0,0,1,2,3
Jhoan Sánchez,0,27.0,0,0,1,0,1
Jhon Chancellor,0,116.0,0,0,0,2,2
Jhon Murillo,0,51.0,0,0,0,1,1
Jhonny Acosta,0,69.0,0,0,1,1,2
Ji Dong-won,4,303.0,0,0,5,2,7
Ji Yun-nam,1,89.0,0,0,0,1,1
Jia Xiuquan,2,132.0,0,0,3,2,5
Jiana Raoelijaona,0,85.0,0,0,1,0,1
Jiang Ning,0,176.0,0,0,3,0,3
Jim Allevinah,2,236.0,0,0,3,1,4
Jim Bett,0,86.0,0,0,0,1,1
Jim Brennan,0,250.0,0,0,3,0,3
Jim Brown,1,89.0,0,0,0,1,1
Jim Holton,0,40.0,0,0,1,0,1
Jim Kremer,0,38.0,0,0,1,0,1
Jim Magilton,0,48.0,0,0,1,1,2
Jim McCalliog,0,87.0,0,0,0,1,1
Jim McLaughlin,0,85.0,0,0,2,0,2
Jimmy Ben,2,53.0,0,0,0,2,2
Jimmy Bermúdez,0,85.0,0,0,0,1,1
Jimmy Bone,0,20.0,0,0,0,1,1
Jimmy Conway,0,23.0,0,0,1,0,1
Jimmy Dickinson,1,94.0,1,0,1,0,1
Jimmy Doña,0,20.0,0,0,1,0,1
Jimmy Dunne,1,59.0,0,0,1,1,2
Jimmy Durmaz,0,89.0,0,0,2,0,2
Jimmy Floyd Hasselbaink,1,156.0,0,1,2,2,4
Jimmy Gatete,0,53.0,0,0,1,0,1
Jimmy Greaves,1,252.0,0,0,0,4,4
Jimmy Johnstone,0,3.0,0,0,0,1,1
Jimmy Kaierea,0,38.0,1,0,1,0,1
Jimmy Mackay,1,113.0,0,0,3,0,3
Jimmy Marín,0,3.0,0,0,1,0,1
Jimmy Mason,0,80.0,0,0,0,1,1
Jimmy McIlroy,0,233.0,0,1,2,2,4
Jimmy Modeste,0,26.0,0,0,1,0,1
Jimmy Muguwa,1,85.0,0,0,0,1,1
Jimmy Mulisa,0,27.0,0,0,1,0,1
Jimmy Mullen,0,126.0,0,0,0,2,2
Jimmy Murray,1,49.0,0,0,1,0,1
Jimmy Nicholl,0,111.0,1,0,1,1,2
Jimmy Nicholson,0,223.0,0,0,2,3,5
Jimmy Quinn,0,351.0,0,1,7,2,9
Jimmy Rooney,2,137.0,0,0,3,0,3
Jimmy Zakazaka,0,6.0,0,0,1,0,1
Jin Jingdao,0,39.0,0,0,1,0,1
Jiří Feureisl,1,69.0,0,0,0,1,1
Jiří Hledík,1,70.0,0,0,1,0,1
Jiří Novotný,0,73.0,0,0,1,0,1
Jiří Sloup,0,26.0,0,0,0,1,1
Jiří Sobotka,1,49.0,0,0,1,0,1
Jiří Štajner,0,82.0,0,0,1,0,1
Jo Inge Berget,0,51.0,0,0,1,0,1
Jo Paul Ancheri,0,188.0,0,0,1,3,4
Joachim Streich,2,1367.0,0,2,16,9,25
Joakim Mæhle,1,435.0,0,0,4,3,7
Joan Capdevila,0,21.0,0,0,2,0,2
Joan Morales,0,34.0,1,0,1,0,1
Joan Oumari,2,145.0,0,0,3,0,3
Joao Rafael Elias,0,43.0,0,0,1,0,1
Joao Rojas,0,90.0,0,0,0,1,1
Joaquim Alberto Silva,2,269.0,0,0,2,2,4
Joaquim Santana,0,30.0,0,0,1,0,1
Joaquim Santos,0,72.0,0,0,1,0,1
Joaquín,0,189.0,0,0,2,1,3
Joaquín Botero,0,760.0,0,1,14,3,17
Joaquín Correa,0,150.0,0,0,0,2,2
Joaquín Peiró,1,145.0,0,0,1,1,2
Joaquín Rivas,3,219.0,0,0,1,2,3
Joaquín Sierra,0,86.0,0,0,1,0,1
Joaquín del Olmo,0,52.0,0,0,1,0,1
Joash Leader,0,36.0,0,0,0,2,2
Job,0,135.0,0,0,1,1,2
Jobby Crossan,0,182.0,0,2,5,0,5
Jobi McAnuff,1,48.0,0,0,0,1,1
Jocelyn Ahouéya,0,91.0,0,0,2,0,2
Jocelyn Angloma,2,27.0,0,0,0,2,2
Jodel Dossou,0,43.0,0,0,1,0,1
Joe Aisa,0,35.0,0,1,0,1,1
Joe Allen,0,66.0,0,0,1,1,2
Joe Bell,1,50.0,0,0,0,1,1
Joe Cole,3,276.0,0,0,1,5,6
Joe Corona,0,123.0,0,0,3,0,3
Joe Emerson Bizera,1,22.0,0,0,1,0,1
Joe Gaetjens,1,38.0,0,0,0,1,1
Joe Harper,0,131.0,0,0,0,2,2
Joe Haverty,0,52.0,0,0,0,1,1
Joe Jordan,4,297.0,0,0,4,5,9
Joe Ledley,0,103.0,0,0,0,2,2
Joe Maca,1,48.0,0,1,0,1,1
Joe Masiga,0,108.0,0,0,1,2,3
Joe Royle,0,51.0,0,0,1,0,1
Joe Spiteri,0,51.0,0,0,1,0,1
Joe-Max Moore,2,479.0,0,3,7,2,9
Joel Antônio Martins,2,111.0,0,0,2,0,2
Joel Campbell,6,691.0,0,0,7,6,13
Joel Estrada,0,107.0,0,0,2,0,2
Joel Konofilla,1,89.0,0,0,1,0,1
Joel Lindpere,0,201.0,0,0,1,2,3
Joel Lupahla,1,71.0,0,0,0,1,1
Joel Minko,0,24.0,0,0,1,0,1
Joel Mogorosi,0,109.0,0,0,2,1,3
Joel Pohjanpalo,0,524.0,0,0,4,4,8
Joel Porter,6,290.0,0,0,6,0,6
Joerisse Cexome,1,79.0,0,0,1,0,1
Joetex Asamoah Frimpong,0,5.0,0,0,0,1,1
Joevin Jones,1,360.0,0,1,5,2,7
Joey Jones,0,70.0,0,0,0,1,1
Johan Cruyff,3,1131.0,0,0,20,5,25
Johan Cruz,0,66.0,0,0,0,1,1
Johan Devrindt,0,556.0,0,0,8,4,12
Johan Djourou,0,113.0,1,1,2,0,2
Johan Elmander,0,396.0,0,0,2,6,8
Johan Fano,0,178.0,0,0,3,0,3
Johan Mjällby,0,119.0,0,0,2,1,3
Johan Neeskens,4,423.0,0,5,7,5,12
Johan Venegas,1,158.0,0,0,2,2,4
Johan Vonlanthen,1,141.0,0,0,4,1,5
Johan Walem,1,7.0,0,0,1,0,1
Johann Eigenstiller,0,51.0,1,0,0,1,1
Johann Horvath,2,110.0,0,0,5,0,5
Johann Krankl,0,279.0,0,2,3,2,5
Johann Lonfat,0,64.0,0,0,1,0,1
Johann Obiang,0,75.0,1,0,1,0,1
Johann Paul,0,66.0,0,0,1,0,1
Johann Schmidradner,0,4.0,0,1,0,1,1
Johanna Omolo,1,163.0,0,0,1,2,3
Johannes Ortmann,0,80.0,0,0,1,0,1
John Aldridge,1,856.0,0,4,10,7,17
John Aloisi,5,1230.0,0,1,17,5,22
John Arne Riise,0,373.0,0,1,7,2,9
John Atyeo,0,293.0,0,0,2,2,4
John Banda,0,132.0,0,0,2,0,2
John Baraza,1,133.0,0,0,2,1,3
John Barnes,0,236.0,0,0,4,4,8
John Barry Nusum,0,528.0,0,0,7,5,12
John Bosman,3,798.0,0,0,9,6,15
John Boye,3,198.0,1,0,1,3,4
John Brooks,1,86.0,0,0,0,1,1
John Bunyenyezi,1,16.0,0,0,0,1,1
John Byrne,0,66.0,0,0,0,2,2
John Carew,0,746.0,0,1,10,5,15
John Catliff,0,160.0,0,2,2,2,4
John Charles,1,244.0,0,0,1,3,4
John Chiedozie,0,26.0,0,0,0,2,2
John Collins,1,470.0,0,2,5,5,10
John Connelly,0,5.0,0,0,1,0,1
John Dempsey,0,58.0,1,0,1,0,1
John Doyle,0,48.0,0,0,1,0,1
John Ebow Essien,1,28.0,0,0,1,0,1
John Egan,0,45.0,0,0,0,1,1
John Eriksen,1,62.0,0,0,1,0,1
John Greig,0,138.0,0,0,1,1,2
John Guidetti,0,80.0,0,0,1,0,1
John Hartson,0,436.0,0,1,6,4,10
John Heitinga,0,63.0,0,0,1,1,2
John Hewie,0,41.0,0,1,1,0,1
John Holland,0,151.0,2,0,2,0,2
John Hughes,0,39.0,0,0,1,0,1
John Jensen,1,128.0,0,0,4,0,4
John Kosmina,1,727.0,0,1,11,2,13
John Kramer,0,33.0,0,0,0,1,1
John Krogh,0,60.0,0,0,0,1,1
John Lauridsen,1,84.0,0,0,1,0,1
John Limniatis,1,60.0,0,0,0,1,1
John Lungu,0,44.0,0,0,0,1,1
John Maduka,0,78.0,0,0,0,1,1
John Mahoney,0,69.0,0,0,0,1,1
John Matkin,0,49.0,0,0,0,1,1
John McClelland,0,18.0,0,0,1,0,1
John McGinlay,0,40.0,0,0,2,1,3
John McGinn,0,461.0,0,0,10,1,11
John McPhail,0,25.0,0,0,1,0,1
John Mensah,2,34.0,0,0,2,0,2
John Metgod,0,138.0,0,0,2,1,3
John Morris Williams,0,90.0,0,0,0,1,1
John Moshoeu,0,249.0,0,0,4,0,4
John Méndez,0,89.0,0,0,1,0,1
John O'Brien,1,136.0,0,0,3,0,3
John O'Hare,0,41.0,0,0,3,0,3
John O'Neill,0,44.0,0,0,1,0,1
John O'Shea,0,163.0,1,0,1,2,3
John Pareanga,1,59.0,0,0,0,1,1
John Petersen,1,162.0,0,1,2,3,5
John Restrepo,0,156.0,0,0,2,0,2
John Robertson,1,373.0,0,4,7,1,8
John Robinson,0,59.0,0,0,2,0,2
John Sheridan,0,139.0,0,0,1,2,3
John Shore,0,82.0,0,0,0,1,1
John Sivebæk,0,57.0,0,0,0,1,1
John Smith,0,159.0,0,0,2,0,2
John Souttar,0,35.0,0,0,1,0,1
John Souza,1,75.0,0,0,1,1,2
John Stones,2,85.0,0,0,3,0,3
John Terry,0,85.0,0,0,1,0,1
John Toshack,0,353.0,0,0,3,4,7
John Utaka,2,191.0,0,0,1,2,3
John Wark,2,259.0,0,0,5,0,5
John Wilkinson,1,219.0,0,0,1,2,3
John de Wolf,0,137.0,0,0,2,0,2
John van 't Schip,0,47.0,0,0,1,0,1
John van den Brom,0,2.0,0,0,1,0,1
John-Patrick Strauß,0,149.0,0,0,0,2,2
Johnnier Montaño,1,87.0,0,0,0,1,1
Johnny Crossan,0,8.0,0,0,1,0,1
Johnny Descouines,3,138.0,0,0,3,0,3
Johnny Ekström,1,502.0,0,0,4,5,9
Johnny Gavin,0,80.0,0,1,2,0,2
Johnny Giles,0,41.0,0,0,1,0,1
Johnny Hall,0,99.0,0,0,0,2,2
Johnny Halsdorf,0,34.0,0,0,0,1,1
Johnny Haynes,1,146.0,0,0,0,3,3
Johnny Leverón,1,86.0,0,0,1,0,1
Johnny N'Wadioha,0,74.0,0,0,1,0,1
Johnny Nicholls,0,50.0,0,0,0,1,1
Johnny Rep,8,591.0,0,1,3,8,11
Johnny Russell,0,74.0,0,0,0,1,1
Johnny Squires,0,44.0,0,0,0,1,1
Johnny Thio,0,324.0,0,0,4,1,5
Johnny Warren,1,17.0,0,0,0,1,1
Johnny Watkiss,0,125.0,0,0,1,1,2
Johnson Bwalya,2,268.0,0,0,4,1,5
Johny Léonard,0,131.0,0,1,0,3,3
Joleon Lescott,1,30.0,0,0,0,1,1
Jomard Moussa,0,197.0,0,0,3,0,3
Jon Andoni Goikoetxea,2,132.0,0,0,1,2,3
Jon Dahl Tomasson,9,1833.0,0,5,16,20,36
Jon Kwang-ik,0,90.0,0,0,1,0,1
Jonah Ebanks,1,30.0,0,1,1,0,1
Jonas Bahamboula,1,82.0,0,0,1,1,2
Jonas Hector,0,97.0,0,0,0,2,2
Jonas Hofmann,0,116.0,0,0,1,1,2
Jonas Mendes,0,3.0,1,0,1,0,1
Jonas Ogandaga,0,5.0,0,0,0,1,1
Jonas Okétola,0,33.0,0,0,1,0,1
Jonas Paulionis,0,162.0,0,0,1,1,2
Jonas Svensson,0,57.0,0,0,0,1,1
Jonas Wind,0,152.0,0,0,0,2,2
Jonatan Johansson,0,474.0,0,0,6,5,11
Jonathan Akpoborie,0,113.0,0,0,1,1,2
Jonathan Ayité,1,45.0,0,0,0,1,1
Jonathan Barrios,0,9.0,0,0,1,0,1
Jonathan Bolingi,1,139.0,0,1,2,1,3
Jonathan Bornstein,0,90.0,0,0,1,0,1
Jonathan Bru,0,78.0,0,0,1,0,1
Jonathan Buatu,0,90.0,0,0,1,0,1
Jonathan Cantillana,1,121.0,0,0,3,0,3
Jonathan David,10,862.0,0,1,11,4,15
Jonathan Fabbro,0,33.0,0,1,1,1,2
Jonathan Faña,0,109.0,0,0,2,1,3
Jonathan Ikoné,0,85.0,0,0,1,0,1
Jonathan Kodjia,2,152.0,0,0,3,0,3
Jonathan Niva,0,44.0,0,0,0,1,1
Jonathan Osorio,1,62.0,0,0,1,1,2
Jonathan Perry,1,144.0,0,0,2,0,2
Jonathan Pitroipa,2,367.0,0,1,6,1,7
Jonathan Sogbie,0,55.0,0,0,0,1,1
Jonathan Tah,0,66.0,1,0,0,1,1
Jonathan Tehau,5,269.0,1,0,2,4,6
Jonathan Walters,0,492.0,0,3,7,3,10
Jonathan dos Santos,1,104.0,0,0,1,1,2
Jones Chilengi,1,23.0,1,0,1,1,2
Jones Mwewa,0,71.0,0,0,2,0,2
Jones Nkhwazi,0,88.0,0,0,1,0,1
Jong Chol-min,0,173.0,0,0,1,3,4
Jong Il-gwan,0,207.0,0,1,4,1,5
Jong Tae-Se,0,72.0,0,0,0,1,1
Joni,1,64.0,0,1,2,0,2
Jonny Evans,0,105.0,0,0,3,0,3
Jonny Magallón,0,63.0,0,0,1,0,1
Joona Toivio,0,148.0,1,0,2,0,2
Joonas Kolkka,0,324.0,0,0,6,0,6
Joonas Tamm,3,195.0,0,0,0,3,3
Jope Namawa Leka,1,4.0,0,0,0,1,1
Jordan Adéoti,0,33.0,0,0,1,0,1
Jordan Ayew,3,412.0,0,1,4,3,7
Jordan Henderson,2,187.0,1,0,2,2,4
Jordan Johnson,0,52.0,0,0,0,1,1
Jordan Morris,0,228.0,0,0,3,0,3
Jordan Perez,0,52.0,1,0,1,0,1
Jordan Wetria,1,78.0,0,0,1,0,1
Jordi Alba,3,168.0,0,0,2,4,6
Jordi Cruyff,1,66.0,0,0,0,1,1
Jordy Caicedo,0,85.0,0,1,0,1,1
Jordy Delem,1,84.0,0,0,1,0,1
Jorge Alcalde,2,266.0,0,0,5,2,7
Jorge Amado Nunes,0,82.0,0,0,0,1,1
Jorge Andrade,0,87.0,1,0,1,1,2
Jorge Aravena,0,260.0,0,0,3,3,6
Jorge Bengoché,0,88.0,0,0,1,0,1
Jorge Benjamín Araya,3,96.0,0,0,1,2,3
Jorge Bermúdez,0,50.0,0,0,1,1,2
Jorge Bolaño,1,7.0,0,0,0,1,1
Jorge Bolaños,1,100.0,0,0,0,2,2
Jorge Burruchaga,3,505.0,0,1,4,3,7
Jorge Cadete,0,372.0,0,0,5,0,5
Jorge Campos,1,65.0,1,0,0,1,1
Jorge Ceciliano,1,13.0,0,0,1,0,1
Jorge Claros,1,93.0,1,0,2,0,2
Jorge Contreras,1,121.0,0,1,1,1,2
Jorge Costa,1,29.0,1,0,1,0,1
Jorge Dely Valdés,2,550.0,1,0,4,8,12
Jorge Duilio Benitez,6,394.0,0,0,0,7,7
Jorge Estuardo Vargas,0,85.0,0,0,1,0,1
Jorge Gáspari,0,15.0,0,0,1,0,1
Jorge Hirano,4,280.0,0,0,2,3,5
Jorge Hugo Fernández,1,11.0,0,0,1,0,1
Jorge Insfran,0,92.0,0,0,1,1,2
Jorge Larraz,5,189.0,0,4,2,3,5
Jorge Laurido,1,75.0,1,0,0,1,1
Jorge Lino Romero,2,130.0,0,0,1,1,2
Jorge Luis Alarcón,0,9.0,0,0,1,0,1
Jorge Luis Campos,1,156.0,0,0,1,1,2
Jorge López Caballero,1,58.0,0,0,1,0,1
Jorge Martín Núñez,0,68.0,0,0,1,0,1
Jorge Monge,0,127.0,0,0,1,3,4
Jorge Muñoz Luna,0,80.0,0,0,1,0,1
Jorge Orlando Aravena Plaza,0,252.0,0,0,4,1,5
Jorge Oyarbide,0,279.0,0,0,4,0,4
Jorge Peredo,0,201.0,0,0,3,1,4
Jorge Peñaloza,0,51.0,0,0,0,1,1
Jorge Plácido,0,88.0,0,0,2,0,2
Jorge Ramírez Gallego,0,89.0,0,0,0,1,1
Jorge Rodríguez,0,284.0,0,2,6,1,7
Jorge Rojas,0,7.0,0,0,1,0,1
Jorge Sarmiento,0,41.0,0,0,1,0,1
Jorge Sota,0,24.0,0,0,1,0,1
Jorge Soto,2,396.0,0,1,6,1,7
Jorge Sánchez,0,21.0,0,0,1,0,1
Jorge Toro,0,129.0,0,0,2,0,2
Jorge Valdano,4,136.0,0,0,5,0,5
Jorge Valdivia,1,85.0,0,0,1,1,2
Jorge Vickers,0,19.0,0,0,1,0,1
Jorge Álvarez,1,59.0,0,0,1,0,1
Jorginho,0,217.0,0,3,2,1,3
Jorginho Putinatti,0,23.0,0,0,1,0,1
Joris Marveaux,1,45.0,0,0,0,1,1
Joris Mathijsen,0,41.0,0,0,1,1,2
Jorma Vaihela,0,179.0,0,0,1,1,2
Jorman Aguilar,0,31.0,0,0,1,0,1
Josateki Kurivitu,1,90.0,0,0,1,0,1
Jose Albornoz,0,90.0,0,0,0,1,1
Jose Maria Garcia,2,91.0,0,0,0,2,2
Jose Neves,0,60.0,0,0,1,0,1
Jose Tognola,1,77.0,0,0,0,1,1
Joseba Etxeberria,1,496.0,0,0,2,6,8
Josef Bican,1,109.0,0,0,1,0,1
Josef Gauchel,1,168.0,0,0,3,0,3
Josef Hickersberger,0,99.0,0,0,3,0,3
Josef Hügi,0,346.0,0,0,6,2,8
Josef Jelínek,0,31.0,0,0,1,0,1
Josef Jurkanin,0,73.0,0,0,1,0,1
Josef Kadraba,1,88.0,0,0,2,0,2
Josef Košťálek,1,93.0,0,0,1,0,1
Josef Ludl,0,73.0,0,0,1,0,1
Josef Martínez,2,449.0,0,0,5,3,8
Josef Masopust,1,85.0,0,0,1,2,3
Josef Novák,0,52.0,0,0,0,1,1
Josef Rasselnberg,0,183.0,0,0,0,4,4
Josef Shirdel,1,79.0,0,0,1,0,1
Josef Silný,0,33.0,0,0,0,1,1
Josef Stering,0,122.0,0,0,3,0,3
Josef Zeman,1,111.0,0,0,1,0,1
Josef Šural,0,35.0,0,0,0,1,1
Joselito Vaca,0,84.0,0,0,1,0,1
Josep Maria Fusté,1,38.0,0,0,1,1,2
Joseph Aghoghovbia,0,47.0,0,0,1,0,1
Joseph Bassey,1,82.0,0,0,0,1,1
Joseph Bléziri,1,66.0,0,0,0,1,1
Joseph Chahrestan,3,223.0,0,0,2,1,3
Joseph Chipolina,0,29.0,1,0,1,0,1
Joseph Enakarhire,0,28.0,0,0,0,1,1
Joseph Francis,0,17.0,0,0,0,1,1
Joseph Ghartey,1,40.0,0,0,0,1,1
Joseph Kaboré,2,114.0,0,0,2,0,2
Joseph Kamwendo,0,66.0,0,0,1,0,1
Joseph Maluka,0,35.0,0,0,2,0,2
Joseph Mapulanga,1,157.0,0,0,2,1,3
Joseph Marrero,0,87.0,0,0,1,0,1
Joseph Mbarga,0,64.0,0,0,1,0,1
Joseph Mbong,0,102.0,0,0,2,0,2
Joseph Mendes,1,279.0,0,1,3,1,4
Joseph Mounoundzi,0,66.0,0,1,1,0,1
Joseph Obas,0,155.0,0,0,2,1,3
Joseph Ouattara,0,52.0,0,0,0,1,1
Joseph Sam,0,51.0,0,0,0,1,1
Joseph Ujlaki,0,316.0,0,0,0,5,5
Joseph Urpani,0,39.0,0,0,1,0,1
Joseph Wamba,0,76.0,0,0,1,0,1
Joseph Yegba Maya,0,64.0,0,0,1,0,1
Joseph Yobo,2,303.0,2,0,3,3,6
Joseph-Désiré Job,3,251.0,0,0,3,1,4
Joses Nawo,0,59.0,0,0,1,0,1
Josh Magennis,0,526.0,0,0,3,4,7
Josh Parker,0,162.0,0,0,2,0,2
Josh Simpson,0,112.0,0,0,3,0,3
Josh Wolff,0,179.0,0,0,4,1,5
Joshua John,2,115.0,0,0,0,2,2
Joshua Kennedy,0,455.0,0,0,6,2,8
Joshua Kimmich,0,131.0,0,0,0,2,2
Joshua King,0,722.0,0,5,6,8,14
Joshua Pérez,0,123.0,0,0,1,2,3
Josimar,2,97.0,0,0,1,1,2
Josip Brekalo,0,90.0,0,0,1,0,1
Josip Bukal,0,199.0,0,0,0,4,4
Josip Drmić,1,393.0,0,0,4,1,5
Josip Iličić,0,608.0,0,4,5,8,13
Josip Katalinski,2,312.0,1,1,6,2,8
Josip Skoblar,1,136.0,0,2,3,1,4
Josip Skoko,1,151.0,0,0,1,4,5
Josip Šimunić,0,86.0,0,0,1,1,2
Joslin Kamatuka,1,146.0,0,0,1,1,2
Jostein Flo,0,271.0,0,0,2,3,5
Josué Anunciado de Oliveira,1,68.0,0,0,0,1,1
Josué Duverger,1,46.0,1,0,1,0,1
Josué Martínez,1,59.0,0,0,0,1,1
Josy Kirchens,0,38.0,0,0,1,0,1
José Alfredo Castillo,0,367.0,0,1,3,3,6
José Altafini,2,201.0,0,0,0,3,3
José Anthony Torres,0,90.0,1,0,1,0,1
José Antonio Castro,0,79.0,0,0,0,1,1
José Antonio Reyes,0,177.0,0,0,0,2,2
José Antonio Vázquez,1,37.0,0,0,0,1,1
José Ariel Núñez,0,18.0,0,0,1,0,1
José Artetxe,1,11.0,0,0,0,1,1
José Augusto Torres,3,338.0,1,0,3,2,5
José Augusto de Almeida,3,166.0,0,0,0,4,4
José Aveiro,6,250.0,0,0,3,3,6
José Avendaño,3,113.0,0,0,2,1,3
José Batista,0,9.0,0,0,1,0,1
José Borello,3,221.0,0,0,3,0,3
José Bustamante,0,27.0,0,0,0,2,2
José Cardona,1,19.0,0,0,1,0,1
José Cardozo,4,979.0,0,2,11,7,18
José Carlos Guimarães,1,53.0,0,0,1,0,1
José Cea,0,128.0,0,0,2,0,2
José Chamot,1,54.0,0,0,0,1,1
José Ciprian Alfonso,1,57.0,0,0,0,2,2
José Claramunt,0,122.0,0,1,1,2,3
José Clayton,0,123.0,0,3,4,0,4
José Coelho,0,66.0,0,0,1,0,1
José Domingo Insfrán,0,59.0,1,0,0,1,1
José Durand Laguna,0,10.0,0,0,1,0,1
José Emilio Amavisca,0,49.0,0,0,0,1,1
José Eulogio Gárate,0,196.0,0,0,4,0,4
José Fabián Paz y Miño,0,81.0,0,0,1,0,1
José Fajardo,1,85.0,0,0,0,1,1
José Fernández,4,201.0,0,0,1,3,4
José Filipe Correia Semedo,0,34.0,0,0,0,1,1
José Francisco Rojo,1,116.0,0,0,1,1,2
José Gabriel Chaparro,0,59.0,0,0,1,0,1
José García,3,223.0,0,0,0,4,4
José Gaslini,1,75.0,0,0,1,0,1
José Gavica,1,133.0,0,0,1,1,2
José Gayà,0,14.0,0,0,1,0,1
José Gómez,1,28.0,0,0,1,0,1
José Hmae,2,39.0,0,0,2,0,2
José Iraragorri,2,43.0,0,1,0,2,2
José Jacinto Vega,0,89.0,0,0,1,0,1
José Javier del Aguila,1,16.0,0,0,1,0,1
José João Pereira,0,47.0,0,0,0,1,1
José Kanté,1,48.0,0,0,1,0,1
José Leal,0,34.0,0,0,1,0,1
José Leandro Andrade,1,69.0,0,0,0,1,1
José Luis Aussin,0,14.0,0,0,1,0,1
José Luis Brown,1,23.0,0,0,1,0,1
José Luis Caminero,4,518.0,0,0,2,6,8
José Luis Capón,0,85.0,0,0,1,0,1
José Luis Chilavert,1,506.0,0,5,5,3,8
José Luis Dolgetta,4,358.0,0,0,0,6,6
José Luis Ferraro,2,161.0,0,0,2,0,2
José Luis Garcés,2,132.0,0,0,3,1,4
José Luis Gayà,0,71.0,0,0,0,1,1
José Luis González Dávila,0,53.0,0,0,2,1,3
José Luis Lamadrid,1,257.0,0,0,2,3,5
José Luis Panizo,0,15.0,0,0,1,0,1
José Luis Pineda,1,72.0,0,0,1,1,2
José Luis Rodríguez,2,91.0,0,0,2,0,2
José Luis Sierra,3,56.0,0,0,2,1,3
José Luis Veloso,0,79.0,0,0,1,1,2
José Luis Violeta,0,86.0,0,0,0,1,1
José Luís,0,83.0,0,0,1,0,1
José Macia,3,98.0,0,0,3,0,3
José Magriñá,1,69.0,0,0,1,0,1
José Manuel Abundis,0,166.0,0,0,6,0,6
José Manuel Contreras,1,158.0,0,0,2,0,2
José Manuel Moreno,12,493.0,0,0,12,1,13
José Manuel Rey,0,280.0,1,0,3,2,5
José Manuel Velázquez,1,10.0,0,0,0,1,1
José Manuel de la Torre,1,134.0,0,0,2,1,3
José Mari Bakero,0,257.0,0,0,6,1,7
José Maria da Cruz Martins,1,89.0,0,0,1,0,1
José María Carranza,0,26.0,0,0,0,1,1
José María Carrasco,0,66.0,1,0,1,0,1
José María García Lavilla,0,20.0,0,0,1,0,1
José María Giménez,3,183.0,0,0,2,1,3
José María Jiménez,2,167.0,0,0,4,1,5
José María Lavalle,1,43.0,0,0,0,1,1
José María Medina,7,263.0,0,0,0,7,7
José María Ortiz,1,75.0,0,0,0,1,1
José Mendoza,1,62.0,0,0,0,1,1
José Miguel Cubero,0,31.0,0,0,0,1,1
José Milton Melgar,0,357.0,0,1,4,1,5
José Mora,1,75.0,0,0,0,1,1
José Naranjo,0,195.0,0,0,3,0,3
José Orlando Martínez Peña,0,14.0,0,0,1,0,1
José Orlando Semedo,0,44.0,0,0,0,1,1
José Oscar Herrera,0,59.0,0,0,0,1,1
José Parodi,2,229.0,0,0,3,1,4
José Pedro Fuenzalida,3,108.0,0,0,0,3,3
José Pereda,1,110.0,0,0,0,3,3
José Perácio,3,195.0,0,0,3,0,3
José Piendibene,4,212.0,0,0,1,3,4
José Pérez,3,202.0,0,0,0,4,4
José Quintanilla,1,129.0,0,0,1,1,2
José Rafael,0,50.0,0,0,1,0,1
José Ramos Delgado,0,35.0,1,0,1,0,1
José Reinaldo de Lima,1,105.0,0,0,1,1,2
José Ricardo Taylor,0,85.0,0,0,1,0,1
José Ruvalcaba,0,41.0,0,0,1,0,1
José Sanfilippo,8,624.0,0,1,9,1,10
José Sasía,9,575.0,0,0,0,9,9
José Taboada,1,28.0,0,0,0,1,1
José Torrealba,0,152.0,0,0,2,0,2
José Touré,0,93.0,0,0,2,1,3
José Travassos,0,51.0,0,0,1,0,1
José Ufarte,1,80.0,0,0,0,1,1
José Urquia,0,18.0,0,0,1,0,1
José Urruzmendi,0,182.0,0,0,3,1,4
José Vargas,2,84.0,0,0,1,1,2
José Velásquez,3,198.0,0,0,3,2,5
José Vicente Balseca,0,25.0,0,0,1,0,1
José Vieira Dias Paulino do Carmo,0,79.0,0,0,0,1,1
José Walter Roque,1,105.0,0,0,1,1,2
José del Solar,8,599.0,3,3,5,7,12
José Águas,0,158.0,0,0,2,1,3
José Ángel Iribar,0,61.0,1,0,1,0,1
Jovan Aćimović,0,14.0,0,0,1,0,1
Jovan Kirovski,1,163.0,0,0,2,1,3
Jovan Kostovski,0,85.0,0,0,1,0,1
Jozef Adamec,1,322.0,0,0,6,1,7
Jozef Barmoš,1,66.0,1,0,1,0,1
Jozef Chovanec,0,80.0,1,0,0,2,2
Jozef Majoroš,0,195.0,0,0,3,0,3
Jozef Móder,0,161.0,0,0,1,2,3
Jozef Štibrányi,1,80.0,0,0,1,0,1
Jozy Altidore,1,1256.0,0,2,20,4,24
João Cancelo,0,134.0,0,0,1,1,2
João Carlos dos Santos,1,8.0,0,0,1,0,1
João Domingos Pinto,0,135.0,0,0,4,0,4
João Elias,0,41.0,0,0,0,1,1
João Félix,1,78.0,0,0,1,0,1
João Moutinho,0,315.0,0,0,2,2,4
João Palhinha,0,149.0,0,0,1,1,2
João Paulo,2,81.0,0,0,1,1,2
João Pedro,0,52.0,0,0,0,1,1
João Resende Alves,0,55.0,0,0,1,1,2
João Vieira Pinto,2,813.0,0,0,12,6,18
Joël Kimwaki,1,81.0,0,0,0,1,1
Joël Matip,0,26.0,0,0,0,1,1
Joël Tiéhi,10,727.0,0,1,9,5,14
Joško Gvardiol,1,87.0,0,0,1,1,2
Ju Manu Rai,0,129.0,0,0,2,0,2
Ju Yingzhi,0,42.0,0,0,1,0,1
Juan,4,183.0,0,0,4,2,6
Juan Alberto Schiaffino,4,273.0,0,0,0,5,5
Juan Alcántara,0,407.0,0,0,5,1,6
Juan Amarilla,1,5.0,0,0,0,1,1
Juan Américo Díaz,0,18.0,0,0,1,0,1
Juan Angel Romero,1,17.0,0,0,0,1,1
Juan Antonio Pizzi,0,274.0,0,0,4,0,4
Juan Antonio Señor,1,234.0,0,1,3,1,4
Juan Arango,1,840.0,0,0,8,6,14
Juan Arremón,1,43.0,0,0,0,1,1
Juan Ayala,3,206.0,0,0,1,2,3
Juan Barrera,2,195.0,0,0,2,3,5
Juan Bassa,0,83.0,0,0,1,0,1
Juan Bautista Agüero,2,241.0,0,0,4,1,5
Juan Bautista Coronel,1,20.0,1,0,1,0,1
Juan Bautista Villalba,9,500.0,0,0,3,6,9
Juan Bernat,0,88.0,0,0,0,1,1
Juan Caballero,0,106.0,0,0,1,1,2
Juan Camilo Zúñiga,0,90.0,0,0,1,0,1
Juan Carlos Arce,1,473.0,0,3,7,3,10
Juan Carlos Arguedas,0,91.0,0,0,2,1,3
Juan Carlos Arteche,0,67.0,0,0,0,1,1
Juan Carlos Carone,1,26.0,0,0,1,0,1
Juan Carlos Cubillas,0,43.0,0,0,1,0,1
Juan Carlos Espinoza,1,34.0,0,0,0,1,1
Juan Carlos García,0,40.0,0,0,1,0,1
Juan Carlos Heguy,1,10.0,0,0,0,1,1
Juan Carlos Heredia,1,12.0,0,0,1,0,1
Juan Carlos Irurieta,0,63.0,0,0,1,0,1
Juan Carlos Lallana,1,58.0,0,0,1,0,1
Juan Carlos Letelier,8,529.0,0,0,7,3,10
Juan Carlos Mariño,1,131.0,0,0,1,2,3
Juan Carlos Oblitas,0,305.0,0,0,7,1,8
Juan Carlos Orellana,0,76.0,0,0,0,1,1
Juan Carlos Padilla,0,17.0,0,0,1,0,1
Juan Carlos Paredes,0,25.0,1,0,0,1,1
Juan Carlos Pedraza,0,60.0,0,0,1,0,1
Juan Carlos Plata,6,674.0,0,0,9,5,14
Juan Carlos Portillo,0,30.0,0,0,0,1,1
Juan Carlos Rojas,2,203.0,0,1,1,3,4
Juan Carlos Salvini,0,159.0,0,0,2,0,2
Juan Carlos Sarnari,1,36.0,0,0,1,0,1
Juan Carlos Sánchez,0,74.0,0,0,0,1,1
Juan Carlos Valerón,2,218.0,0,0,2,2,4
Juan Carlos Villamayor,2,90.0,0,0,2,0,2
Juan Carreño,1,70.0,0,0,0,1,1
Juan Carreño López,0,84.0,0,0,1,0,1
Juan Castillo,1,73.0,0,0,0,1,1
Juan Cayasso,3,235.0,0,0,3,1,4
Juan Contrera,0,147.0,0,0,2,0,2
Juan Cruz Sol,0,39.0,0,0,1,0,1
Juan Cuadrado,3,228.0,0,2,0,5,5
Juan Domingo Brown,0,122.0,0,2,2,0,2
Juan Emilio Salinas,1,70.0,0,0,0,2,2
Juan Enrique García,0,151.0,0,0,3,0,3
Juan Fernando Quintero,2,109.0,0,0,2,0,2
Juan Flores Madariaga,0,143.0,0,0,3,2,5
Juan Francisco Barraza,0,170.0,0,0,2,0,2
Juan Francisco Riveros,1,62.0,0,0,0,1,1
Juan Francisco Rodríguez Herrera,0,40.0,0,0,1,0,1
Juan Fuenmayor,0,41.0,1,0,0,1,1
Juan González Soto,0,27.0,0,0,0,1,1
Juan Gutiérrez Moreno,0,34.0,0,0,0,1,1
Juan Hernández,0,90.0,0,0,1,0,1
Juan Hohberg,3,183.0,0,0,0,3,3
Juan Ignacio Basaguren,0,83.0,0,0,1,0,1
Juan Jairo Galeano,0,27.0,0,0,0,1,1
Juan José Jayo,0,38.0,0,0,0,1,1
Juan José Muñante,0,70.0,0,0,0,1,1
Juan José Pizzuti,1,177.0,0,0,4,0,4
Juan Joya,2,108.0,0,0,2,0,2
Juan Loyarte,1,78.0,0,0,1,0,1
Juan Maglio,0,47.0,0,0,0,2,2
Juan Manuel Asensi,1,266.0,0,0,4,1,5
Juan Manuel Funes,2,109.0,0,0,3,0,3
Juan Manuel Vargas,1,235.0,0,0,2,1,3
Juan Marvezzi,5,146.0,0,0,5,0,5
Juan Mata,3,621.0,0,1,4,5,9
Juan Mujica,1,50.0,0,0,0,1,1
Juan Pablo Rodríguez,0,83.0,0,0,1,0,1
Juan Pablo Sorín,2,445.0,0,0,2,5,7
Juan Pablo Vargas,1,121.0,0,0,2,0,2
Juan Pablo Ángel,0,465.0,0,2,6,2,8
Juan Pajuelo,1,207.0,0,0,1,2,3
Juan Pedro Riephoff,1,96.0,0,0,0,2,2
Juan Píriz,2,196.0,0,0,0,3,3
Juan Ramón Epitié,0,57.0,0,0,1,0,1
Juan Ramón Martínez,3,356.0,0,0,4,3,7
Juan Reynoso Guzmán,2,213.0,0,0,3,1,4
Juan Riephoff,1,25.0,0,0,0,1,1
Juan Rodrigo Rojas,1,77.0,1,0,0,1,1
Juan Román Riquelme,7,719.0,0,4,12,3,15
Juan Sebastián Verón,0,252.0,0,1,3,3,6
Juan Seminario,2,217.0,0,0,1,2,3
Juan Soto Mura,2,68.0,0,0,0,2,2
Juan Soto Quiros,0,32.0,0,0,1,0,1
Juan Ulloa,0,280.0,0,0,4,2,6
Juanito,1,70.0,0,1,1,2,3
Juanpi,0,34.0,0,0,1,0,1
Juary Soares,0,90.0,0,0,0,1,1
Judd Molea,0,41.0,0,0,0,1,1
Jude Bellingham,1,35.0,0,0,1,0,1
Judelin Aveska,0,60.0,0,0,1,0,1
Judikael Ixoée,1,25.0,0,1,1,0,1
Juhani Peltonen,0,252.0,0,1,3,3,6
Jukka Ikäläinen,0,47.0,1,0,1,0,1
Julen Guerrero,0,417.0,0,0,5,5,10
Jules Alberto,0,83.0,0,0,2,0,2
Jules Bocandé,1,187.0,0,0,2,1,3
Jules Kadeba,0,73.0,0,0,1,0,1
Jules Lagadeau,0,180.0,0,0,2,0,2
Juli Fernandez,1,84.0,0,0,0,1,1
Juli Sánchez,0,73.0,0,0,0,1,1
Julian Brandt,0,162.0,0,0,2,0,2
Julian Draxler,2,148.0,0,1,4,1,5
Julian Green,1,107.0,0,0,0,1,1
Julian Johnsson,0,87.0,0,0,1,1,2
Julian Wade,2,99.0,0,0,1,1,2
Julian de Guzman,2,177.0,0,0,1,2,3
Juliano Belletti,2,146.0,1,0,1,1,2
Julien Cools,1,130.0,0,0,2,0,2
Julien Escudé,0,55.0,1,0,0,1,1
Julien Nsengiyumva,0,75.0,0,0,1,0,1
Julinho,1,69.0,0,0,1,0,1
Julio Abbadie,5,250.0,0,0,0,5,5
Julio Asad,0,11.0,0,0,0,1,1
Julio Crisosto,0,78.0,0,0,2,0,2
Julio César Baldivieso,0,529.0,0,3,8,3,11
Julio César Britos,3,182.0,0,0,0,3,3
Julio César Cortés,1,75.0,0,0,1,1,2
Julio César Cáceres,0,54.0,0,0,1,0,1
Julio César Enciso,0,62.0,0,0,0,1,1
Julio César Romero,1,563.0,0,0,6,4,10
Julio César Uribe,0,197.0,0,1,1,2,3
Julio César de Andrade Moura,0,75.0,0,0,1,1,2
Julio César de León,1,457.0,0,1,4,4,8
Julio Dely Valdés,0,582.0,0,1,6,5,11
Julio Enrique Martínez,0,100.0,0,0,1,1,2
Julio Francia,4,219.0,0,1,4,0,4
Julio Gallardo,2,55.0,0,0,2,1,3
Julio Libonatti,1,158.0,0,0,4,0,4
Julio Meléndez,0,10.0,1,0,0,1,1
Julio Montero Castillo,0,44.0,0,0,1,0,1
Julio Morales,0,168.0,0,1,2,0,2
Julio Palacios Lozano,0,22.0,0,0,1,0,1
Julio Pérez,2,137.0,0,0,0,2,2
Julio Ramírez,1,5.0,0,0,0,1,1
Julio Rodas,2,93.0,0,0,2,0,2
Julio Salinas,3,471.0,0,0,4,10,14
Julio Valentín González,1,29.0,0,0,0,1,1
Julio dos Santos,1,85.0,0,1,0,1,1
Julius Aghahowa,4,639.0,0,0,5,5,10
Julius James,0,26.0,1,0,1,0,1
Julius Owino,0,8.0,0,0,1,0,1
Julián Álvarez,4,256.0,0,0,3,2,5
Juma Darwish Al-Mashri,0,87.0,0,0,1,0,1
Juma Marzouq,1,44.0,0,0,0,1,1
Juma Mkambi,0,54.0,0,0,0,1,1
Jumah Salem Joher,0,32.0,0,0,1,0,1
Junaedi Abdillah,1,70.0,0,0,0,1,1
Jung Jae-Kwon,0,76.0,0,0,1,0,1
Jung Woo-young,0,82.0,0,0,0,1,1
Jung Yong-Hwan,0,30.0,0,0,0,1,1
Junichi Inamoto,0,118.0,0,0,2,0,2
Juninho Bacuna,0,36.0,0,0,2,0,2
Juninho Paulista,0,28.0,0,0,0,1,1
Juninho Pernambucano,2,159.0,0,0,1,2,3
Junior Agogo,2,387.0,0,0,5,2,7
Junior Bukaudi,1,49.0,0,0,1,0,1
Junior Flemmings,1,87.0,0,0,0,1,1
Junior Hoilett,7,463.0,0,2,4,4,8
Junior Kabananga,3,112.0,0,0,1,2,3
Junior Michael,1,198.0,0,1,2,1,3
Junior Pukoku,1,13.0,0,0,1,0,1
Junya Ito,0,361.0,0,0,4,2,6
Juozas Gudelis,0,79.0,0,0,0,1,1
Jupp Heynckes,0,224.0,0,0,4,0,4
Juraj Kucka,0,225.0,1,0,4,3,7
Juraj Piroska,0,54.0,0,0,0,1,1
Juraj Szikora,0,15.0,0,0,0,1,1
Jurgen Cavens,0,83.0,0,0,0,1,1
Jurgen Degabriele,0,90.0,0,0,0,1,1
Jurgen Kohler,0,55.0,1,0,0,1,1
Jurica Jerković,0,47.0,0,0,1,1,2
Jurijs Ševļakovs,0,119.0,0,0,2,0,2
Jurijs Žigajevs,0,44.0,0,0,1,0,1
Juris Laizāns,0,500.0,0,1,4,5,9
Juriën Gaari,1,90.0,0,0,0,1,1
Just Fontaine,13,980.0,0,0,20,1,21
Justas Lasickas,0,18.0,0,0,1,0,1
Justin Cochrane,0,47.0,0,0,0,1,1
Justin Donawa,0,127.0,0,0,0,2,2
Justin Manao,1,116.0,0,0,1,1,2
Justin Meram,1,158.0,0,1,1,2,3
Justo Jacquet,0,34.0,0,0,1,0,1
Justo Ruiz,0,129.0,0,2,2,0,2
Juvenal Edjogo-Owono,0,276.0,0,3,4,2,6
Juvenal Olmos,2,53.0,0,0,1,1,2
Juvencio Osorio,0,61.0,0,0,2,0,2
Jyn Tson,0,90.0,0,0,1,0,1
Jyrki Nieminen,0,128.0,0,0,1,1,2
Jádson,1,38.0,0,0,1,0,1
Jákup Thomsen,0,90.0,0,0,0,1,1
Ján Greguš,0,41.0,0,0,0,1,1
Ján Kapko,0,65.0,1,0,1,0,1
Ján Kozák,0,421.0,0,0,3,4,7
Ján Čapkovič,0,223.0,0,0,0,4,4
Ján Ďurica,0,354.0,3,1,3,3,6
Ján Švehlík,1,8.0,0,0,1,0,1
János Farkas,1,381.0,0,0,8,2,10
János Göröcs,0,240.0,0,0,3,1,4
János Hrutka,0,82.0,0,0,1,0,1
János Mátyus,0,83.0,0,0,1,1,2
Jérémie Boga,1,90.0,0,0,0,1,1
Jérémy Doku,0,42.0,0,0,1,0,1
Jérémy Ménez,0,53.0,0,0,0,1,1
Jérôme Boateng,1,8.0,0,0,1,0,1
Jérôme Doté,0,80.0,0,0,1,0,1
Jérôme Lèbre Mamahou,0,115.0,0,0,3,0,3
Jérôme Rothen,0,66.0,0,0,0,1,1
Jóan Símun Edmundsson,0,195.0,0,0,1,3,4
Jóhann Berg Guðmundsson,0,283.0,0,0,2,4,6
Jóhannes Eðvaldsson,0,12.0,0,0,1,0,1
Jón Dagur Þorsteinsson,0,54.0,0,0,0,1,1
Jón Daði Böðvarsson,1,175.0,1,0,4,0,4
Jón Rói Jacobsen,0,30.0,1,0,1,0,1
Józef Wandzik,0,53.0,1,0,1,0,1
József Bencsics,1,69.0,0,0,1,0,1
József Bozsik,1,57.0,0,0,2,0,2
József Horváth,0,18.0,0,0,0,1,1
József Kardos,0,89.0,0,0,1,1,2
József Kiprich,0,479.0,0,2,5,6,11
József Nemes,0,126.0,0,0,3,0,3
József Pecsovszky,0,50.0,0,0,2,0,2
József Póczik,0,158.0,0,0,0,3,3
József Sebők,0,17.0,0,0,1,0,1
József Solti,0,133.0,0,0,2,0,2
József Szalma,0,15.0,0,0,0,1,1
József Tóth,2,125.0,0,0,1,1,2
József Varga,1,27.0,0,0,0,1,1
Jô,0,180.0,0,0,2,0,2
Jörgen Pettersson,0,53.0,0,0,1,0,1
Jørgen Kristensen,0,75.0,0,0,1,0,1
Jørn Andersen,0,90.0,0,0,1,1,2
Júlio Baptista,3,180.0,0,0,2,3,5
Júlio Botelho,6,343.0,0,0,4,4,8
Júlio Tavares,2,132.0,0,0,1,2,3
Július Šimon,0,154.0,0,1,3,0,3
Júnior Alonso,1,119.0,0,0,1,1,2
Júnior Baiano,1,66.0,0,0,1,0,1
Júnior Díaz,0,16.0,0,0,1,0,1
Júnior Izaguirre,1,42.0,0,0,0,1,1
Júnior Moraes,0,80.0,0,0,1,0,1
Jürgen Damm,0,72.0,0,0,0,1,1
Jürgen Grabowski,0,191.0,0,0,2,1,3
Jürgen Heun,0,71.0,0,0,1,0,1
Jürgen Klinsmann,15,1357.0,0,2,19,11,30
Jürgen Nöldner,0,126.0,0,0,2,1,3
Jürgen Pommerenke,0,48.0,0,0,0,1,1
Jürgen Sparwasser,0,454.0,0,0,4,3,7
Jānis Ikaunieks,0,40.0,0,0,1,0,1
K. Appalaraju,1,2.0,0,0,1,0,1
Kaan Ayhan,0,182.0,0,0,2,1,3
Kaba Diawara,2,348.0,0,0,5,2,7
Kabamba Musasa,0,86.0,0,0,1,0,1
Kabasu Babo,1,51.0,0,0,0,1,1
Kabeu,1,22.0,0,0,1,0,1
Kadell Daniel,1,54.0,0,0,1,0,1
Kader Mangane,0,67.0,0,0,1,0,1
Kadhim Waal,1,84.0,0,0,1,0,1
Kagiso Dikgacoi,0,99.0,0,0,2,0,2
Kahraba,1,88.0,0,0,1,0,1
Kai Haaskivi,0,143.0,0,0,0,2,2
Kai Havertz,2,347.0,0,0,3,4,7
Kai Pahlman,0,80.0,0,1,1,1,2
Kai Sjøberg,0,66.0,0,0,1,0,1
Kaies Ghodhbane,1,236.0,0,0,1,3,4
Kaimar Saag,0,180.0,0,0,2,0,2
Kairat Ashirbekov,0,47.0,0,0,1,0,1
Kairat Nurdauletov,0,172.0,0,2,2,1,3
Kais Yâakoubi,0,82.0,0,0,1,0,1
Kaiser Hamid,1,148.0,0,1,2,0,2
Kaitano Tembo,0,47.0,0,0,1,0,1
Kaj Poulsen,0,4.0,0,0,0,1,1
Kakha Gogoladze,3,177.0,0,0,1,3,4
Kakha Kaladze,0,122.0,2,0,0,2,2
Kakhaber Tskhadadze,0,68.0,0,0,1,0,1
Kakhi Asatiani,1,120.0,0,0,0,3,3
Kakoko Etepé,2,309.0,0,0,3,4,7
Kaká,6,829.0,0,2,8,9,17
Kalaje Gnipate,1,44.0,0,0,1,0,1
Kalen Damessi,0,8.0,0,0,1,0,1
Kalevi Lehtovirta,0,187.0,0,0,3,0,3
Kalidou Koulibaly,1,70.0,0,0,0,1,1
Kalifa Coulibaly,1,106.0,0,0,1,1,2
Kalin Bankov,0,76.0,0,0,1,0,1
Kaliova Bulinaceva,0,15.0,0,0,0,1,1
Kalu Uche,2,28.0,0,0,1,1,2
Kalusha Bwalya,10,1104.0,0,2,11,8,19
Kama Dumbuya,0,105.0,0,0,2,0,2
Kamal Abdel Wahab,1,37.0,0,0,0,1,1
Kamal Kamyabinia,0,32.0,0,0,0,1,1
Kamel Gabsi,1,60.0,0,0,0,1,1
Kamel Seddik,0,42.0,1,0,1,0,1
Kameli Kilalwaca,1,54.0,0,0,1,0,1
Kamil Al Aswad,0,166.0,0,0,3,1,4
Kamil Glik,0,328.0,1,0,3,2,5
Kamil Grosicki,2,170.0,0,0,4,4,8
Kamil Jóźwiak,0,72.0,0,0,0,2,2
Kamil Kopúnek,1,89.0,0,0,1,0,1
Kamil Kosowski,0,88.0,0,0,3,0,3
Kamil Zayatte,0,166.0,0,0,1,1,2
Kamilou Daouda,0,157.0,0,0,2,0,2
Kamo Hovhannisyan,0,44.0,1,0,0,2,2
Kamunda Tshinabu,0,88.0,0,1,1,0,1
Kamuran Yavuz,0,15.0,0,0,0,1,1
Kanat Sardarov,1,76.0,0,0,1,0,1
Kandia Traoré,1,168.0,0,0,0,2,2
Kane Crichlow,3,179.0,0,0,2,1,3
Kang Chul,0,51.0,0,0,1,0,1
Kanga Akalé,0,86.0,0,0,0,2,2
Kanika Matondo,0,90.0,0,0,0,1,1
Kanku Mulekelayi,0,79.0,0,0,0,1,1
Kanlaya Sysomvang,0,112.0,0,1,1,0,1
Kaoru Mitoma,0,179.0,0,0,0,2,2
Kara Mbodji,2,180.0,0,0,1,2,3
Karapet Mikaelyan,0,91.0,0,0,2,0,2
Karel Geraerts,0,109.0,0,0,1,2,3
Karel Jarolím,0,35.0,0,0,1,0,1
Karel Kula,0,67.0,0,0,1,0,1
Karel Poborský,2,271.0,0,2,5,1,6
Karen Dokhoyan,0,60.0,0,0,1,0,1
Kari Ukkonen,0,59.0,0,0,1,1,2
Karim Abdul Razak,0,112.0,0,0,2,0,2
Karim Adeyemi,0,90.0,0,0,1,0,1
Karim Ansarifard,4,888.0,0,2,10,4,14
Karim Bagheri,12,1594.0,0,1,15,17,32
Karim Bavi,0,62.0,0,0,0,3,3
Karim Bellarabi,1,57.0,0,0,0,1,1
Karim Benzema,7,1035.0,0,2,11,8,19
Karim Boudiaf,0,134.0,0,0,1,2,3
Karim Haggui,1,163.0,0,0,2,1,3
Karim Kamanzi,1,90.0,0,0,1,0,1
Karim Maroc,1,73.0,0,0,1,0,1
Karim Matmour,1,99.0,0,0,1,1,2
Karim Mohammed Allawi,1,76.0,0,0,1,0,1
Karim Saddam,1,88.0,0,0,1,0,1
Karim Ziani,0,154.0,0,2,3,0,3
Karl Brauneder,0,81.0,0,0,1,0,1
Karl Hohmann,2,258.0,0,0,2,3,5
Karl Kodat,0,11.0,0,0,0,1,1
Karl Koller,1,62.0,0,0,2,0,2
Karl Namnganda,0,90.0,0,0,0,1,1
Karl Odermatt,0,324.0,0,0,3,3,6
Karl Sesta,1,54.0,0,0,1,0,1
Karl Skerlan,0,60.0,0,0,1,0,1
Karl Stotz,0,89.0,0,1,1,0,1
Karl Toko Ekambi,0,416.0,0,0,7,1,8
Karl Zischek,1,110.0,0,0,2,0,2
Karl-Erik Palmér,3,223.0,0,0,1,5,6
Karl-Heinz Riedle,2,447.0,0,0,3,5,8
Karl-Heinz Rummenigge,10,1719.0,0,3,25,7,32
Karl-Heinz Schnellinger,1,90.0,0,0,1,0,1
Karlen Mkrtchyan,0,30.0,0,0,0,1,1
Karlheinz Förster,0,126.0,0,0,1,1,2
Karol Dobiaš,1,25.0,0,0,1,0,1
Karol Jokl,1,329.0,0,0,3,3,6
Karol Kisel,0,54.0,0,0,0,1,1
Karol Linetty,1,179.0,0,0,2,1,3
Karol Świderski,0,252.0,0,0,3,2,5
Karrar Jassim,3,113.0,0,0,3,0,3
Kaspars Gorkšs,0,249.0,0,0,0,5,5
Kasper Dolberg,3,341.0,0,1,4,4,8
Kasper Hämäläinen,0,232.0,0,0,5,0,5
Kasper Lorentzen,0,81.0,0,0,1,0,1
Kassahun Teka,0,79.0,0,1,0,1,1
Kassaly Daouda,0,53.0,1,0,1,0,1
Kassim M'Dahoma,0,10.0,1,0,1,0,1
Kassoum Ouédraogo,0,154.0,0,2,3,0,3
Kastriot Dermaku,0,32.0,0,0,1,0,1
Kasun Jayasuriya,2,113.0,0,0,3,0,3
Katlego Mashego,1,90.0,0,0,0,1,1
Katlego Mphela,1,364.0,0,0,4,1,5
Katsuyoshi Shinto,0,19.0,0,0,1,0,1
Kaveh Rezaei,2,167.0,0,0,0,2,2
Kazi Salahuddin,1,60.0,0,1,0,1,1
Kazimierz Deyna,4,631.0,0,2,9,5,14
Kazushi Kimura,2,291.0,0,0,4,3,7
Kazuyoshi Miura,10,1519.0,0,1,23,7,30
Kebede Asfaw,0,65.0,0,0,0,1,1
Kebede Metaferia,0,31.0,0,0,0,1,1
Kees Kist,2,229.0,0,1,3,1,4
Kees Rijvers,0,54.0,0,0,1,0,1
Kees van Kooten,2,151.0,0,0,1,3,4
Kei Kamara,0,93.0,0,0,2,0,2
Keidi Bare,0,34.0,0,0,0,1,1
Keiji Tamada,3,372.0,0,0,3,4,7
Keijo Kousa,0,169.0,0,0,2,0,2
Keiran Murtagh,0,90.0,0,0,1,0,1
Keisuke Honda,11,920.0,0,7,12,9,21
Keita Baldé,1,135.0,0,0,3,0,3
Keita Karamokoba,0,71.0,0,0,0,1,1
Keita Suzuki,0,8.0,1,0,1,0,1
Keith Andrews,0,13.0,0,0,0,1,1
Keith Fahey,0,76.0,0,0,0,1,1
Keith Fletcher,0,201.0,0,0,3,0,3
Keith Gillespie,0,140.0,1,0,2,1,3
Keith Gumbs,0,370.0,0,2,5,2,7
Keith Mackay,0,48.0,0,0,1,0,1
Keith Nelson,0,192.0,0,0,6,1,7
Keith O'Neill,0,9.0,0,0,0,1,1
Keith Rowland,0,36.0,0,0,1,0,1
Keithroy Cornelius,0,51.0,0,0,0,1,1
Keithroy Freeman,0,135.0,0,1,2,2,4
Kelechi Emeteole,0,63.0,0,0,1,0,1
Kelechi Iheanacho,1,215.0,0,0,4,1,5
Kelly Peters,0,85.0,0,0,0,1,1
Kelvin Mutale,0,92.0,0,0,2,2,4
Kelvin Sebwe,2,232.0,0,1,3,3,6
Kelvyn Peters,0,6.0,0,0,1,0,1
Kelyn Rowe,0,56.0,0,0,1,0,1
Kema Jack,1,85.0,0,0,1,0,1
Kemar Lawrence,1,88.0,0,0,0,1,1
Kemar Roofe,0,38.0,0,0,0,1,1
Kembo Uba Kembo,0,253.0,0,0,6,0,6
Ken Boden,0,31.0,0,0,0,1,1
Ken Naganuma,0,16.0,0,0,1,0,1
Kenan Karaman,0,85.0,0,0,1,1,2
Kenan Kodro,1,65.0,0,0,0,1,1
Kenan Simambe,0,84.0,0,0,1,0,1
Kendall Velox,0,285.0,0,0,0,5,5
Kendall Waston,1,214.0,0,0,1,2,3
Kengo Nakamura,0,230.0,0,0,1,2,3
Kenji Gorré,2,147.0,0,0,0,2,2
Kenlyn Gonsalves,0,88.0,0,0,1,1,2
Kennedy Chihuri,0,16.0,0,0,1,0,1
Kennedy Mweene,1,85.0,0,1,1,0,1
Kennedy Phillip,0,39.0,0,0,1,0,1
Kennedy Simiyu,0,30.0,0,0,1,1,2
Kennet Andersson,5,852.0,0,2,7,9,16
Kenneth Brylle Larsen,1,60.0,0,0,1,0,1
Kenneth Hughes,0,69.0,0,1,1,0,1
Kenneth Kluivert,0,31.0,0,0,1,0,1
Kenneth Malitoli,4,263.0,0,0,3,2,5
Kenneth Olayombo,0,81.0,0,0,2,0,2
Kenneth Omeruo,1,73.0,0,0,1,0,1
Kenneth Thompson,0,21.0,0,0,0,1,1
Kenny Cooper,0,250.0,0,1,3,0,3
Kenny Dalglish,3,582.0,0,0,8,6,14
Kenny McLean,0,4.0,0,0,0,1,1
Kenny Miller,0,389.0,0,1,8,3,11
Kenny Rocha Santos,0,76.0,1,0,0,1,1
Kenny Sansom,0,88.0,0,0,1,0,1
Kenroy Skinner,0,33.0,0,0,0,1,1
Kensuke Nagai,0,40.0,0,0,1,0,1
Kent Nielsen,0,59.0,0,0,2,0,2
Kenta Hasegawa,0,24.0,0,0,1,0,1
Kento Hashimoto,0,51.0,0,0,1,0,1
Kentoine Jennings,0,130.0,0,0,1,1,2
Kenwin McPhee,1,73.0,0,0,2,0,2
Kenwyne Jones,5,723.0,1,1,6,5,11
Kenzo Huur,2,167.0,0,0,0,2,2
Keo Sokpheng,0,33.0,0,0,1,0,1
Keon Daniel,1,289.0,0,0,2,4,6
Kerbi Rodríguez,0,64.0,0,0,1,0,1
Kerem Aktürkoğlu,0,39.0,0,0,2,1,3
Kerem Demirbay,1,48.0,0,0,1,0,1
Kermit Erasmus,0,28.0,0,0,1,0,1
Keron Cummings,2,122.0,0,0,2,0,2
Kerry Baptiste,0,170.0,0,1,2,1,3
Kerry Jamerson,0,72.0,0,0,1,0,1
Kerry Skepple,0,103.0,0,0,3,0,3
Kervens Belfort,0,308.0,0,1,3,2,5
Kervin Severino,0,99.0,0,1,2,0,2
Keung He-chi,1,78.0,0,0,1,0,1
Kevin Archer,0,48.0,0,0,0,1,1
Kevin Davies,0,109.0,0,0,1,1,2
Kevin De Bruyne,2,877.0,0,1,11,7,18
Kevin Doyle,1,310.0,0,0,3,6,9
Kevin Edward,0,20.0,0,0,0,1,1
Kevin Gallacher,0,379.0,0,0,5,4,9
Kevin Gameiro,0,82.0,0,0,2,0,2
Kevin Holness,2,90.0,0,0,2,0,2
Kevin Kampl,0,68.0,0,0,2,0,2
Kevin Keegan,0,385.0,0,1,6,7,13
Kevin Kilbane,1,368.0,1,0,3,4,7
Kevin Kurányi,0,274.0,0,0,4,2,6
Kevin Lafrance,0,105.0,0,0,0,2,2
Kevin López,0,65.0,0,0,0,1,1
Kevin McKenna,3,224.0,0,0,2,2,4
Kevin Mirallas,0,233.0,0,0,1,3,4
Kevin Molino,2,367.0,0,0,3,3,6
Kevin Moran,0,138.0,0,0,2,0,2
Kevin Muscat,4,372.0,0,4,8,1,9
Kevin Nemia,1,28.0,0,0,1,0,1
Kevin O'Callaghan,0,35.0,0,0,1,0,1
Kevin O'Flanagan,1,62.0,0,0,1,0,1
Kevin Sheedy,1,234.0,0,0,3,1,4
Kevin Strootman,0,54.0,0,0,1,1,2
Kevin Vandenbergh,0,100.0,0,0,2,0,2
Kevin Volland,0,85.0,0,0,0,1,1
Kevin Weymouth,0,74.0,0,0,1,0,1
Kevin Wilson,1,63.0,0,0,2,2,4
Kevin Wimmer,0,45.0,1,0,0,1,1
Kevin-Prince Boateng,1,93.0,0,0,0,2,2
Kewullay Conteh,0,45.0,0,0,2,0,2
Keysher Fuller,1,82.0,0,0,0,2,2
Khader Yousef,0,63.0,0,0,0,1,1
Khaibar Amani,2,129.0,0,0,2,0,2
Khairul Amri,0,157.0,0,0,2,1,3
Khalaf Al-Mutairi,1,142.0,0,0,1,1,2
Khalaf Al-Salamah,0,75.0,0,0,1,0,1
Khaled Adénon,0,2.0,0,0,1,0,1
Khaled Al Zaher,2,343.0,0,0,3,2,5
Khaled Al-Doseri,0,43.0,0,0,2,0,2
Khaled Awad,0,156.0,0,0,1,1,2
Khaled Badra,1,289.0,0,2,3,3,6
Khaled Elfallah,0,105.0,0,0,2,0,2
Khaled Hamieh,0,88.0,0,0,0,1,1
Khaled Korbi,1,34.0,0,0,0,1,1
Khaled Lounici,1,2.0,0,0,0,1,1
Khaled Massad,5,742.0,0,3,9,5,14
Khaled Mhemed,0,81.0,0,0,1,0,1
Khaled Mobayed,0,30.0,0,0,0,1,1
Khaled Mouelhi,1,30.0,0,1,0,1,1
Khaled Saad,1,90.0,0,0,1,0,1
Khaleel Mubarak,2,107.0,0,0,1,1,2
Khaleem Hyland,1,231.0,0,0,2,1,3
Khalfan Ibrahim,3,410.0,0,2,5,4,9
Khalfan Mubarak,0,41.0,0,0,1,0,1
Khalfan Ngassa,0,74.0,0,0,1,0,1
Khalid Ahmed Elmustafa,0,81.0,0,0,2,0,2
Khalid Al-Hajri,2,205.0,0,0,0,3,3
Khalid Al-Temawi,3,66.0,0,2,2,1,3
Khalid Bakhit,0,84.0,0,0,1,1,2
Khalid Boutaïb,1,206.0,0,0,4,1,5
Khalid Ismaïl,2,127.0,0,0,1,3,4
Khalid Labied,3,212.0,0,0,1,3,4
Khalid Mohammed Sabbar,1,69.0,0,0,0,1,1
Khalid Raghib,0,172.0,0,0,3,0,3
Khalid Salman,2,286.0,0,2,3,1,4
Khalifa Al-Sulaiti,1,20.0,0,0,0,1,1
Khalifa Ayil,0,78.0,0,0,2,0,2
Khalifa Khalifa,0,11.0,0,0,1,0,1
Khalil Al-Malki,5,368.0,0,0,2,5,7
Khalil Allawi,2,122.0,0,0,2,0,2
Khalil Bani Attiah,0,45.0,0,0,1,0,1
Khalil Ibrahim,0,40.0,0,0,1,0,1
Khalilou Fadiga,1,125.0,0,1,2,2,4
Khama Billiat,1,130.0,0,0,1,1,2
Khamees Saad Mubarak,3,548.0,0,0,6,2,8
Khamis Al-Zahrani,0,46.0,0,0,1,0,1
Khamis Eid,1,40.0,0,0,1,0,1
Khamis Eid Rafe Thani,3,107.0,0,0,2,1,3
Khamis Esmaeel,0,14.0,0,0,1,0,1
Khamis Mubarak,2,73.0,0,0,0,2,2
Khampheng Sayavutthi,1,200.0,0,1,3,1,4
Khan Thatat Songwuti,1,72.0,0,0,0,1,1
Khandoker Wasim Iqbal,0,10.0,0,0,1,0,1
Khano Smith,0,317.0,0,2,3,3,6
Khash-Erdene Tuya,0,39.0,1,0,1,0,1
Khemais Labidi,0,109.0,0,0,2,0,2
Khishigdalai Battulga,0,75.0,1,0,1,0,1
Khodadad Azizi,5,501.0,0,0,4,6,10
Khoren Bayramyan,0,74.0,0,0,1,0,1
Khoren Oganesian,3,145.0,0,0,2,1,3
Khoun Laboravy,0,193.0,1,0,2,1,3
Khuda Muyaba,1,20.0,0,0,0,1,1
Khvicha Kvaratskhelia,0,260.0,0,0,3,1,4
Khürelbaataryn Tsend-Ayuush,0,48.0,0,0,1,0,1
Ki Sung-yueng,2,251.0,1,2,2,6,8
Kiatisuk Senamuang,5,795.0,0,0,11,4,15
Kick Smit,1,244.0,0,0,4,1,5
Kidumu Mantantu,1,154.0,0,0,1,2,3
Kieffer Moore,0,153.0,0,0,2,3,5
Kieran Trippier,1,5.0,0,0,0,1,1
Kiki Antenen,0,59.0,0,0,1,0,1
Kiko,1,145.0,0,0,2,1,3
Kily González,4,99.0,0,3,5,1,6
Kily Álvarez,0,90.0,0,0,1,0,1
Kim Bo-Kyung,0,78.0,0,0,2,0,2
Kim Bok-man,1,20.0,0,0,1,0,1
Kim Chi-Woo,0,176.0,0,0,1,1,2
Kim Chol-Ho,0,43.0,0,0,0,1,1
Kim Christofte,1,2.0,0,1,0,1,1
Kim Do-heon,1,321.0,0,1,2,4,6
Kim Do-hoon,4,244.0,1,0,3,4,7
Kim Gwan-Mo,1,90.0,0,0,0,1,1
Kim Gwang-Un,1,90.0,0,0,0,1,1
Kim Ho-Kon,0,22.0,0,0,1,0,1
Kim Jae-han,0,269.0,0,0,5,0,5
Kim Jaggy,0,11.0,0,0,0,1,1
Kim Ji-sung,0,45.0,0,0,0,1,1
Kim Jin-su,2,158.0,0,0,1,1,2
Kim Jong-Boo,1,70.0,0,0,1,0,1
Kim Jong-Min,1,53.0,0,0,1,0,1
Kim Jong-man,1,88.0,0,0,1,0,1
Kim Joo-sung,2,264.0,0,0,2,3,5
Kim Jung-woo,0,116.0,0,0,1,1,2
Kim Ki-bok,0,8.0,0,0,1,0,1
Kim Kuk-jin,0,10.0,0,0,1,0,1
Kim Kwang-min,2,164.0,0,1,1,3,4
Kim Kyong-il,2,131.0,0,0,2,0,2
Kim Källström,0,426.0,0,1,7,3,10
Kim Meng Leong,1,50.0,0,0,1,0,1
Kim Min-jae,2,92.0,0,0,1,1,2
Kim Nam-il,1,68.0,0,0,1,0,1
Kim Pan-Keun,1,40.0,0,0,0,1,1
Kim Pung-Il,1,139.0,0,0,3,0,3
Kim Sang-sik,1,90.0,0,0,0,1,1
Kim Seung-il,2,93.0,0,0,0,2,2
Kim Shin-wook,0,285.0,0,1,6,1,7
Kim Suk-won,0,36.0,0,0,1,0,1
Kim Suominen,0,58.0,0,0,0,2,2
Kim Tae-Young,0,107.0,0,0,2,0,2
Kim Vilfort,2,615.0,0,0,8,3,11
Kim Yong-Nam,3,257.0,0,0,3,0,3
Kim Yong-Se,1,163.0,0,0,2,2,4
Kim Yong-su,0,113.0,0,0,0,2,2
Kim Young-gwon,3,285.0,0,0,5,0,5
Kin Seng Chan,0,113.0,0,0,1,1,2
Kingsley Black,0,42.0,0,0,1,0,1
Kingsley Coman,0,94.0,0,0,3,0,3
Kinitoni Falatau,1,90.0,0,0,1,0,1
Kiril Despodov,0,110.0,0,0,1,1,2
Kiril Milanov,0,71.0,0,0,1,0,1
Kirk Broadfoot,0,18.0,0,0,0,1,1
Kit Leong Cheong,1,28.0,0,0,0,1,1
Kit Symons,0,163.0,0,0,2,0,2
Kiyika Tokodi,0,112.0,0,2,2,0,2
Kjell Kristiansen,0,78.0,0,0,1,0,1
Kjetil Hasund,0,145.0,0,0,0,2,2
Kjetil Osvold,0,106.0,0,0,1,1,2
Kjetil Rekdal,2,966.0,0,6,11,4,15
Klaas Nuninga,0,5.0,0,0,1,0,1
Klaas-Jan Huntelaar,3,1345.0,0,2,19,7,26
Klas Ingesson,0,242.0,0,1,1,3,4
Klaus Allofs,5,581.0,0,0,6,4,10
Klaus Berggreen,1,236.0,0,0,1,3,4
Klaus Fichtel,0,37.0,0,0,1,0,1
Klaus Fischer,1,711.0,0,0,11,4,15
Klaus Toppmöller,0,43.0,0,0,1,0,1
Klaus-Dieter Sieloff,0,51.0,0,0,2,0,2
Kleanthis Vikelidis,2,133.0,0,1,1,2,3
Klemen Lavrič,0,147.0,0,1,1,4,5
Klemi Saban,0,45.0,0,0,0,1,1
Klodian Duro,0,142.0,0,0,2,1,3
Klæmint Olsen,0,259.0,0,0,2,2,4
Knory Scott,1,64.0,0,0,1,0,1
Knowledge Musona,2,212.0,0,1,3,2,5
Knut Dahlen,0,15.0,0,0,1,0,1
Knut Hansson,0,120.0,0,0,0,2,2
Knut Kroon,1,86.0,0,0,1,1,2
Ko Itakura,0,90.0,0,0,1,0,1
Ko Jae-wook,0,27.0,0,0,1,0,1
Ko Jeong-woon,3,242.0,0,0,2,2,4
Ko Po Keung,0,118.0,0,0,2,0,2
Kobenan Kouman,3,322.0,0,0,6,1,7
Kodjo Fo-Doh Laba,1,103.0,0,0,1,1,2
Koen Daerden,0,150.0,0,0,3,0,3
Koffi Kossi,0,69.0,0,0,2,0,2
Koh Traoré,1,81.0,0,0,1,0,1
Koichi Hashiratani,0,47.0,0,0,0,1,1
Koji Miyoshi,2,84.0,0,0,0,2,2
Koji Mori,1,19.0,0,0,0,1,1
Koji Nakata,1,113.0,0,0,0,2,2
Koji Sasaki,0,26.0,0,0,0,1,1
Kokos Antoniou,0,88.0,0,0,1,0,1
Kokouni Akpalo Gnavor,0,85.0,0,0,0,1,1
Kolbeinn Sigþórsson,1,566.0,0,0,8,5,13
Kole Hall,1,65.0,0,0,1,0,1
Kolo Touré,0,60.0,0,0,0,1,1
Komlan Amewou,0,47.0,1,0,1,1,2
Komlan Assignon,1,52.0,0,1,1,1,2
Komron Tursunov,1,34.0,0,0,1,0,1
Konan Yoboué,1,35.0,0,0,1,0,1
Konrad Laimer,0,106.0,0,0,1,1,2
Konstantin Gorovenka,1,238.0,0,0,3,0,3
Konstantin Vassiljev,0,784.0,0,2,7,7,14
Konstantin Zyryanov,1,213.0,0,0,1,3,4
Konstantinos Galanopoulos,0,70.0,0,0,1,0,1
Konstantinos Laifis,0,85.0,0,0,2,0,2
Konstantinos Mitroglou,1,440.0,0,0,5,4,9
Koo Ja-cheol,6,523.0,0,1,8,4,12
Koray Avcı,0,72.0,0,0,0,1,1
Koriak Upaiga,0,67.0,0,0,1,0,1
Korken Yenkibarian,1,82.0,0,0,0,1,1
Kornel Saláta,0,24.0,0,0,1,1,2
Kossi Noutsoudje,0,138.0,0,0,2,0,2
Kosta Barbarouses,1,109.0,0,0,2,1,3
Kosta Tomašević,2,151.0,0,0,0,2,2
Kostadin Kostadinov,0,162.0,0,0,1,2,3
Kostakis Artymatas,0,75.0,0,0,0,1,1
Kostas Aidiniou,0,80.0,0,0,1,0,1
Kostas Antoniou,0,51.0,0,0,1,1,2
Kostas Batsinilas,0,73.0,0,0,0,1,1
Kostas Davourlis,0,60.0,0,0,1,0,1
Kostas Eleftherakis,0,167.0,0,0,2,1,3
Kostas Fortounis,1,241.0,0,1,1,3,4
Kostas Foti,0,25.0,0,0,1,0,1
Kostas Frantzeskos,0,215.0,0,0,2,1,3
Kostas Iosifidis,0,47.0,0,0,1,0,1
Kostas Katsouranis,0,248.0,0,0,3,1,4
Kostas Konstantinidis,0,89.0,0,0,0,1,1
Kostas Mavridis,0,39.0,0,0,0,1,1
Kostas Mitroglou,0,104.0,0,0,2,1,3
Kostas Nestoridis,0,28.0,0,0,0,1,1
Kostas Panayiotou,0,96.0,2,0,0,2,2
Kostas Stafylidis,0,65.0,0,0,1,1,2
Kouassi N'Dri,1,152.0,0,0,2,0,2
Kouch Sokumpheak,0,227.0,0,0,2,1,3
Kouligo Zoma,0,32.0,0,0,0,1,1
Kpah Sherman,1,86.0,0,0,1,0,1
Krasimir Balakov,0,387.0,0,4,6,5,11
Krassimir Chomakov,0,108.0,0,0,2,0,2
Kresten Bjerre,0,258.0,0,2,4,0,4
Kris Bouckenooghe,0,27.0,0,0,0,1,1
Kris Boyd,0,104.0,0,1,4,0,4
Kris Trajanovski,4,577.0,0,1,7,4,11
Krishanu Dey,0,119.0,0,0,1,1,2
Krissada Piandit,0,23.0,0,0,1,0,1
Kristaps Grebis,0,76.0,0,0,1,0,1
Kristen Nygaard,0,114.0,0,2,1,1,2
Kristen Viikmäe,0,144.0,0,0,3,1,4
Kristian Dimitrov,0,55.0,0,0,1,0,1
Kristian Laferla,0,79.0,0,0,0,2,2
Kristian Thorstvedt,0,109.0,0,0,1,2,3
Kristján Örn Sigurðsson,0,155.0,0,0,2,0,2
Kristofer Hæstad,0,31.0,0,0,1,0,1
Krisztián Kenesei,0,65.0,0,0,0,2,2
Krisztián Lisztes,0,302.0,0,0,1,4,5
Krisztián Németh,0,199.0,0,0,1,2,3
Kroekrit Thaweekarn,0,29.0,0,0,0,1,1
Krum Yanev,0,59.0,0,0,1,0,1
Krzysztof Bukalski,0,74.0,0,1,1,0,1
Krzysztof Mączyński,0,17.0,0,0,2,0,2
Krzysztof Nowak,0,90.0,0,0,1,0,1
Krzysztof Piątek,0,355.0,0,0,2,4,6
Krzysztof Warzycha,0,211.0,0,1,2,1,3
Krépin Diatta,1,64.0,0,0,1,0,1
Ku Kam Fai,0,60.0,0,0,0,1,1
Kubilay Türkyilmaz,0,1492.0,0,8,15,11,26
Kudakwashe Mahachi,2,99.0,0,0,2,1,3
Kuliwa Tshikalu,0,19.0,1,0,0,1,1
Kunishige Kamamoto,2,92.0,0,0,0,2,2
Kunle Awesu,0,77.0,0,0,1,0,1
Kurapiah Gunalan,1,81.0,0,0,1,0,1
Kurniawan Dwi Yulianto,0,139.0,0,0,2,2,4
Kurt Frederick,0,155.0,0,1,1,1,2
Kurt Hamrin,0,478.0,0,0,5,2,7
Kurt Jara,0,466.0,0,0,6,4,10
Kurt Liebrecht,0,80.0,0,1,1,0,1
Kurt Mørkøre,0,82.0,0,0,0,1,1
Kurt Müller,0,189.0,0,0,1,2,3
Kurt Svanström,0,68.0,0,0,1,0,1
Kurt Welzl,0,312.0,0,0,4,3,7
Kurt Zouma,0,60.0,0,0,0,1,1
Kuyangana Makukula,0,47.0,0,0,0,1,1
Kwadwo Asamoah,2,258.0,0,0,2,2,4
Kwak Tae-hwi,0,187.0,0,0,2,1,3
Kwame Ayew,0,202.0,0,0,3,1,4
Kwame Nti,1,43.0,0,0,1,0,1
Kwame Quee,0,56.0,0,0,0,1,1
Kwame Steede,0,101.0,0,0,1,1,2
Kwasi Owusu,4,358.0,0,1,2,6,8
Kwesi Appiah,1,44.0,0,0,1,0,1
Kwok Ka-ming,3,252.0,0,0,1,3,4
Kwok Yue Hung,0,93.0,0,0,0,1,1
Kwon Chang-hoon,1,433.0,0,0,5,2,7
Kyaw Ko Ko,1,32.0,0,0,1,0,1
Kyaw Zayar Win,0,85.0,0,0,0,1,1
Kyle Beckerman,0,49.0,0,0,1,0,1
Kyle Lafferty,0,889.0,0,0,9,6,15
Kyle Lightbourne,0,97.0,0,0,1,1,2
Kyle Martino,0,51.0,0,0,1,0,1
Kylian Mbappé,12,1368.0,0,2,15,6,21
Kyogo Furuhashi,0,171.0,0,0,3,0,3
Kypros Christoforou,0,51.0,1,0,1,0,1
Kyriakos Papadopoulos,0,110.0,0,0,1,1,2
Kyrian Nwoko,0,13.0,0,0,1,0,1
Kálmán Kovács,0,147.0,0,0,1,3,4
Kálmán Mészöly,2,291.0,0,4,3,3,6
Kári Reynheim,0,63.0,0,0,0,1,1
Kári Árnason,0,120.0,0,0,2,2,4
Károly Csapó,0,9.0,0,0,0,1,1
Károly Sándor,1,230.0,0,0,4,2,6
Kévin Constant,1,15.0,0,1,1,0,1
Kévin Denkey,0,77.0,0,0,0,1,1
Kévin Fortuné,2,137.0,0,0,1,1,2
Kévin Parsemain,3,274.0,0,1,3,2,5
Köbi Kuhn,0,132.0,0,1,2,1,3
Köksal Mesçi,0,79.0,0,1,1,0,1
La'Vere Corbin-Ong,0,12.0,0,0,1,0,1
Labama Bokota,0,298.0,0,1,4,0,4
Lachezar Tanev,0,317.0,0,1,3,2,5
Lacina Traoré,0,25.0,0,0,0,2,2
Ladislao Kubala,0,152.0,0,0,1,3,4
Ladislas Douniama,0,5.0,0,0,0,1,1
Ladislav Jurkemik,0,111.0,0,0,1,1,2
Ladislav Kačáni,0,29.0,0,0,0,1,1
Ladislav Krejčí,0,56.0,0,0,0,1,1
Ladislav Kuna,0,232.0,0,0,2,2,4
Ladislav Novák,0,43.0,0,0,0,1,1
Ladislav Pavlovič,0,154.0,0,0,1,1,2
Ladislav Petráš,2,150.0,0,0,3,2,5
Ladislav Vízek,1,508.0,0,1,7,3,10
Ladislav Šimůnek,0,189.0,0,0,3,0,3
Lahcen Abrami,0,60.0,0,1,1,0,1
Lahcen Chicha,0,64.0,0,0,0,1,1
Lai Wing-Cheung,0,11.0,0,0,1,1,2
Laisiasa Gataurua,3,249.0,0,0,3,1,4
Laith Hussein,8,406.0,0,0,9,3,12
Lajos Csordás,0,91.0,0,0,2,0,2
Lajos Détári,1,323.0,0,1,5,3,8
Lajos Kocsis,2,361.0,0,2,4,3,7
Lajos Kű,0,53.0,0,1,0,1,1
Lajos Puskás,0,68.0,0,0,1,0,1
Lajos Szűcs,0,91.0,0,0,2,0,2
Lajos Sătmăreanu,0,56.0,0,0,0,1,1
Lajos Tichy,6,704.0,0,1,5,10,15
Lakhdar Belloumi,6,656.0,0,0,8,4,12
Lakis Glezos,0,88.0,0,0,0,1,1
Lakis Papaioannou,0,104.0,0,0,0,2,2
Lalawélé Atakora,0,35.0,0,0,1,0,1
Lalaïna Nomenjanahary,1,103.0,0,0,1,2,3
Lam Ka Wai,0,199.0,0,1,3,0,3
Lamin Conteh,0,87.0,0,0,1,0,1
Lamine Diatta,1,141.0,0,0,1,1,2
Lamnao Singto,0,74.0,0,0,2,0,2
Lancaster Joseph,0,50.0,0,0,0,1,1
Landon Donovan,7,2040.0,0,10,31,7,38
Landry N'Guémo,1,64.0,0,0,1,0,1
Lantame Ouadja,1,66.0,0,0,1,1,2
Larbi Chebbak,1,81.0,0,0,1,0,1
Larrymore Bedford,0,88.0,0,0,1,0,1
Lars Bastrup,0,234.0,0,0,1,3,4
Lars Bender,1,80.0,0,0,0,1,1
Lars Bohinen,0,223.0,0,0,2,3,5
Lars Elstrup,1,123.0,0,0,2,1,3
Lars Granström,0,49.0,0,0,0,2,2
Lars Jacobsen,0,7.0,0,0,0,1,1
Lars Krogh Gerson,0,129.0,0,1,2,1,3
Lars Olsen,0,13.0,0,0,1,0,1
Lars Stindl,3,66.0,0,0,1,2,3
Laryea Kingston,1,82.0,0,0,1,1,2
Lasaad Abdelli,0,37.0,0,0,1,0,1
Lascelles Dunkley,0,179.0,0,0,2,2,4
Lassana Fané,0,23.0,0,0,0,1,1
Lasse Larsson,0,85.0,0,0,1,0,1
Lasse Schøne,0,60.0,0,0,0,1,1
Lasse Vibe,0,81.0,0,0,0,1,1
Lassina Dao,0,29.0,0,0,1,0,1
Lassina Diabaté,1,83.0,0,0,1,0,1
Lassina Traoré,1,76.0,0,1,0,1,1
Lau Wing Yip,1,516.0,0,0,5,4,9
Laughter Chilembe,1,52.0,0,0,1,0,1
Lauren,0,78.0,0,0,1,0,1
Laurent Blanc,2,552.0,0,0,6,3,9
Laurent Depoitre,0,64.0,0,0,0,1,1
Laurent Grimmonprez,0,51.0,0,0,1,0,1
Laurent Pokou,13,910.0,0,0,1,14,15
Laurenţiu Roşu,0,156.0,0,0,2,1,3
Lauro Amado,1,29.0,0,0,1,0,1
Lautaro Martínez,6,484.0,0,0,6,7,13
Lawrence Adjei,0,90.0,0,0,1,0,1
Lawrence Harvey,1,41.0,1,0,0,1,1
Lawrence Reilly,0,82.0,0,0,1,1,2
Lawrence Shankland,0,65.0,0,0,1,0,1
Lawrence Waya,0,51.0,0,0,1,0,1
Lazar Marković,0,55.0,0,0,0,1,1
Lazar Tasić,0,87.0,0,0,1,0,1
Lazaros Christodoulopoulos,0,20.0,0,0,0,1,1
Lazarus Kaimbi,0,142.0,0,0,2,1,3
Le Huynh Duc,0,38.0,0,0,1,0,1
Leandro Bacuna,3,62.0,0,0,0,3,3
Leandro Barreiro,0,45.0,0,0,1,0,1
Leandro Machado,1,86.0,0,0,1,0,1
Leandro Paredes,0,8.0,0,0,0,1,1
Leandro Trossard,0,112.0,0,0,2,0,2
Leart Paqarada,1,60.0,1,0,0,1,1
Ledian Memushaj,0,71.0,0,0,0,1,1
Lee Casciaro,0,136.0,0,0,1,2,3
Lee Chun-soo,1,130.0,0,0,1,1,2
Lee Chung-yong,2,185.0,0,0,2,2,4
Lee Dixon,0,9.0,0,0,1,0,1
Lee Dong-gook,11,986.0,0,1,12,6,18
Lee Dong-gyeong,0,22.0,0,0,1,0,1
Lee Eul-yong,0,9.0,0,0,1,0,1
Lee Hak-Jong,1,31.0,0,0,0,1,1
Lee Hoi-taek,1,59.0,0,0,0,1,1
Lee Jae-sung,2,176.0,0,0,2,2,4
Lee Jeong-hyeop,0,90.0,0,0,1,0,1
Lee Jung-hyup,1,53.0,0,0,1,1,2
Lee Jung-il,1,7.0,0,0,0,1,1
Lee Jung-soo,2,45.0,0,0,1,1,2
Lee Kang-Jo,1,84.0,0,0,1,0,1
Lee Keun-ho,1,569.0,0,0,4,5,9
Lee Kin Wo,2,99.0,0,0,2,1,3
Lee McCulloch,0,10.0,0,0,1,0,1
Lee Min-sung,1,161.0,0,0,1,1,2
Lee Sang-yoon,0,179.0,0,0,2,1,3
Lee Soon-myung,0,79.0,0,0,0,1,1
Lee Tae-ho,6,531.0,0,2,4,5,9
Lee Wai-Shan,0,30.0,0,0,1,0,1
Lee Wilkie,0,71.0,0,0,1,0,1
Lee Yi-woo,0,45.0,0,0,1,0,1
Lee Young-Moo,0,116.0,0,0,0,2,2
Lee Young-jin,0,38.0,0,0,1,0,1
Lee Young-pyo,1,166.0,0,0,3,0,3
Leen Vente,1,216.0,0,0,2,1,3
Lefter Küçükandonyadis,2,239.0,0,1,3,2,5
Lefteris Makris,0,89.0,0,0,0,1,1
Leger Djime,1,109.0,0,0,1,1,2
Lehlohonolo Majoro,0,62.0,0,0,1,0,1
Lehlohonolo Seema,1,90.0,0,0,1,0,1
Lehlomela Ramabele,0,82.0,0,0,1,0,1
Lei Clijsters,1,15.0,0,0,1,0,1
Leif Engqvist,0,89.0,0,0,1,0,1
Leif Eriksson,0,208.0,0,0,3,1,4
Leigh Griffiths,0,258.0,0,0,3,1,4
Leighton Baines,0,83.0,0,0,0,1,1
Leighton James,0,375.0,0,2,5,2,7
Lejuan Simmons,1,60.0,0,0,1,0,1
Leng Makara,1,70.0,1,0,1,0,1
Lennart Bunke,0,192.0,0,0,4,0,4
Lennart Skoglund,0,32.0,0,0,1,0,1
Leo Houtsonen,0,61.0,0,0,1,0,1
Leo Lainer,0,44.0,0,0,0,1,1
Leo Leslie,0,81.0,0,0,1,0,1
Leocadio Marín,3,304.0,0,0,2,4,6
Leon Andreasen,0,33.0,0,0,1,1,2
Leon Bailey,0,39.0,0,1,1,0,1
Leon Balogun,1,29.0,0,0,0,1,1
Leon Cort,0,81.0,0,0,1,0,1
Leon Goretzka,3,458.0,0,0,11,1,12
Leon Goua G'Bize,0,92.0,0,0,1,1,2
Leon Mupenzi,0,48.0,0,0,1,0,1
Leonard Farrugia,0,124.0,0,0,2,0,2
Leonard Piątek,0,23.0,0,0,2,0,2
Leonard Wells,0,89.0,0,0,1,0,1
Leonardo Araújo,4,207.0,0,0,4,0,4
Leonardo Astrada,1,70.0,0,0,1,0,1
Leonardo Bonucci,1,303.0,0,1,0,5,5
Leonardo Palacios,1,49.0,0,0,0,1,1
Leonardo Pavoletti,0,76.0,0,0,1,0,1
Leonardo Rodríguez,1,87.0,0,0,0,2,2
Leonardo Véliz,0,31.0,0,0,1,0,1
Leone Vurukania,2,90.0,0,0,0,2,2
Leonel Duarte,0,85.0,0,0,0,1,1
Leonel Hernández,0,258.0,0,1,4,1,5
Leonel Justiniano,1,82.0,0,0,1,0,1
Leonel Moreira,0,66.0,1,0,1,0,1
Leonel Saint-Preux,0,28.0,0,0,0,1,1
Leonel Sánchez,5,488.0,0,3,9,2,11
Leonel Vielma,0,72.0,0,0,0,1,1
Leong Ka Hang,0,111.0,0,1,2,0,2
Leonhard Kass,0,47.0,0,0,0,1,1
Leonid Buryak,1,56.0,0,0,2,0,2
Leonid Koshelev,0,93.0,0,0,1,1,2
Leonid Kovel,0,86.0,0,0,1,0,1
Leonidas Flores,1,17.0,0,0,1,0,1
Leonson Lewis,1,179.0,0,0,2,1,3
Leopold Grausam,0,193.0,0,0,2,1,3
Leopold Kielholz,3,68.0,0,0,0,3,3
Leopoldo Luque,0,406.0,0,0,5,3,8
Leopoldo Quiñónez,1,32.0,0,0,0,1,1
Leotis Boateng,0,11.0,0,0,1,0,1
Leovegildo Lins da Gama Júnior,1,159.0,0,0,1,1,2
Leroy Fer,1,77.0,0,0,1,0,1
Leroy Francis,0,116.0,0,0,2,0,2
Leroy Sané,1,320.0,0,0,3,4,7
Les Ferdinand,1,166.0,0,0,2,2,4
Les Scheinflug,2,85.0,0,1,1,1,2
Leslie Santos,0,60.0,0,1,1,0,1
Lesly St. Fleur,0,379.0,1,0,7,0,7
Lester Hayes III,0,90.0,0,0,1,0,1
Lester Moré,3,704.0,0,1,7,7,14
Lester Peltier,0,193.0,0,0,4,0,4
Leszek Lipka,0,75.0,0,0,0,1,1
Levan Kenia,1,90.0,0,0,1,0,1
Levan Kobiashvili,0,565.0,0,3,3,5,8
Levan Mchedlidze,0,16.0,0,0,1,0,1
Levi García,1,160.0,0,0,1,2,3
Levon Hayrapetyan,0,22.0,1,0,1,0,1
Lexa Bibi,2,99.0,0,0,1,1,2
Leônidas,1,55.0,0,0,1,0,1
Leônidas da Silva,7,439.0,0,0,7,0,7
Li Bing,2,396.0,0,0,3,4,7
Li Chang-Ha,2,43.0,0,0,2,0,2
Li Dong-woon,1,22.0,0,0,1,0,1
Li Fubao,1,7.0,0,0,0,1,1
Li Huan-wen,1,45.0,0,0,0,1,1
Li Huayun,1,108.0,0,0,0,1,1
Li Hui,1,84.0,0,0,3,0,3
Li Jinyu,0,413.0,0,0,5,3,8
Li Kwok Keung,1,14.0,0,0,1,0,1
Li Ming,2,147.0,0,0,5,0,5
Li Weifeng,0,517.0,0,0,5,2,7
Li Xiao,0,70.0,0,0,0,1,1
Li Xiaopeng,0,144.0,0,0,3,0,3
Li Yi,0,80.0,0,0,1,0,1
Li Yong-Man,0,3.0,0,0,0,1,1
Li Yong-Sob,2,66.0,0,0,1,2,3
Liam Brady,0,296.0,0,2,4,1,5
Liam O'Kane,0,68.0,0,0,0,1,1
Liam Tuohy,0,71.0,0,0,2,1,3
Liam Walker,1,33.0,0,0,2,0,2
Liberato Cacace,1,71.0,0,0,1,0,1
Libor Kozák,0,19.0,0,0,0,1,1
Libor Sionko,1,113.0,0,0,2,3,5
Ligorio López,0,113.0,0,0,1,1,2
Lilian Laslandes,0,74.0,0,0,0,1,1
Lilian Thuram,0,117.0,0,0,2,0,2
Lim Teong Kim,0,19.0,0,0,0,1,1
Limberg Gutiérrez,1,144.0,0,0,1,2,3
Limbikani Mzava,1,51.0,1,0,1,0,1
Lin Lefeng,1,81.0,0,0,0,2,2
Lin Qiang,0,51.0,0,0,0,1,1
Lin Wen Han,1,59.0,0,0,0,1,1
Lincoln Zvasiya,0,81.0,0,0,1,0,1
Linnal Wilson,0,67.0,0,0,1,0,1
Lino Nessi,1,10.0,0,0,1,0,1
Linos Chalwe,0,26.0,0,0,1,0,1
Linos Makwaza,1,40.0,0,0,1,0,1
Liombi Essende,1,72.0,0,0,0,1,1
Lionel Messi,25,2475.0,0,14,39,15,54
Lior Refaelov,0,164.0,0,0,0,3,3
Lisi Leututu,1,8.0,1,0,0,1,1
Listner Pierre-Louis,0,44.0,0,0,1,0,1
Lito,0,39.0,0,0,1,0,1
Litsepe Marabe,0,88.0,0,0,1,0,1
Liu Binbin,1,5.0,0,0,1,0,1
Liu Haiguang,4,259.0,0,0,3,2,5
Liu Jian,1,77.0,0,0,1,1,2
Liuai Duguga,0,89.0,0,0,1,0,1
Liviu Ciobotariu,0,66.0,0,0,0,1,1
Lizardo Garrido,0,85.0,1,0,1,0,1
Liédson,1,241.0,0,0,2,1,3
Ljubinko Drulović,1,108.0,0,0,1,1,2
Ljubomir Radanović,0,95.0,0,0,1,1,2
Ljupčo Markovski,0,69.0,0,0,0,1,1
Llewellyn Riley,0,256.0,0,0,3,2,5
Lo Chih Tsong,0,71.0,1,0,1,0,1
Lo Hung-Hoi,1,53.0,0,0,1,0,1
Lo Kwan Yee,0,32.0,0,0,2,0,2
Loay Taleb,1,60.0,0,0,0,1,1
Locó,0,78.0,0,0,0,1,1
Logan Rogerson,1,36.0,0,1,1,0,1
Loh Wai Chi,1,15.0,0,0,0,1,1
Lokenge Mungongo,0,166.0,0,0,0,2,2
Lokoua Taufahema,4,244.0,0,0,0,5,5
Lomana LuaLua,1,76.0,0,0,0,2,2
Lorenc Trashi,0,40.0,0,0,0,1,1
Lorenzo Fernández,3,93.0,0,0,0,3,3
Lorenzo Gimenez,0,11.0,0,0,1,0,1
Lorenzo Insigne,1,274.0,0,0,3,3,6
Lorenzo Pellegrini,0,77.0,0,0,0,1,1
Lorenzo Staelens,0,268.0,0,2,4,2,6
Lorenzo Tehau,5,293.0,0,0,1,4,5
Lorgio Álvarez,0,57.0,0,0,0,1,1
Loris Benito,0,75.0,0,0,0,1,1
Lorry Thomsen,1,45.0,0,0,0,1,1
Loten Dalai,0,89.0,0,0,0,1,1
Lotfi Hsoumi,0,80.0,0,0,1,0,1
Lotfi Rouissi,0,60.0,0,0,0,2,2
Lothar Emmerich,1,39.0,0,0,1,0,1
Lothar Matthäus,7,657.0,0,5,10,5,15
Lou Macari,0,18.0,0,0,0,1,1
Louis Camara,2,55.0,0,0,0,2,2
Louis Floch,0,30.0,0,0,1,0,1
Louis Gomis Diop,0,2.0,0,0,1,0,1
Louis Pilot,0,143.0,0,0,3,1,4
Louis Saha,0,16.0,0,0,1,1,2
Louis Schaub,0,335.0,0,0,4,1,5
Louis-Paul M'Fédé,2,234.0,0,1,4,0,4
Lovro Majer,1,201.0,0,0,1,2,3
Loïc Loval,1,33.0,0,0,0,1,1
Loïc Négo,0,178.0,0,0,1,1,2
Loïc Rémy,0,120.0,0,0,2,0,2
Lubambo Musonda,0,59.0,0,0,1,0,1
Luboš Kozel,0,26.0,0,0,1,0,1
Luboš Kubík,1,210.0,0,0,3,1,4
Luc Holtz,0,44.0,0,0,1,0,1
Luc Nilis,1,242.0,0,0,2,5,7
Luca Gobbi,0,27.0,1,0,0,1,1
Luca Toni,2,481.0,0,0,7,4,11
Lucas Barrios,4,301.0,0,0,2,3,5
Lucas Biglia,0,19.0,0,0,0,1,1
Lucas Cavallini,10,492.0,0,0,3,7,10
Lucas Lima,1,125.0,0,0,1,1,2
Lucas Neill,0,84.0,0,0,1,0,1
Lucas Paquetá,1,303.0,0,0,4,2,6
Lucas Pratto,0,79.0,0,0,1,1,2
Lucas Radebe,2,64.0,0,0,1,1,2
Lucho González,2,171.0,0,0,3,1,4
Luciano Djim,0,39.0,0,0,0,1,1
Luciano Figueroa,6,516.0,0,0,4,5,9
Luciano Galletti,0,63.0,0,0,0,1,1
Luciano Narsingh,0,161.0,0,0,1,1,2
Luciano Vassallo,1,325.0,0,4,6,1,7
Lucien Cossou,0,278.0,0,0,4,0,4
Lucien Kassi-Kouadio,2,176.0,0,1,3,0,3
Lucien Kouassi Kouame,0,17.0,0,0,1,0,1
Lucien Laurent,1,19.0,0,0,1,0,1
Lucien Mettomo,1,52.0,0,0,1,0,1
Lucjan Brychczy,0,250.0,0,0,4,2,6
Lucky Msiska,0,68.0,0,0,2,0,2
Ludo Coeck,1,106.0,0,0,3,0,3
Ludovic Giuly,0,206.0,0,0,2,1,3
Ludovic Gotin,1,59.0,0,0,1,0,1
Ludovic Magnin,0,158.0,1,0,2,0,2
Ludovic Sané,0,14.0,1,0,1,0,1
Ludovico Avio,1,60.0,0,0,1,0,1
Ludwig Augustinsson,1,62.0,0,0,0,2,2
Luigi De Agostini,1,176.0,0,0,2,0,2
Luigi Di Biagio,2,46.0,0,0,2,0,2
Luigi Pieroni,0,52.0,0,0,0,1,1
Luigi Riva,0,407.0,0,0,4,3,7
Luis Advíncula,0,89.0,0,0,0,1,1
Luis Alfonso Rodríguez,1,26.0,0,0,1,0,1
Luis Alfredo Ramírez,0,83.0,0,0,0,1,1
Luis Anaya,0,229.0,0,0,1,2,3
Luis Antonio Jiménez,0,91.0,0,0,2,0,2
Luis Aragonés,0,75.0,0,0,1,0,1
Luis Araneda,0,127.0,0,0,2,0,2
Luis Artime,8,625.0,0,0,9,2,11
Luis Capurro,1,6.0,0,1,1,0,1
Luis Carlos Perea,1,88.0,0,0,1,0,1
Luis Casquez,0,77.0,0,0,1,0,1
Luis Chávez,1,52.0,0,0,0,1,1
Luis Copete,0,64.0,0,0,2,0,2
Luis Cristaldo,0,151.0,0,0,1,3,4
Luis Cruz,1,59.0,1,0,1,0,1
Luis Cruzado,0,40.0,0,0,1,0,1
Luis Cubilla,2,169.0,0,0,1,4,5
Luis Diego Arnáez,0,166.0,0,0,2,1,3
Luis Díaz,3,395.0,0,0,2,5,7
Luis Enrique,2,705.0,0,0,9,3,12
Luis Enrique Cálix,3,119.0,0,0,0,3,3
Luis Ernesto Castro,0,137.0,0,0,3,0,3
Luis Ernesto Pérez,0,267.0,0,0,5,0,5
Luis Espel,1,89.0,0,0,0,1,1
Luis Espinal,1,75.0,0,0,0,1,1
Luis Fernández,1,164.0,0,1,3,1,4
Luis Flores,0,107.0,0,0,3,1,4
Luis Fretes,3,209.0,0,0,0,3,3
Luis Fuentes,0,42.0,0,0,2,0,2
Luis Gabriel Rey,0,60.0,0,0,2,1,3
Luis Galeano,0,60.0,0,0,1,1,2
Luis García,1,244.0,1,0,5,0,5
Luis García Postigo,9,1035.0,0,2,12,6,18
Luis González Rubio,2,5.0,0,0,1,1,2
Luis Guadalupe,0,90.0,1,0,1,0,1
Luis Guzmán,3,214.0,0,0,0,3,3
Luis Guzmán Gonzales,1,62.0,0,0,0,1,1
Luis Gómez,0,90.0,0,0,0,1,1
Luis Henríquez,0,81.0,0,0,1,1,2
Luis Hernán Álvarez,0,25.0,0,0,0,1,1
Luis Hernández,18,1138.0,0,3,9,12,21
Luis Luna,0,56.0,0,0,2,0,2
Luis Mago,0,9.0,0,0,1,0,1
Luis Manuel Seijas,0,82.0,0,0,1,0,1
Luis Martén,1,177.0,0,0,2,1,3
Luis Martínez,0,111.0,0,0,2,0,2
Luis Marín Murillo,1,174.0,0,1,2,1,3
Luis Mendez,1,61.0,0,0,1,0,1
Luis Mendoza,1,54.0,0,0,1,1,2
Luis Mendoza Benedetto,0,55.0,0,0,1,0,1
Luis Meseguer,1,34.0,0,0,0,1,1
Luis Miguel Noriega,1,45.0,0,1,0,1,1
Luis Miguel Salvador,0,232.0,0,0,5,0,5
Luis Molowny,0,65.0,0,0,1,0,1
Luis Montes,2,60.0,0,0,0,2,2
Luis Monti,2,101.0,0,0,2,0,2
Luis Monzón,4,220.0,0,1,4,0,4
Luis Morales,0,51.0,0,0,1,0,1
Luis Muriel,0,122.0,0,1,3,0,3
Luis Navarrete,0,51.0,0,0,1,0,1
Luis Nery Caballero,0,15.0,0,0,0,1,1
Luis Norberto Campero,3,66.0,0,0,0,3,3
Luis Omar Sanchez,1,43.0,0,0,0,1,1
Luis Paradela,1,33.0,0,0,1,0,1
Luis Quiñónez,1,30.0,0,0,1,0,1
Luis Ramallo,0,260.0,0,0,2,5,7
Luis Ramírez Zapata,1,64.0,0,0,0,1,1
Luis Regueiro,0,165.0,0,0,2,1,3
Luis Reyna,0,59.0,0,0,0,1,1
Luis Santamaría,0,77.0,0,0,0,1,1
Luis Suárez,16,2414.0,0,9,28,18,46
Luis Suárez Miramontes,0,141.0,0,0,1,3,4
Luis Tejada,10,1292.0,0,1,15,9,24
Luis Vargas Peña,1,80.0,0,0,0,2,2
Luis Zavalla,0,121.0,0,0,0,2,2
Luis de Souza,1,75.0,0,0,1,0,1
Luis de la Fuente,0,197.0,0,0,4,0,4
Luis del Sol,0,80.0,0,0,0,1,1
Luisão,1,68.0,0,0,0,2,2
Luizão,0,31.0,0,0,2,0,2
Luk Man Wai,1,51.0,0,0,1,0,1
Luka Jović,0,125.0,0,0,2,0,2
Luka Menalo,0,155.0,0,0,2,0,2
Luka Milivojević,0,11.0,0,0,0,1,1
Luka Modrić,3,891.0,0,6,12,6,18
Luka Đorđević,0,24.0,0,0,0,1,1
Lukas Podolski,6,1285.0,0,0,18,11,29
Lukas Spalvis,0,90.0,0,0,1,0,1
Luke Adams,1,80.0,0,0,1,0,1
Luke Dimech,0,73.0,0,0,1,0,1
Luke Gambin,0,16.0,0,0,0,1,1
Luke Ivor,0,17.0,0,0,0,1,1
Luke Jukulile,0,87.0,0,0,1,0,1
Luke Shaw,0,2.0,0,0,1,0,1
Luke Wilkshire,0,147.0,0,2,1,1,2
Luki Gosche,0,55.0,0,0,2,0,2
Lukáš Haraslín,0,45.0,0,0,0,1,1
Lukáš Hrádecký,1,74.0,1,0,0,1,1
Lukáš Masopust,0,58.0,0,0,0,1,1
Lukáš Provod,0,50.0,0,0,1,0,1
Lungisani Ndlela,2,109.0,0,0,1,1,2
Lupo Quiñónez,0,44.0,0,0,0,1,1
Luther Blissett,0,192.0,0,0,3,0,3
Luton Shelton,2,423.0,0,2,9,2,11
Lutz Lindemann,0,108.0,0,0,1,1,2
Luuk de Jong,0,380.0,0,0,2,3,5
Luz Gastelbondo,1,27.0,0,0,0,1,1
Luís Fabiano,10,873.0,0,1,10,10,20
Luís Fernandes,0,83.0,0,0,1,0,1
Luís Figo,2,780.0,0,1,9,8,17
Luís Henrique,1,144.0,0,0,1,1,2
Luís Leal,0,86.0,0,0,1,0,1
Luís Neto,1,54.0,1,0,0,1,1
Luís Oliveira,0,186.0,0,0,3,3,6
Luís Roberto Alves,3,1024.0,0,1,18,3,21
Luís Trochillo,1,88.0,0,0,0,1,1
Luíz Mesquita de Oliveira,4,168.0,0,0,4,0,4
Lwata Mpia,0,78.0,0,0,1,0,1
Lyle Taylor,3,318.0,0,2,1,5,6
Lyndon Dykes,0,187.0,0,1,2,2,4
Lyndon Hooper,0,54.0,0,0,0,1,1
Lyndon Joseph,0,90.0,1,0,0,1,1
Lys Mouithys,0,80.0,0,0,0,2,2
Lyuboslav Penev,1,524.0,1,0,7,2,9
Lárus Guðmundsson,0,21.0,0,0,1,0,1
Lárus Sigurðsson,0,66.0,0,0,0,1,1
László Branikovits,0,88.0,0,0,2,0,2
László Bálint,1,211.0,1,0,3,2,5
László Bölöni,1,293.0,0,0,5,1,6
László Dajka,1,73.0,1,0,1,0,1
László Disztl,0,16.0,0,0,1,0,1
László Fazekas,2,369.0,0,0,6,1,7
László Fekete,0,53.0,0,0,2,0,2
László Kiss,3,554.0,0,0,6,2,8
László Klausz,0,80.0,0,0,3,0,3
László Kleinheisler,0,84.0,0,0,0,2,2
László Nagy,0,188.0,0,0,1,3,4
László Pusztai,0,111.0,0,0,2,1,3
László Szokolai,0,143.0,0,0,2,0,2
László Tieber,0,74.0,0,0,0,1,1
Lázaro Darcourt,3,361.0,0,0,3,3,6
Lázaro Oliveira,1,46.0,0,0,1,0,1
Lázár Szentes,1,131.0,0,0,2,0,2
Léger Djimrangar,1,92.0,0,0,1,1,2
Léider Preciado,1,82.0,0,0,1,0,1
Léon Dolmans,0,90.0,0,2,1,1,2
Léon Glovacki,0,67.0,0,0,0,2,2
Léon Letsch,0,58.0,0,0,0,1,1
Léon Mungamuni,1,188.0,0,0,1,2,3
Léon Semmeling,0,49.0,0,0,1,0,1
Léopold Anoul,3,194.0,0,0,3,2,5
Léster Blanco,1,215.0,0,0,1,3,4
Lê Công Vinh,0,521.0,0,1,7,4,11
Lê Hữu Đức,2,178.0,0,0,0,3,3
Líder Paz,0,96.0,0,0,2,1,3
Lúcio,1,84.0,0,0,0,1,1
Lư Đình Tuấn,1,14.0,0,0,1,0,1
M'Bala Nzola,0,35.0,0,1,1,0,1
M'Baye Niang,1,60.0,0,0,0,1,1
M'Peti Suzeti,0,1.0,0,0,1,0,1
Ma Jung-U,2,116.0,0,0,2,0,2
Ma Lin,3,446.0,0,0,1,7,8
Ma Mingyu,1,195.0,0,0,3,2,5
MaNicolás Oliveratias Almeyda,0,45.0,0,0,0,1,1
Mabululu,0,48.0,0,0,1,0,1
Macchambes Younga-Mouhani,0,184.0,0,0,3,0,3
Macha Gatien,1,88.0,0,0,1,0,1
Maciej Żurawski,0,447.0,0,1,5,3,8
Maciu Dunadamu,1,190.0,0,0,1,2,3
Macnelly Torres,0,128.0,0,0,3,0,3
Madjid Bougherra,1,160.0,0,0,1,2,3
Mael Kaudre,0,83.0,0,0,0,1,1
Magdi Abdelghani,2,159.0,0,2,0,2,2
Magid Mohamed,1,156.0,0,0,2,0,2
Magnús Bergs,0,110.0,0,0,1,1,2
Magomed Ozdoyev,0,83.0,0,0,1,1,2
Mahad Khaireh,0,39.0,0,0,1,0,1
Mahamadou Diarra,2,202.0,0,0,2,1,3
Mahamadou N'Diaye,1,108.0,0,0,2,0,2
Mahamane Cissé,0,115.0,0,0,3,0,3
Mahamat Labbo,0,63.0,0,0,1,1,2
Mahamoudou Kéré,0,116.0,0,0,3,0,3
Maharan Radi,0,4.0,0,0,0,1,1
Mahboub Juma'a,0,69.0,0,0,2,0,2
Mahdi Houssein Mahabeh,0,45.0,0,1,1,0,1
Mahdi Kadhim,1,35.0,0,0,0,1,1
Mahdi Kamel,2,139.0,0,0,2,0,2
Mahdi Karim,0,251.0,0,0,0,4,4
Maheanum Gatien,2,131.0,0,0,2,0,2
Maher Al Sayed,0,162.0,0,1,2,0,2
Maher Hammam,1,57.0,0,0,2,0,2
Maher Kanzari,0,30.0,0,0,1,0,1
Maher Malki,0,89.0,0,0,1,0,1
Maher Sabra,0,95.0,1,0,2,0,2
Mahfood Sultan Al Araimi,2,117.0,0,0,0,2,2
Mahir Emreli,0,128.0,0,0,1,1,2
Mahir Shukurov,0,152.0,0,1,2,0,2
Mahlon Houkarawa,1,82.0,0,0,0,1,1
Mahmadu Alphajor Bah,0,87.0,0,0,1,0,1
Mahmood Abdulrahman,0,295.0,0,1,4,1,5
Mahmood Al-Ajmi,0,45.0,0,0,1,0,1
Mahmoud Al Baher,1,64.0,0,0,1,0,1
Mahmoud Al-Jahani,0,22.0,0,0,1,0,1
Mahmoud Al-Mawas,9,726.0,0,3,5,7,12
Mahmoud Al-Sayed,0,101.0,0,0,2,0,2
Mahmoud Baquir Younes,0,89.0,1,0,0,1,1
Mahmoud Chahoud,0,63.0,0,0,0,1,1
Mahmoud El Ali,0,213.0,0,0,2,3,5
Mahmoud El Khatib,2,307.0,0,0,5,3,8
Mahmoud El-Gohary,3,144.0,0,0,3,0,3
Mahmoud Fathalla,0,55.0,0,0,1,0,1
Mahmoud Guendouz,0,34.0,0,0,1,0,1
Mahmoud Khamees,0,66.0,0,0,1,1,2
Mahmoud Mokhtar El-Tetsh,2,126.0,0,0,3,2,5
Mahmoud Shelbaieh,2,147.0,0,0,2,2,4
Mahmoud Soufi,1,448.0,0,0,8,0,8
Mahmoud Yaseen Al-Soufi,1,367.0,0,0,5,1,6
Mahmud Qurbanov,0,63.0,0,0,0,1,1
Mai Aih Naing,0,88.0,0,0,1,0,1
Mai Chao,3,354.0,0,2,3,2,5
Maicon Sisenando,4,146.0,0,0,2,2,4
Maik Galakos,0,206.0,0,0,3,0,3
Maikel Reyes,3,213.0,0,0,1,2,3
Majdi Samir,0,67.0,0,0,1,0,1
Majdi Shaaban Samir,0,266.0,0,0,2,2,4
Majdi Siddiq,0,37.0,0,0,1,0,1
Majed Abdullah,4,516.0,0,0,9,2,11
Majid Musisi,0,73.0,0,0,1,0,1
Majid Namjoo-Motlagh,1,15.0,0,1,0,1,1
Mak King-Fun,0,217.0,0,0,4,0,4
Mak Tian-fu,1,37.0,0,0,0,1,1
Makoto Hasebe,1,35.0,0,0,0,1,1
Maksim Bardachov,0,23.0,0,0,1,0,1
Maksim Buznikin,0,19.0,0,0,1,0,1
Maksim Igorevich Shevchenko,0,116.0,0,0,2,0,2
Maksim Medvedev,1,47.0,1,0,2,0,2
Maksim Nizovtsev,0,62.0,0,0,0,1,1
Maksim Romaschenko,0,365.0,0,1,3,4,7
Maksim Shatskikh,3,861.0,0,1,13,6,19
Maksim Skavysh,0,90.0,0,0,0,1,1
Maksim Smirnov,0,147.0,0,0,1,1,2
Maksim Valadzko,0,55.0,0,0,1,0,1
Maksim Zhalmagambetov,0,53.0,0,0,1,0,1
Maksym Kalynychenko,1,173.0,0,0,2,1,3
Mal Donaghy,0,15.0,0,0,0,1,1
Mal Griffiths,0,80.0,0,0,1,0,1
Malcolm Allen,0,11.0,0,0,0,1,1
Malcolm Bland,0,180.0,0,0,2,0,2
Malcolm Dunford,0,154.0,0,0,3,1,4
Malcolm Macdonald,0,224.0,0,0,5,0,5
Malek Mouath,2,309.0,0,0,3,2,5
Malick Evouna,1,74.0,0,0,1,1,2
Malik Awab,0,36.0,0,0,1,0,1
Malik Jabir,1,100.0,0,0,1,0,1
Malkhaz Asatiani,0,242.0,1,0,3,2,5
Mama Baldé,0,82.0,0,0,0,1,1
Mama Ouattara,0,104.0,0,0,1,1,2
Mamadaou Koïta,1,52.0,0,0,0,1,1
Mamadou Aliou Keita,3,162.0,0,0,2,3,5
Mamadou Bagayoko,1,103.0,0,0,2,0,2
Mamadou Bah,2,216.0,0,0,2,1,3
Mamadou Diallo,1,241.0,0,0,3,2,5
Mamadou Diarra,0,75.0,0,0,1,0,1
Mamadou Kané,0,31.0,0,0,0,1,1
Mamadou Niang,3,185.0,0,0,3,2,5
Mamadou Niass,0,69.0,0,0,1,0,1
Mamadou Sakho,0,94.0,0,0,2,0,2
Mamadou Samassa,2,171.0,0,1,2,3,5
Mamadou Tall,0,54.0,1,0,0,1,1
Mamadou Zongo,0,329.0,0,0,5,4,9
Mamane Ali,0,82.0,0,0,0,1,1
Mamar Mamouni,1,13.0,0,0,1,0,1
Mame Biram Diouf,1,211.0,0,0,1,2,3
Mamedaly Karadanov,0,159.0,0,0,1,1,2
Mamun Joarder,3,170.0,0,0,2,1,3
Mandla Masango,1,17.0,0,0,1,0,1
Maneca,0,85.0,0,0,1,0,1
Manfred Kaiser,0,57.0,0,0,0,1,1
Manfred Kaltz,0,220.0,0,2,3,3,6
Manfred Linzmaier,0,115.0,0,0,2,0,2
Manfred Ritschel,0,75.0,0,1,0,1,1
Manfred Zsak,0,62.0,0,0,1,0,1
Mani Stenter,1,68.0,0,0,0,1,1
Maniche,2,196.0,0,0,5,1,6
Maninho,0,69.0,0,0,0,1,1
Manjrekar James,0,35.0,0,0,0,1,1
Manny Rodríguez,0,90.0,0,0,1,0,1
Manoa Masi,2,62.0,0,0,0,2,2
Manoel Alencar Monte,0,23.0,0,0,0,1,1
Manolo,0,294.0,0,0,4,1,5
Manolo Gabbiadini,0,90.0,0,0,1,0,1
Manolom Phomsouvanh,0,71.0,0,0,0,2,2
Manor Solomon,0,62.0,0,0,1,1,2
Manrique Quesada,0,117.0,0,0,2,0,2
Mansour Al-Mousa,1,47.0,0,0,1,0,1
Mansour Al-Muainea,0,40.0,0,0,1,0,1
Mansour Basha Mohamed,1,62.0,0,0,1,0,1
Mansour Boutabout,0,309.0,0,0,3,2,5
Mansour Muftah,8,785.0,0,0,11,1,12
Mansour Sulaiti,1,37.0,0,0,0,1,1
Mansurdzhon Hakimov,0,37.0,0,0,1,0,1
Mantas Savėnas,0,41.0,0,0,1,0,1
Mantorras,0,134.0,0,0,1,1,2
Manuchekhr Dzhalilov,1,475.0,0,1,7,3,10
Manucho,7,424.0,0,2,2,7,9
Manucho Diniz,0,66.0,1,0,1,0,1
Manuel Akanji,1,58.0,0,0,0,1,1
Manuel Alonso,1,132.0,0,0,3,0,3
Manuel Amoros,1,111.0,0,1,1,0,1
Manuel Arancibia,1,84.0,0,0,2,0,2
Manuel Arenas,2,110.0,0,0,1,1,2
Manuel Asisclo Cordoba,0,15.0,0,0,1,0,1
Manuel Bobadilla,0,88.0,0,0,0,1,1
Manuel Bravo Paredes,0,41.0,0,0,0,1,1
Manuel Cardoni,0,117.0,0,0,1,1,2
Manuel Drago,1,47.0,0,0,0,1,1
Manuel Fernandes,0,496.0,0,0,5,3,8
Manuel Ferreira,0,117.0,0,0,3,2,5
Manuel Fleitas Solich,1,73.0,0,1,1,1,2
Manuel Friedrich,0,87.0,0,0,0,1,1
Manuel Gavilán,1,17.0,0,0,0,1,1
Manuel Locatelli,0,161.0,0,0,2,1,3
Manuel Lugo,0,110.0,0,0,1,2,3
Manuel Marani,0,86.0,0,0,1,0,1
Manuel Marengo,0,14.0,0,0,0,1,1
Manuel Muñoz,1,229.0,0,0,5,0,5
Manuel Negrete Arias,0,34.0,0,0,1,0,1
Manuel Ott,0,84.0,0,0,1,0,1
Manuel Pellegrina,1,83.0,0,0,1,0,1
Manuel Piñeiro,0,80.0,0,0,1,0,1
Manuel Ramírez,0,134.0,0,0,3,0,3
Manuel Rivera,0,72.0,0,0,2,0,2
Manuel Rosas,3,159.0,1,1,1,2,3
Manuel Rosas Arreola,1,89.0,1,1,0,3,3
Manuel Saavedra,0,61.0,0,0,1,0,1
Manuel Salamanca,1,71.0,0,0,0,1,1
Manuel Sanchís Hontiyuelo,0,64.0,0,0,1,0,1
Manuel Sanchís Martínez,1,57.0,0,0,1,0,1
Manuel Sarabia,0,129.0,0,0,1,1,2
Manuel Schauls,0,41.0,1,0,1,0,1
Manuel Seoane,2,360.0,0,0,8,0,8
Manuel Vallejas,1,36.0,0,0,0,1,1
Manuel Varela,1,79.0,1,0,1,0,1
Manuel Vasques,0,65.0,0,0,2,0,2
Manuel Velázquez,0,27.0,0,0,2,0,2
Mao Jianqing,1,33.0,0,0,1,0,1
Mao Yijun,0,87.0,0,0,0,1,1
Maor Melikson,0,61.0,0,0,0,1,1
Maouhoub Ghazouani,1,87.0,0,0,0,2,2
Marat Bikmaev,1,201.0,0,0,2,2,4
Marat Izmailov,0,32.0,0,0,2,0,2
Marc Berdoll,1,197.0,0,0,3,0,3
Marc Bernaus,0,60.0,0,0,1,0,1
Marc Birsens,0,76.0,0,0,1,0,1
Marc Degryse,2,586.0,0,0,10,4,14
Marc Enoumba,0,37.0,0,0,1,0,1
Marc Hottiger,0,126.0,0,0,4,0,4
Marc Janko,0,906.0,0,1,10,10,20
Marc Joseph,0,42.0,0,0,1,0,1
Marc Overmars,1,659.0,0,0,6,5,11
Marc Pujol,0,195.0,0,3,3,1,4
Marc Rebés,0,26.0,0,0,1,0,1
Marc Rieper,1,136.0,0,0,1,1,2
Marc Vales,0,150.0,0,0,4,0,4
Marc Van Der Linden,4,428.0,0,0,2,5,7
Marc Wilmots,4,870.0,0,2,9,9,18
Marc Wilson,0,46.0,0,0,0,1,1
Marc Zoro,1,54.0,0,0,1,0,1
Marc-Vivien Foé,1,258.0,0,0,3,3,6
Marcel Artelesa,0,80.0,0,0,0,1,1
Marcel Bossi,0,18.0,1,0,1,0,1
Marcel Christophe,1,51.0,0,0,0,1,1
Marcel Coraș,1,73.0,0,0,0,2,2
Marcel Desailly,1,67.0,0,0,2,0,2
Marcel Di Domenico,0,54.0,0,0,1,0,1
Marcel Halstenberg,0,48.0,0,0,0,1,1
Marcel Kimemba Mbayo,0,12.0,0,0,1,0,1
Marcel Koller,0,7.0,0,0,0,1,1
Marcel Langiller,1,40.0,0,0,1,0,1
Marcel Paeschen,0,25.0,0,0,1,0,1
Marcel Răducanu,0,189.0,0,0,2,1,3
Marcel Sabitzer,0,404.0,0,0,3,4,7
Marcel de Jong,1,28.0,0,0,0,1,1
Marcelinho Paraíba,0,4.0,0,0,1,0,1
Marcelino Bernal,1,214.0,0,0,3,1,4
Marcelino Martínez,0,218.0,0,0,4,0,4
Marcelino Núñez,0,77.0,0,0,0,1,1
Marcell Jansen,1,117.0,0,0,2,1,3
Marcelo,0,97.0,1,0,1,1,2
Marcelo Balboa,1,253.0,1,0,3,1,4
Marcelo Brozović,0,297.0,1,0,5,1,6
Marcelo Corrales,1,84.0,0,0,0,1,1
Marcelo Gallardo,3,461.0,0,2,5,3,8
Marcelo Martins Moreno,3,1246.0,0,6,15,10,25
Marcelo Nascimento da Costa,0,65.0,0,0,1,0,1
Marcelo Oliveira,1,89.0,0,0,1,0,1
Marcelo Otero,0,229.0,0,0,5,1,6
Marcelo Salas,4,1177.0,0,1,13,9,22
Marcelo Saralegui,3,227.0,0,0,5,1,6
Marcelo Sosa,1,22.0,0,0,1,0,1
Marcelo Zalayeta,3,478.0,0,0,5,2,7
Marcial Barrios,7,434.0,0,1,3,5,8
Marcial Salazar,1,39.0,1,0,1,0,1
Marciano Leyman,0,68.0,0,0,0,1,1
Marcin Kuźba,0,144.0,0,0,2,0,2
Marcin Żewłakow,1,313.0,0,0,3,1,4
Marco Antonio Anariba,2,117.0,0,1,0,3,3
Marco Antonio Mendoza,0,42.0,0,0,1,0,1
Marco Antonio Sandy,0,96.0,1,0,2,0,2
Marco Antônio García Alves,1,57.0,0,0,1,1,2
Marco Asensio,1,21.0,0,0,1,0,1
Marco Bode,1,232.0,0,0,1,4,5
Marco Delvecchio,1,117.0,0,0,1,2,3
Marco Di Vaio,0,64.0,0,0,1,0,1
Marco Estrada,0,74.0,0,0,1,0,1
Marco Etcheverry,2,542.0,0,1,9,2,11
Marco Fabián,4,212.0,0,1,2,2,4
Marco Garcés,1,38.0,0,0,1,0,1
Marco Ilaimaharitra,1,76.0,0,0,1,0,1
Marco Materazzi,2,45.0,0,0,1,1,2
Marco Padalino,0,87.0,0,0,1,0,1
Marco Pappa,1,200.0,0,0,3,1,4
Marco Paulo Rebelo Lopes,0,81.0,0,0,0,1,1
Marco Reus,2,557.0,0,0,8,5,13
Marco Rojas,0,252.0,0,0,3,1,4
Marco Sandy,0,94.0,0,0,3,0,3
Marco Schällibaum,0,23.0,0,0,1,0,1
Marco Soares,0,166.0,0,0,1,1,2
Marco Streller,0,105.0,0,0,1,1,2
Marco Tardelli,2,205.0,0,0,3,0,3
Marco Ureña,5,509.0,0,0,3,6,9
Marco Verratti,0,118.0,0,0,2,0,2
Marco Zwyssig,0,26.0,0,0,1,0,1
Marco van Basten,4,927.0,0,2,6,12,18
Marcos Alonso Peña,0,67.0,0,0,0,1,1
Marcos Bermeo,1,36.0,1,0,0,1,1
Marcos Coll,1,68.0,0,0,1,0,1
Marcos González,0,29.0,0,0,1,0,1
Marcos Lugris,0,93.0,0,1,1,1,2
Marcos Paulo,1,45.0,0,0,0,1,1
Marcos Pizzelli,0,203.0,0,0,3,3,6
Marcos Rojo,3,150.0,0,0,1,2,3
Marcos Senna,0,83.0,0,0,1,0,1
Marcus Allbäck,2,1009.0,0,0,12,7,19
Marcus Berg,0,762.0,0,0,12,4,16
Marcus Danielson,0,11.0,0,0,0,1,1
Marcus Forss,0,29.0,0,0,0,1,1
Marcus Gayle,1,41.0,0,0,1,0,1
Marcus Ingvartsen,0,89.0,0,0,1,0,1
Marcus Julien,0,41.0,0,0,0,1,1
Marcus Lopez,1,127.0,1,1,2,0,2
Marcus Macauley,1,81.0,0,0,1,1,2
Marcus Pürk,0,84.0,0,0,1,0,1
Marcus Rashford,3,368.0,0,0,3,4,7
Marcus Tulio Tanaka,0,219.0,1,0,1,3,4
Marcílio Alves da Silva,2,126.0,0,0,0,2,2
Mardik Mardikian,2,53.0,0,1,0,3,3
Marei Al Ramly,0,70.0,0,0,1,0,1
Marei Suliman,0,54.0,0,0,1,0,1
Marek Citko,0,7.0,0,0,0,1,1
Marek Hamšík,1,931.0,0,2,8,9,17
Marek Heinz,2,220.0,0,0,2,2,4
Marek Jankulovski,0,410.0,0,3,4,5,9
Marek Koźmiński,0,19.0,0,0,0,1,1
Marek Kulič,0,91.0,0,0,2,0,2
Marek Kusto,0,24.0,0,0,0,1,1
Marek Lemsalu,0,87.0,1,0,0,1,1
Marek Leśniak,0,282.0,0,0,2,3,5
Marek Matějovský,0,23.0,0,0,0,1,1
Marek Mintál,0,385.0,0,0,5,4,9
Marek Ostrowski,0,58.0,0,0,0,1,1
Marek Poštulka,0,82.0,0,0,0,2,2
Marek Saganowski,0,352.0,0,0,3,1,4
Marek Sapara,0,124.0,0,0,3,1,4
Marek Ujlaky,0,77.0,0,0,1,0,1
Marek Čech,0,265.0,0,0,3,2,5
Marian Hristov,0,58.0,0,0,0,1,1
Marian Zeman,0,37.0,0,0,1,0,1
Marians Pahars,0,134.0,0,0,3,2,5
Marijo Dodik,0,85.0,0,0,1,0,1
Marinho Chagas,0,96.0,0,0,2,0,2
Marino Alcívar,1,149.0,0,0,0,3,3
Marino Klinger,1,86.0,0,0,1,0,1
Marinos Ouzounidis,0,113.0,1,0,3,0,3
Mario Acevedo,0,84.0,0,0,0,1,1
Mario Alborta,1,42.0,0,0,0,1,1
Mario Balotelli,6,563.0,0,3,5,6,11
Mario Basler,0,71.0,0,0,1,0,1
Mario Bertini,0,81.0,0,0,0,1,1
Mario Bolatti,0,84.0,0,0,0,1,1
Mario Boyé,5,269.0,0,0,5,0,5
Mario Cordero,1,81.0,0,0,1,1,2
Mario Corso,0,236.0,0,0,1,2,3
Mario César Ramírez,0,43.0,1,0,1,0,1
Mario Evaristo,1,135.0,0,0,3,0,3
Mario Fernández,1,7.0,0,0,1,0,1
Mario Frick,0,537.0,1,1,7,5,12
Mario Gaspar Pérez,0,22.0,0,0,0,1,1
Mario Gavranović,1,425.0,0,0,2,3,5
Mario Gjurovski,0,42.0,0,0,1,0,1
Mario Gómez,5,793.0,0,0,6,9,15
Mario Götze,2,520.0,0,0,8,2,10
Mario Haas,0,96.0,0,0,2,0,2
Mario Harte,0,76.0,0,0,0,1,1
Mario Kempes,0,464.0,0,0,8,1,9
Mario Lemina,0,30.0,0,0,0,1,1
Mario Ludovico Bergara,3,192.0,0,0,0,4,4
Mario López,0,327.0,0,1,0,7,7
Mario Mandžukić,12,997.0,1,0,11,12,23
Mario Martínez,0,139.0,0,0,3,0,3
Mario Moreno,1,88.0,0,0,1,0,1
Mario Mutsch,0,61.0,0,0,1,0,1
Mario Méndez,0,5.0,0,0,0,1,1
Mario Ochoa,0,89.0,0,0,1,0,1
Mario Pašalić,1,235.0,0,0,3,1,4
Mario Pedraza,1,44.0,0,0,1,0,1
Mario Rafael Rodríguez,0,323.0,0,0,3,3,6
Mario Regueiro,0,4.0,0,0,0,1,1
Mario Rodríguez,3,209.0,0,0,3,2,5
Mario Rondón,0,32.0,0,0,0,1,1
Mario Saralegui,0,70.0,0,0,0,1,1
Mario Soto,2,129.0,0,0,1,2,3
Mario Stanić,1,108.0,0,0,2,1,3
Mario Tenorio,0,6.0,0,0,1,0,1
Mario Vega,0,90.0,0,0,1,0,1
Mario Yepes,1,187.0,0,0,2,2,4
Mario Zanabria,0,120.0,0,0,2,0,2
Marios Agathokleous,0,273.0,0,0,4,1,5
Marios Charalambous,0,26.0,1,0,0,1,1
Marios Christodoulou,0,163.0,0,0,2,0,2
Marios Elia,0,30.0,0,0,1,0,1
Marios Tsingis,0,68.0,0,1,0,1,1
Marius Lăcătuș,2,322.0,0,2,4,3,7
Marius Mapou,0,64.0,0,0,1,0,1
Marius Mbaiam,1,28.0,0,0,0,1,1
Marius Niculae,0,182.0,0,0,2,3,5
Marius Stankevičius,0,341.0,1,1,2,4,6
Marius Trésor,1,154.0,0,0,0,2,2
Marius Walter,1,13.0,0,0,1,0,1
Marius Žaliūkas,0,18.0,0,0,1,0,1
Mariusz Kukiełka,0,88.0,0,0,0,1,1
Mariusz Lewandowski,0,187.0,0,0,2,1,3
Marián Masný,0,281.0,0,0,3,4,7
Mark Armstrong,3,150.0,0,0,3,0,3
Mark Bosnich,0,88.0,0,1,1,0,1
Mark Bowen,0,126.0,0,0,2,0,2
Mark Bresciano,0,213.0,0,0,4,1,5
Mark Burton,0,339.0,0,0,5,1,6
Mark Chamberlain,0,71.0,0,0,1,0,1
Mark Ebanks,1,173.0,0,1,3,1,4
Mark Fish,0,110.0,0,0,2,0,2
Mark González,1,134.0,0,0,1,1,2
Mark Hartmann,1,88.0,0,0,1,0,1
Mark Hateley,0,206.0,0,0,2,2,4
Mark Hughes,0,471.0,0,0,7,4,11
Mark Kennedy,0,148.0,0,0,1,1,2
Mark Kinsella,0,61.0,0,0,2,0,2
Mark Lawrenson,0,204.0,0,0,3,2,5
Mark Mackay,0,37.0,0,0,0,1,1
Mark Milligan,1,219.0,0,3,2,2,4
Mark Pembridge,0,255.0,0,1,0,4,4
Mark Rogers,1,63.0,1,0,0,1,1
Mark Strudal,0,162.0,0,0,2,0,2
Mark Uhatahi,1,46.0,0,0,1,0,1
Mark Viduka,2,334.0,0,0,2,4,6
Mark Watson,1,180.0,0,0,1,2,3
Mark Williams,0,311.0,0,0,5,1,6
Mark Wright,1,58.0,0,0,1,0,1
Mark van Bommel,1,311.0,0,0,2,4,6
Mark-Anthony Kaye,2,95.0,0,0,0,2,2
Marko Arnautović,1,1255.0,0,4,13,10,23
Marko Babić,0,19.0,0,0,0,1,1
Marko Dević,0,134.0,0,1,1,3,4
Marko Kristal,0,160.0,0,0,1,1,2
Marko Livaja,1,167.0,0,0,2,1,3
Marko Pantelić,1,304.0,0,0,2,3,5
Marko Rajamäki,0,20.0,0,0,1,0,1
Marko Rehmer,0,48.0,0,0,1,2,3
Marko Simić,0,106.0,0,0,1,1,2
Marko Topić,0,87.0,0,0,1,0,1
Marko Valok,0,83.0,0,0,0,2,2
Marko Vešović,0,48.0,0,0,1,1,2
Marko Šuler,0,97.0,0,0,0,2,2
Markus Babbel,0,72.0,0,0,1,0,1
Markus Henriksen,0,204.0,1,0,2,2,4
Markus Rosenberg,0,139.0,0,0,2,0,2
Markus Schopp,0,229.0,0,0,1,4,5
Markus Tanner,0,55.0,1,0,2,0,2
Marlon Ayoví,0,118.0,0,2,1,1,2
Marlon Felter,0,215.0,1,1,3,2,5
Marlon James,0,252.0,0,0,3,1,4
Marlon King,1,221.0,0,1,5,3,8
Marlos,0,27.0,0,0,0,1,1
Marlos Huggins,0,18.0,0,0,0,1,1
Marlos Moreno,1,73.0,0,0,1,0,1
Marouane Chamakh,2,131.0,0,0,3,2,5
Marouane Fellaini,2,548.0,0,0,9,2,11
Maroš Klimpl,0,37.0,0,0,1,0,1
Marquinhos,0,147.0,1,0,2,2,4
Marshall Forbes,0,63.0,0,1,1,0,1
Marshall Munetsi,0,77.0,0,0,1,0,1
Marteinn Geirsson,1,51.0,0,1,0,1,1
Martin Amerhauser,0,71.0,0,0,1,0,1
Martin Andresen,1,40.0,0,0,0,1,1
Martin Boyle,3,132.0,0,0,2,1,3
Martin Braithwaite,1,317.0,0,0,2,3,5
Martin Büchel,0,17.0,1,0,2,0,2
Martin Chivers,0,173.0,0,0,3,2,5
Martin Dahlin,4,730.0,0,0,8,8,16
Martin Dúbravka,0,30.0,1,0,1,0,1
Martin Fabuš,0,70.0,0,0,1,1,2
Martin Fenin,0,87.0,0,0,0,1,1
Martin Frýdek,0,111.0,0,0,1,1,2
Martin Gisinger,0,37.0,0,0,0,1,1
Martin Gregory,0,85.0,0,0,1,0,1
Martin Harnik,0,501.0,0,0,2,7,9
Martin Hiden,0,69.0,0,0,0,1,1
Martin Hinteregger,0,121.0,1,0,2,2,4
Martin Hoffmann,1,532.0,0,0,8,3,11
Martin Jakubko,0,351.0,0,0,3,3,6
Martin Jiránek,0,85.0,1,0,0,1,1
Martin Jørgensen,1,237.0,0,1,2,5,7
Martin Koscelník,0,77.0,0,0,1,0,1
Martin Laursen,0,102.0,0,0,2,0,2
Martin Linnes,0,86.0,0,0,0,1,1
Martin Machón,1,45.0,0,0,1,0,1
Martin O'Neill,1,208.0,0,0,4,1,5
Martin Olsson,0,189.0,0,0,1,2,3
Martin Paterson,0,57.0,0,0,1,1,2
Martin Peters,1,329.0,0,0,2,5,7
Martin Petrov,1,761.0,0,2,11,4,15
Martin Petráš,0,28.0,0,0,0,1,1
Martin Reim,0,364.0,0,2,3,4,7
Martin Samuelsen,0,82.0,0,0,1,0,1
Martin Smedberg-Dalence,1,17.0,0,0,0,1,1
Martin Stocklasa,0,41.0,0,0,0,1,1
Martin Stranzl,0,157.0,0,0,1,2,3
Martin Sánchez,0,72.0,0,0,1,0,1
Martin Telser,0,49.0,0,0,1,0,1
Martin Vunk,0,28.0,0,0,1,0,1
Martin Weber,0,88.0,0,0,0,1,1
Martin Ødegaard,0,70.0,0,0,1,0,1
Martin Škrtel,0,342.0,2,0,6,1,7
Martins Eyo,1,54.0,0,0,1,0,1
Martti Hyvärinen,0,5.0,0,0,1,0,1
Martí Ventolrà,0,68.0,0,0,1,0,1
Martín Arzuaga,0,70.0,0,0,1,0,1
Martín Cáceres,0,114.0,0,0,2,1,3
Martín Demichelis,1,77.0,0,0,0,1,1
Martín Flor,1,47.0,0,0,0,1,1
Martín Hidalgo,2,136.0,0,0,2,0,2
Martín Palermo,4,351.0,0,0,3,2,5
Martín Pando,0,101.0,0,0,1,1,2
Martín Rodríguez,1,67.0,0,0,1,0,1
Marvin Andrews,2,239.0,1,0,3,4,7
Marvin Baudry,0,10.0,0,0,1,0,1
Marvin Ceballos,0,79.0,0,1,1,0,1
Marvin Chávez,1,168.0,0,0,0,2,2
Marvin Elliott,0,23.0,0,0,1,0,1
Marvin Faustin,0,63.0,0,0,1,0,1
Marvin Fletes,1,46.0,0,0,0,1,1
Marvin González,1,101.0,1,0,2,0,2
Marvin Monterrosa,0,109.0,0,0,0,2,2
Marvin Ogunjimi,0,297.0,0,0,3,2,5
Marvin Rodríguez,1,186.0,0,0,3,1,4
Marwan Khalifa Khouri,0,82.0,0,0,1,0,1
Marwan Medrati,0,78.0,0,0,1,0,1
Maryan Wisniewski,2,412.0,0,0,7,2,9
Marzouk Al-Otaibi,7,347.0,0,0,2,6,8
Masaaki Sawanobori,0,84.0,0,0,0,1,1
Masahiko Inoha,0,89.0,0,0,0,1,1
Masahiro Fukuda,1,196.0,0,0,3,1,4
Masakiyo Maezono,2,176.0,0,0,2,0,2
Masami Ihara,2,164.0,0,0,1,2,3
Masashi Nakayama,6,611.0,0,0,6,3,9
Masashi Oguro,3,419.0,0,0,3,2,5
Masashi Watanabe,1,11.0,0,0,1,0,1
Masato Morishige,1,35.0,0,0,0,1,1
Masauso Tembo,1,73.0,0,0,1,0,1
Masayuki Okano,1,118.0,0,0,1,0,1
Masengo Ilunga,0,85.0,0,0,1,0,1
Masimba Mambare,0,42.0,0,0,1,0,1
Mason Mount,0,153.0,0,0,0,2,2
Masoud Shojaei,1,232.0,0,1,2,2,4
Mass Sarr Jr.,1,54.0,0,0,0,1,1
Massadio Haïdara,1,2.0,0,0,1,0,1
Massamasso Tchangai,2,108.0,0,0,0,2,2
Massimo Lombardo,0,14.0,0,0,0,1,1
Massimo Luongo,0,220.0,0,0,5,0,5
Massimo Margiotta,0,74.0,0,0,0,1,1
Massimo Oddo,0,71.0,0,1,1,0,1
Master Masiku,0,78.0,0,0,0,1,1
Mat Noh,0,31.0,0,0,1,0,1
Matar Niang,2,101.0,0,0,0,2,2
Matateu,0,169.0,0,0,2,1,3
Mate Vatsadze,0,75.0,0,0,2,0,2
Matej Mavrič,0,58.0,0,0,0,1,1
Matej Mitrović,1,68.0,0,0,0,1,1
Mateja Kežman,4,524.0,0,0,4,6,10
Mateus Galiano da Costa,1,48.0,0,0,0,1,1
Mateus Uribe,0,139.0,0,0,1,1,2
Matheus Nunes,0,90.0,0,0,1,0,1
Mathew Leckie,3,314.0,0,0,4,5,9
Mathias Christen,0,60.0,0,0,1,0,1
Mathias Jensen,0,39.0,0,0,1,0,1
Mathias Jänisch,0,87.0,0,0,1,0,1
Mathias Jørgensen,1,85.0,0,0,0,2,2
Mathias Normann,0,88.0,0,0,1,0,1
Mathieu Bollen,0,100.0,0,0,2,0,2
Mathieu Dossevi,1,5.0,0,0,0,1,1
Mathieu Valbuena,1,87.0,0,0,1,1,2
Mathías Corujo,1,88.0,0,0,1,0,1
Matias Belli Moldskred,1,87.0,0,0,0,1,1
Mats Hummels,2,181.0,2,0,2,3,5
Mats Jingblad,0,87.0,0,0,0,1,1
Mats Magnusson,0,177.0,0,0,2,1,3
Mats Møller Dæhli,0,22.0,0,0,0,1,1
Mats Nordgren,0,54.0,0,0,0,1,1
Matt Besler,0,32.0,0,0,0,1,1
Matt Doherty,0,85.0,0,0,1,0,1
Matt Elliott,0,98.0,1,0,0,2,2
Matt Holland,2,243.0,0,0,1,3,4
Matt McKay,0,27.0,0,0,1,0,1
Matt Miazga,0,88.0,0,0,1,0,1
Matt Moussilou,0,1.0,0,0,0,1,1
Matt Ritchie,0,45.0,0,0,1,0,1
Mattar Al-Mukhaini,1,64.0,0,0,0,1,1
Matteo Darmian,0,65.0,0,0,0,1,1
Matteo Pessina,1,144.0,0,0,2,0,2
Matteo Vitaioli,0,55.0,0,0,0,1,1
Matthew Amoah,1,439.0,0,0,5,4,9
Matthew Bingley,0,66.0,0,0,1,0,1
Matthew Booth,0,5.0,0,0,1,0,1
Matthew Garbett,1,90.0,0,0,0,1,1
Matthew Hoppe,0,83.0,0,0,1,0,1
Matthew Upson,1,37.0,0,0,0,1,1
Matthias Döschner,0,84.0,0,0,0,1,1
Matthias Ginter,0,41.0,0,0,1,0,1
Matthias Herget,0,83.0,0,0,0,2,2
Matthias Liebers,0,40.0,0,0,1,0,1
Matthias Phaeton,1,20.0,0,0,0,1,1
Matthias Sammer,2,349.0,0,0,4,2,6
Matthias Sindelar,1,111.0,0,0,2,0,2
Matthijs de Ligt,0,48.0,0,0,1,0,1
Matthías Hallgrímsson,0,25.0,0,0,0,1,1
Matti Paatelainen,0,77.0,0,0,1,2,3
Mattia Destro,0,5.0,0,0,1,0,1
Mattia Stefanelli,0,136.0,1,0,0,2,2
Mattias Jonson,1,361.0,0,0,3,4,7
Mattias Käit,1,239.0,0,0,4,1,5
Mattias Svanberg,0,72.0,0,0,1,0,1
Matty Geoghegan,0,37.0,0,0,0,1,1
Matías Campos,0,86.0,0,0,1,0,1
Matías Fernández,0,390.0,0,0,3,4,7
Matías Jadue,0,90.0,0,0,0,1,1
Matěj Vydra,0,128.0,0,0,0,2,2
Maung Maung Lwin,0,63.0,0,0,1,0,1
Mauri Vanhanen,0,72.0,0,0,1,0,1
Mauri Wasi,2,107.0,0,0,1,1,2
Maurice Escalona,0,161.0,0,0,2,1,3
Maurice Martens,0,32.0,0,0,2,0,2
Maurice Sunguti,0,145.0,0,0,0,2,2
Maurice Tillotson,1,7.0,1,0,1,0,1
Maurice Willems,0,168.0,0,0,0,3,3
Mauricio Alonso Rodríguez,0,90.0,0,0,0,1,1
Mauricio Cienfuegos,0,315.0,0,0,5,0,5
Mauricio Ernesto González,0,90.0,0,0,0,1,1
Mauricio Isla,0,152.0,0,0,2,0,2
Mauricio Molina,1,79.0,0,0,1,0,1
Mauricio Pineda,1,36.0,0,0,1,0,1
Mauricio Pinilla,0,275.0,0,0,1,4,5
Mauricio Pochettino,0,67.0,0,0,0,1,1
Mauricio Ramos,1,87.0,0,0,0,1,1
Mauricio Serna,0,120.0,0,2,0,2,2
Mauricio Solís,0,115.0,0,0,1,1,2
Mauricio Wright,3,191.0,0,0,1,2,3
Maurinho,1,128.0,0,0,2,0,2
Mauro Camoranesi,0,134.0,0,0,0,3,3
Mauro Rosales,0,14.0,0,0,0,1,1
Mauro Valentini,0,110.0,1,0,1,1,2
Mavango Kiala,0,85.0,0,0,0,1,1
Mavuba Mafuila,0,89.0,0,1,1,0,1
Mawa Inunu,0,42.0,0,0,1,0,1
Max Gradel,6,264.0,0,0,2,5,7
Max Hagmayr,0,24.0,0,0,1,0,1
Max Kruse,2,207.0,0,0,1,2,3
Max Llovera,0,82.0,0,0,0,1,1
Max Lorenz,0,32.0,0,0,1,0,1
Max Morlock,6,545.0,0,0,9,3,12
Maxi Gómez,0,90.0,0,0,1,0,1
Maxi Pereira,1,141.0,0,0,2,1,3
Maxi Rodríguez,3,341.0,0,0,4,3,7
Maxim Fedin,0,62.0,0,0,1,0,1
Maxime Bossis,1,89.0,0,0,1,0,1
Maxime Camara,0,28.0,0,0,1,0,1
Maxime Chanot,0,126.0,1,1,2,0,2
Maximilian Göppel,0,227.0,2,0,1,2,3
Maxwel Cornet,2,208.0,0,0,2,1,3
May Mahlangu,0,71.0,0,0,1,0,1
Maya Yoshida,2,608.0,0,0,8,1,9
Mayanga Maku,5,215.0,0,0,0,7,7
Maykel Galindo,1,72.0,0,0,0,1,1
Maynor Figueroa,1,75.0,0,0,0,2,2
Mayron George,1,30.0,0,0,1,0,1
Mazinho Oliveira,1,16.0,0,0,1,1,2
Mbala Mbuta Biscotte,0,75.0,0,0,1,0,1
Mbark Boussoufa,1,90.0,0,0,0,1,1
Mbiamcie Mvoubi,0,89.0,0,1,1,0,1
Mbo Mpenza,0,123.0,0,0,2,0,2
Mbulelo Mabizela,0,108.0,0,0,2,0,2
Mbuleya Tondelva,0,150.0,0,0,1,1,2
Mbungu Ekofa,1,137.0,0,0,1,1,2
Mbwana Samatta,1,289.0,0,0,5,1,6
McDonald Mariga,0,84.0,0,1,2,0,2
Meaataz Kailouni,0,86.0,0,0,0,1,1
Mechack Jérôme,0,38.0,0,0,0,1,1
Meddie Kagere,0,227.0,0,0,3,2,5
Medhi Benatia,0,30.0,0,0,0,1,1
Medin Zhega,0,31.0,0,0,1,0,1
Mehdi Abtahi,1,22.0,0,0,0,1,1
Mehdi Ben Slimane,2,103.0,0,0,2,1,3
Mehdi Fonounizadeh,2,95.0,0,0,0,2,2
Mehdi Ghayedi,1,84.0,0,0,0,1,1
Mehdi Hasheminasab,0,54.0,0,0,1,0,1
Mehdi Mahdavikia,2,439.0,0,0,4,5,9
Mehdi Monajati,0,19.0,0,0,1,0,1
Mehdi Nafti,0,27.0,0,0,0,1,1
Mehdi Taremi,7,1007.0,0,1,9,11,20
Mehdi Torabi,0,89.0,0,0,1,0,1
Mehmed Baždarević,0,188.0,0,0,0,3,3
Mehmet Aurélio,0,72.0,0,0,1,0,1
Mehmet Durakovic,0,227.0,0,0,3,0,3
Mehmet Oğuz,0,85.0,0,0,1,0,1
Mehmet Scholl,1,177.0,0,0,3,0,3
Mehmet Türkkan,0,51.0,0,0,1,0,1
Mehmet Özgül,0,22.0,0,0,1,0,1
Meho Kodro,0,59.0,0,0,1,1,2
Mehrdad Minavand,3,296.0,0,0,0,4,4
Mehrdad Mohammadi,0,85.0,0,0,1,0,1
Mei Fang,0,10.0,0,0,1,0,1
Meinhard Olsen,0,83.0,0,0,0,1,1
Mejdi Traoui,1,82.0,0,0,1,0,1
Mekan Nasyrow,0,83.0,0,0,2,0,2
Mekan Saparow,0,73.0,1,0,1,1,2
Mel Charles,0,6.0,0,0,0,1,1
Meli Vuilabasa,2,266.0,0,0,3,1,4
Melih Atacan,0,54.0,0,0,1,0,1
Melis Asprou,0,22.0,0,0,1,0,1
Melvin Valies,1,65.0,0,0,0,1,1
Melvin Valladares,1,145.0,0,0,2,0,2
Memphis Depay,3,1392.0,0,6,17,9,26
Meng Kam Jong,0,76.0,0,0,1,0,1
Mengistu Worku,5,731.0,0,0,9,2,11
Mengitsu Hussien,0,7.0,0,0,1,0,1
Merih Demiral,0,188.0,2,0,3,0,3
Merlyn Membreño,0,65.0,0,0,1,0,1
Merouane Zemmama,0,66.0,0,0,1,0,1
Mert Müldür,0,84.0,0,0,1,0,1
Meshach Wade,0,130.0,0,0,2,0,2
Meshal Abdullah,0,86.0,0,0,0,1,1
Meshal Mubarak,0,140.0,0,0,2,0,2
Mesut Özil,4,1051.0,0,4,12,6,18
Metin Kurt,0,4.0,0,0,1,0,1
Metin Oktay,0,166.0,0,0,2,1,3
Metin Tekin,0,112.0,0,0,1,1,2
Metodije Spasovski,0,64.0,0,0,2,0,2
Mevlüt Erdinç,0,178.0,0,0,1,2,3
Mexhit Haxhiu,0,77.0,0,0,1,0,1
Mica Pinto,0,8.0,0,0,1,0,1
Micah Hyde,0,40.0,0,0,0,1,1
Micah Lea'alafa,0,102.0,0,1,2,0,2
Micah Richards,0,66.0,0,0,1,0,1
Michael Amir Murillo,1,72.0,1,0,2,0,2
Michael Arroyo,0,164.0,0,0,0,2,2
Michael Ballack,4,1030.0,0,8,15,12,27
Michael Barrantes,2,129.0,0,0,2,0,2
Michael Baur,0,98.0,1,0,2,2,4
Michael Beauchamp,0,21.0,0,0,0,1,1
Michael Bethel,0,40.0,0,0,1,0,1
Michael Boxall,0,31.0,1,0,1,0,1
Michael Bradley,2,514.0,0,0,9,3,12
Michael Chabala,1,167.0,0,0,3,1,4
Michael Crawford,0,50.0,0,0,1,0,1
Michael Degiorgio,0,102.0,0,0,0,2,2
Michael Dupuy,1,90.0,0,0,0,1,1
Michael Eneramo,0,80.0,0,0,1,0,1
Michael Essien,0,249.0,0,1,5,1,6
Michael Estrada,0,234.0,0,0,5,1,6
Michael Forde,0,89.0,0,0,1,0,1
Michael Foster,0,150.0,0,0,3,1,4
Michael Glowatzky,0,11.0,0,0,1,0,1
Michael Gravgaard,0,167.0,0,0,1,3,4
Michael Gregoritsch,1,163.0,0,0,2,0,2
Michael Groom,1,6.0,0,0,1,0,1
Michael Hughes,0,183.0,0,0,2,1,3
Michael Junior Palusami,1,20.0,0,0,1,0,1
Michael Keane,0,30.0,0,0,0,1,1
Michael Klein,0,109.0,0,0,1,1,2
Michael Krohn-Dehli,2,81.0,0,0,2,2,4
Michael Lang,0,94.0,0,0,1,1,2
Michael Laudrup,3,825.0,0,3,14,5,19
Michael Lohai,1,71.0,0,0,0,1,1
Michael McGarry,0,104.0,0,0,2,0,2
Michael McGlinchey,1,183.0,0,0,3,1,4
Michael Mifsud,1,706.0,0,2,9,5,14
Michael Ngadeu-Ngadjui,3,240.0,0,0,3,1,4
Michael O'Neill,0,214.0,0,0,2,2,4
Michael Obiku,0,67.0,0,0,0,1,1
Michael Olunga,2,289.0,0,0,4,3,7
Michael Orozco,0,136.0,0,0,1,1,2
Michael Owen,5,1194.0,0,1,14,13,27
Michael Preetz,1,6.0,0,0,1,0,1
Michael Rabeson,0,26.0,0,0,1,0,1
Michael Robinson,0,128.0,0,0,2,2,4
Michael Schjønberg,0,110.0,0,0,1,2,3
Michael Smith,0,7.0,0,0,0,1,1
Michael Stocklasa,0,90.0,0,0,1,0,1
Michael Streiter,0,48.0,0,0,1,0,1
Michael Umaña,0,22.0,0,0,1,0,1
Michael Zandberg,0,90.0,0,0,1,0,1
Michael Zisser,0,89.0,0,0,0,1,1
Michail Antonio,0,109.0,0,1,1,2,3
Michal Bílek,2,420.0,0,3,5,2,7
Michal Horňák,0,10.0,0,0,1,0,1
Michal Kadlec,0,326.0,1,3,1,4,5
Michal Krmenčík,0,85.0,0,0,3,1,4
Michal Ďuriš,0,110.0,0,0,0,1,1
Michalis Kapsis,0,43.0,0,0,0,1,1
Michalis Konstantinou,0,898.0,0,4,10,12,22
Michalis Kritikopoulos,0,80.0,0,0,0,1,1
Michalis Yasemis,0,118.0,0,1,1,1,2
Michaël Maria,2,36.0,0,0,0,2,2
Michał Żewłakow,0,93.0,1,2,3,0,3
Michel Bassolé,2,50.0,0,0,0,2,2
Michel Bouanga,0,127.0,0,0,2,0,2
Michel De Wolf,1,64.0,0,0,1,0,1
Michel Goba,0,75.0,0,0,1,0,1
Michel Hmaé,6,579.0,0,0,10,1,11
Michel Kira,0,26.0,0,0,1,0,1
Michel Minko,0,37.0,0,0,1,0,1
Michel Mézy,0,63.0,0,0,1,0,1
Michel Ngonge,0,60.0,0,0,1,1,2
Michel Platini,4,1336.0,0,3,17,10,27
Michel Reuter,0,88.0,0,0,0,1,1
Michel Valke,0,15.0,1,0,1,0,1
Michele Cevoli,0,96.0,2,0,2,0,2
Michele Polverino,0,128.0,0,0,3,0,3
Michy Batshuayi,3,537.0,0,1,4,6,10
Michél Mazingu-Dinzey,0,52.0,0,0,1,0,1
Mick Channon,0,343.0,0,1,3,3,6
Mick Martin,0,171.0,1,0,2,2,4
Mickaël Poté,2,101.0,0,0,1,2,3
Mickey Thomas,0,107.0,0,0,2,0,2
Mickey Trotman,1,101.0,0,0,0,1,1
Mickey Walsh,0,145.0,0,0,1,1,2
Mickey Weche,1,89.0,0,1,0,1,1
Mido,1,287.0,0,1,5,1,6
Miel Pijs,0,35.0,0,0,1,0,1
Miguel Aguilar,0,202.0,0,0,1,3,4
Miguel Almirón,1,112.0,0,1,1,1,2
Miguel Angel Lauri,1,28.0,0,0,1,0,1
Miguel Augusto Prince,0,133.0,0,0,3,0,3
Miguel Borja,1,254.0,0,2,5,0,5
Miguel Busquets,1,71.0,0,0,1,0,1
Miguel Camargo,1,123.0,0,0,1,2,3
Miguel Dellavalle,0,13.0,0,0,0,1,1
Miguel Echenausi,1,89.0,0,0,0,1,1
Miguel Estrada,0,3.0,0,0,0,1,1
Miguel Gandara,0,90.0,0,0,1,0,1
Miguel González,0,97.0,0,0,2,0,2
Miguel Layún,0,20.0,0,0,0,1,1
Miguel Martínez,1,57.0,0,0,1,0,1
Miguel María Michelagnoli,0,47.0,0,0,1,0,1
Miguel Mea Vitali,0,24.0,0,0,1,0,1
Miguel Mercado,1,78.0,0,0,0,1,1
Miguel Peredo,1,117.0,0,0,1,1,2
Miguel Pereira,1,86.0,0,0,1,0,1
Miguel Pérez,0,38.0,0,0,1,0,1
Miguel Sabah,4,263.0,0,0,5,0,5
Miguel Veloso,0,222.0,0,0,2,1,3
Miguel Villalta,1,27.0,0,0,0,1,1
Miguel Zepeda,1,283.0,0,0,3,2,5
Miguel Ángel Benítez,1,209.0,0,0,5,2,7
Miguel Ángel Brindisi,1,108.0,0,0,3,0,3
Miguel Ángel Bustillo,0,20.0,0,0,1,0,1
Miguel Ángel Gamboa,0,145.0,0,0,1,2,3
Miguel Ángel Loayza,4,136.0,0,0,3,2,5
Miguel Ángel Nadal,0,123.0,0,0,1,1,2
Miguel Ángel Neira,1,87.0,0,1,1,1,2
Miguel Ángel Noro,0,59.0,1,0,0,1,1
Miguel Ángel Ponce,1,90.0,0,0,0,1,1
Miguel Ángel Russo,0,27.0,0,0,1,0,1
Miha Mevlja,0,143.0,1,0,1,1,2
Miha Zajc,0,147.0,0,0,2,2,4
Mihai Pintilii,0,31.0,0,0,1,0,1
Mihail Aleksandrov,0,26.0,0,1,1,1,2
Mihail Lozanov,0,66.0,0,0,0,1,1
Mihail Titow,0,23.0,0,0,1,0,1
Mihails Zemļinskis,0,404.0,1,3,2,5,7
Mihal Gjika,0,15.0,0,0,1,0,1
Mihály Korhut,0,10.0,0,0,1,0,1
Mihály Kozma,0,9.0,0,0,1,0,1
Mihály Lantos,2,78.0,0,1,1,1,2
Miikka Toivola,0,60.0,0,0,1,1,2
Mijat Gaćinović,0,106.0,0,0,1,1,2
Mika Lipponen,0,238.0,0,0,2,3,5
Mika Nurmela,0,84.0,0,0,1,1,2
Mika Väyrynen,0,166.0,0,0,2,1,3
Mikael Forssell,0,930.0,0,2,16,4,20
Mikael Lustig,0,241.0,0,0,2,3,5
Mikael Nilsson,0,3.0,0,0,0,1,1
Mikalay Ryndzyuk,0,70.0,0,0,1,1,2
Mike England,0,171.0,0,0,2,1,3
Mike Hanke,0,88.0,0,0,1,0,1
Mike Havenaar,0,58.0,0,0,2,0,2
Mike Okoth Origi,0,344.0,0,0,5,1,6
Mike Ott,0,83.0,0,0,1,0,1
Mike Summerbee,0,9.0,0,0,1,0,1
Mikel John Obi,3,234.0,0,0,5,0,5
Mikel Oyarzabal,1,280.0,0,0,2,1,3
Mikel Villanueva,0,80.0,0,0,1,1,2
Mikhail Gordeichuk,0,96.0,0,0,2,0,2
Mikhail Sivakow,0,33.0,0,1,1,0,1
Mikheil Ashvetia,0,17.0,0,0,1,0,1
Mikheil Kavelashvili,0,52.0,0,0,1,0,1
Mikheil Meskhi,2,174.0,0,0,2,1,3
Mikkel Beck,0,54.0,0,0,1,1,2
Mikkel Damsgaard,0,119.0,0,0,3,1,4
Mikkel Diskerud,0,83.0,0,0,1,0,1
Miklos Molnar,0,129.0,0,0,2,0,2
Miklós Fehér,0,259.0,0,0,0,4,4
Miklós Kovács,1,89.0,0,0,0,1,1
Miku,2,336.0,0,0,3,2,5
Milad Meydavoudi,0,7.0,0,0,0,1,1
Milad Mohammadi,1,58.0,0,0,0,1,1
Milan Albrecht,0,30.0,0,0,1,0,1
Milan Badelj,1,85.0,0,0,0,2,2
Milan Baroš,5,1418.0,0,1,20,5,25
Milan Dolinský,0,180.0,0,0,2,1,3
Milan Dvořák,2,32.0,0,1,1,1,2
Milan Galić,4,623.0,0,0,5,12,17
Milan Jovanović,1,387.0,0,0,3,5,8
Milan Luhový,1,216.0,0,0,1,2,3
Milan Osterc,0,299.0,0,0,3,1,4
Milan Rapaić,2,177.0,0,2,3,1,4
Milan Ristovski,0,79.0,0,0,0,1,1
Milan Smiljanić,0,75.0,0,0,0,1,1
Milan Đurić,0,138.0,0,0,1,1,2
Milan Škoda,1,236.0,0,0,3,0,3
Milan Škriniar,1,272.0,2,0,4,1,5
Milciades Morel,0,137.0,0,0,2,1,3
Mile Jedinak,5,884.0,1,11,11,7,18
Mile Krstev,0,117.0,0,0,2,0,2
Mile Sterjovski,0,241.0,0,0,4,0,4
Milenko Ačimovič,1,466.0,0,1,9,0,9
Milenko Špoljarić,0,431.0,0,2,5,1,6
Miles Robinson,0,167.0,0,0,2,0,2
Milivoje Novaković,0,947.0,0,2,14,7,21
Milko Djurovski,0,29.0,0,0,0,1,1
Millan Baçi,0,18.0,0,0,1,0,1
Miller Bolaños,3,319.0,0,0,4,1,5
Millón Medeiros,0,24.0,0,1,1,0,1
Milot Rashica,0,38.0,0,0,0,2,2
Milovan Mirosevic,0,107.0,0,0,1,1,2
Miloš Krasić,0,49.0,0,0,1,1,2
Miloš Milutinović,1,128.0,0,0,3,1,4
Miloš Šestić,0,112.0,0,0,0,2,2
Milton Coimbra,0,198.0,0,0,2,1,3
Milton Karisa,0,11.0,0,0,0,1,1
Milton Meléndez,0,114.0,0,0,1,2,3
Milton Núñez,2,722.0,0,0,8,4,12
Milutin Pajević,0,57.0,0,0,3,0,3
Milyon Beguashaw,0,38.0,0,0,1,0,1
Mimi El-Sherbini,1,64.0,0,0,1,0,1
Mimis Domazos,0,91.0,0,0,1,1,2
Mimis Papaioannou,1,681.0,0,0,9,3,12
Mimoun Mahi,0,88.0,0,0,1,0,1
Mindaugas Kalonas,0,106.0,0,1,1,1,2
Minervino Pietra,0,65.0,0,0,1,0,1
Mini Jakobsen,0,133.0,0,0,2,2,4
Minor López,0,172.0,0,0,1,2,3
Minyahil Teshome,1,61.0,0,0,0,1,1
Miodrag Belodedici,0,42.0,0,0,1,0,1
Miodrag Ješić,0,66.0,0,0,1,0,1
Miralem Pjanić,1,543.0,0,2,8,4,12
Miralem Sulejmani,0,90.0,0,0,1,0,1
Miran Pavlin,1,130.0,0,0,0,2,2
Miranda,0,2.0,0,0,1,0,1
Mirbağır İsayev,0,73.0,0,0,1,0,1
Mircea Dridea,0,139.0,0,0,1,2,3
Mircea Lucescu,0,276.0,0,1,3,2,5
Mircea Sandu,0,90.0,0,0,2,0,2
Mirco Gennari,0,87.0,1,0,1,0,1
Mirdjalal Kasimov,0,71.0,0,0,1,0,1
Mirel Josa,0,69.0,0,0,1,0,1
Mirel Rădoi,0,25.0,0,0,0,1,1
Mirjalol Qosimov,7,747.0,0,1,7,8,15
Mirko Hrgović,0,64.0,0,0,0,2,2
Mirko Ivanovski,0,59.0,0,0,1,0,1
Mirko Palazzi,0,74.0,0,0,0,1,1
Mirko Vučinić,0,433.0,0,1,7,2,9
Mirlan Murzaev,3,297.0,0,1,0,6,6
Miro,0,52.0,0,0,1,0,1
Miroslav Baranek,0,12.0,0,0,0,1,1
Miroslav Chvíla,0,78.0,0,0,0,1,1
Miroslav Gajdůšek,0,149.0,0,0,0,2,2
Miroslav Gjokić,0,142.0,0,0,0,2,2
Miroslav Kadlec,0,82.0,0,0,2,0,2
Miroslav Karhan,0,463.0,0,1,7,2,9
Miroslav Klose,13,2316.0,0,0,29,19,48
Miroslav Pavlović,0,67.0,0,0,0,1,1
Miroslav Romaschenko,0,68.0,0,0,1,0,1
Miroslav Sovič,0,3.0,0,0,0,1,1
Miroslav Stevanović,0,84.0,0,0,0,1,1
Miroslav Stoch,0,149.0,0,0,2,1,3
Miroslav Đukić,1,91.0,0,0,1,1,2
Mirosław Szymkowiak,0,41.0,0,0,1,1,2
Mirosław Trzeciak,0,99.0,0,0,2,0,2
Mirsad Bešlija,0,41.0,0,0,0,1,1
Mirsad Hibić,0,29.0,1,0,0,1,1
Misagh Bahadoran,1,145.0,0,0,2,1,3
Mislav Oršić,2,127.0,0,0,2,0,2
Mitchell Duke,6,350.0,0,0,4,2,6
Mitchell Joseph,0,65.0,0,0,1,0,1
Mithun Chowdhury,0,52.0,0,0,1,0,1
Mitko Stojkovski,0,150.0,0,1,3,2,5
Mitsunori Yoshida,1,36.0,0,0,0,1,1
Mitsuo Ogasawara,0,106.0,0,0,2,1,3
Mixu Paatelainen,0,672.0,0,0,9,4,13
Mladen Bartolović,0,45.0,0,0,0,1,1
Mladen Krstajić,0,74.0,0,0,0,1,1
Mladen Mladenović,0,7.0,0,0,1,0,1
Mladen Petrić,0,432.0,0,0,6,4,10
Mladen Rudonja,0,55.0,0,0,0,1,1
Mladen Vasilev,0,37.0,0,0,0,1,1
Mo Johnston,1,422.0,0,1,7,3,10
Mo'ayyad Salim,0,70.0,0,0,1,0,1
Moayad Ajan,1,42.0,0,0,0,1,1
Mobarak Al-Faneeni,0,49.0,0,0,1,0,1
Moctar Sidi El Hacen,1,72.0,0,1,0,1,1
Moderato Wisintainer,2,110.0,0,0,0,2,2
Modeste Eta,0,64.0,0,0,0,1,1
Modeste M'Bami,2,107.0,0,0,2,0,2
Modestus Haas,0,60.0,1,0,1,0,1
Modibo Maïga,2,157.0,0,0,2,1,3
Modibo Sidibé,0,34.0,0,0,0,1,1
Mogakolodi Ngele,1,218.0,0,0,4,0,4
Mogens Berg,0,60.0,0,0,0,1,1
Mogogi Gabonamong,0,12.0,0,0,1,0,1
Mohaisen Al-Jam'an,1,207.0,0,0,3,0,3
Mohamad Kdouh,3,107.0,0,0,1,2,3
Mohamad Moustafa Kadir,1,193.0,0,2,2,1,3
Mohamad Yehya Al Rashed,0,76.0,0,0,1,0,1
Mohamadi Balma,0,27.0,1,0,1,0,1
Mohamadou Sumareh,0,220.0,0,0,2,2,4
Mohamadu Salisu,0,55.0,0,0,1,0,1
Mohamed Abdallah,0,68.0,0,0,0,1,1
Mohamed Abdel-Shafy,1,80.0,0,0,0,1,1
Mohamed Abdelmonem,1,35.0,0,0,1,0,1
Mohamed Abdelrahman,0,145.0,0,0,2,0,2
Mohamed Abdelwahab,0,88.0,0,0,0,1,1
Mohamed Abdulazeez,0,13.0,0,0,0,1,1
Mohamed Aboutrika,4,1238.0,0,4,10,10,20
Mohamed Ahmed,0,111.0,0,0,2,0,2
Mohamed Ahmed Bashir,2,106.0,0,0,2,0,2
Mohamed Akid,0,158.0,0,0,2,1,3
Mohamed Al Ghanodi,0,48.0,0,0,0,1,1
Mohamed Al Zeno,1,209.0,0,1,2,2,4
Mohamed Al-Diabaz,0,75.0,0,0,2,0,2
Mohamed Al-Romaihi,1,290.0,0,0,2,2,4
Mohamed Al-Shehhi,0,174.0,0,1,3,2,5
Mohamed Al-Suwaiyed Shehrani,1,82.0,0,0,0,1,1
Mohamed Ala'a,0,23.0,0,0,1,0,1
Mohamed Ali,0,46.0,0,0,1,0,1
Mohamed Ali Hamoud,0,37.0,0,0,1,0,1
Mohamed Ali Mahjoubi,0,178.0,0,0,3,0,3
Mohamed Ali Manser,1,70.0,0,0,1,0,1
Mohamed Amine Ben Amor,0,83.0,0,0,0,1,1
Mohamed Aoudou,0,176.0,0,0,2,0,2
Mohamed Barakat,1,179.0,0,0,3,1,4
Mohamed Bayo,2,123.0,0,0,1,1,2
Mohamed Boussati,0,30.0,0,0,1,0,1
Mohamed Brahimi,0,60.0,0,0,1,0,1
Mohamed Daima,0,71.0,0,0,0,1,1
Mohamed Dräger,0,31.0,0,0,1,0,1
Mohamed El Monir,0,126.0,0,0,0,2,2
Mohamed El Rabty,0,88.0,0,0,1,0,1
Mohamed El-Akad,0,42.0,0,0,1,0,1
Mohamed El-Sayed,0,72.0,0,0,2,0,2
Mohamed El-Seyagui,1,86.0,0,0,1,0,1
Mohamed Elneny,1,72.0,0,0,2,1,3
Mohamed Elyounoussi,0,340.0,0,0,2,4,6
Mohamed Emara,0,15.0,0,0,1,0,1
Mohamed Farouk,0,221.0,0,0,3,0,3
Mohamed Gasri,0,160.0,0,0,1,1,2
Mohamed Hameed,0,90.0,0,0,1,0,1
Mohamed Hassan Abdullah,2,159.0,0,0,1,1,2
Mohamed Hubail,1,308.0,0,0,3,2,5
Mohamed Husain,1,277.0,1,0,2,2,4
Mohamed Jameel,0,61.0,0,0,0,1,1
Mohamed Kaci-Saïd,0,67.0,0,0,0,1,1
Mohamed Kader,3,336.0,0,0,1,5,6
Mohamed Kallon,1,158.0,0,1,2,1,3
Mohamed Kamara,0,11.0,0,0,1,0,1
Mohamed Khalfi,0,70.0,0,0,2,0,2
Mohamed Konaté,2,139.0,0,0,0,2,2
Mohamed Koussa,0,49.0,0,0,1,0,1
Mohamed Latif,1,132.0,0,0,2,1,3
Mohamed Liban,0,21.0,0,0,0,1,1
Mohamed M'Changama,0,70.0,0,0,0,1,1
Mohamed Madih,0,58.0,0,0,1,0,1
Mohamed Magdy,0,9.0,0,2,2,0,2
Mohamed Maghfour,0,14.0,0,0,1,0,1
Mohamed Mesud,0,83.0,0,0,1,0,1
Mohamed Morsi Hussein,4,151.0,0,0,4,0,4
Mohamed Nagy,0,83.0,0,0,1,0,1
Mohamed Nazeeh,0,80.0,0,0,1,0,1
Mohamed Nizam,0,66.0,0,0,1,1,2
Mohamed Obaid,0,48.0,0,0,1,0,1
Mohamed Obaid Al-Zahiri,1,11.0,1,0,0,1,1
Mohamed Omer,0,127.0,0,0,2,1,3
Mohamed Rashid,1,69.0,0,0,1,1,2
Mohamed Salah,5,1026.0,0,3,9,10,19
Mohamed Salah Abo Greisha,0,77.0,0,0,1,0,1
Mohamed Salah Jedidi,2,168.0,0,0,2,2,4
Mohamed Salim,0,3.0,0,0,0,1,1
Mohamed Salmeen,1,113.0,1,0,1,2,3
Mohamed Samadi,0,50.0,0,0,1,0,1
Mohamed Shawky,1,178.0,0,0,1,2,3
Mohamed Sissoko,1,79.0,0,0,1,1,2
Mohamed Sylla,0,62.0,0,0,0,1,1
Mohamed Tayib Abdul Noor,0,83.0,0,0,1,0,1
Mohamed Timoumi,0,216.0,0,0,2,2,4
Mohamed Wonkoye,1,127.0,0,1,1,1,2
Mohamed Yattara,3,255.0,0,0,3,3,6
Mohamed Youssouf,0,72.0,0,0,0,1,1
Mohamed Zahid Hossain,0,22.0,0,0,1,0,1
Mohamed Zidan,5,253.0,0,0,3,3,6
Mohammad Afash,1,318.0,0,1,6,1,7
Mohammad Al Marmour,0,44.0,0,0,0,1,1
Mohammad Al-Sahlawi,3,1042.0,0,5,8,11,19
Mohammad Al-Shalhoub,3,371.0,0,1,9,0,9
Mohammad Alavi,0,38.0,0,0,0,1,1
Mohammad Hassan,1,74.0,0,0,0,1,1
Mohammad Hassan Ansarifard,0,50.0,0,0,0,1,1
Mohammad Ibrahim Hussain,0,27.0,0,0,0,1,1
Mohammad Jakalan,0,30.0,0,0,0,1,1
Mohammad Kassas,0,90.0,0,0,1,0,1
Mohammad Mohebi,0,132.0,0,0,2,0,2
Mohammad Muharam,1,140.0,0,0,2,1,3
Mohammad Nasuha,0,43.0,0,0,1,0,1
Mohammad Nosrati,1,138.0,0,0,1,1,2
Mohammad Nouri,1,83.0,0,0,0,1,1
Mohammad Omar,0,122.0,0,0,1,3,4
Mohammad Reza Khalatbari,0,174.0,0,0,1,2,3
Mohammad Sadeghi,0,89.0,0,0,1,0,1
Mohammad Sultan,1,25.0,0,0,0,1,1
Mohammad Umer,0,66.0,0,0,1,1,2
Mohammadou Idrissou,1,86.0,0,0,1,0,1
Mohammed Abdellaoue,0,163.0,0,1,1,1,2
Mohammed Abdul Ghani,0,44.0,0,0,0,1,1
Mohammed Abdul Noor,2,103.0,0,0,0,2,2
Mohammed Abduljawad,1,65.0,0,0,0,1,1
Mohammed Adolf Rishard,0,70.0,0,0,1,0,1
Mohammed Ahmed,0,52.0,0,0,1,0,1
Mohammed Al Balushi,1,8.0,0,0,0,1,1
Mohammed Al-Anbar,0,5.0,0,0,0,1,1
Mohammed Al-Attas,0,74.0,1,0,0,1,1
Mohammed Al-Fatil,1,37.0,0,0,1,0,1
Mohammed Al-Ghafri,1,22.0,0,0,0,1,1
Mohammed Al-Ghassani,0,70.0,0,0,0,1,1
Mohammed Al-Hardan,0,65.0,0,1,1,0,1
Mohammed Al-Hinai,0,202.0,0,0,0,3,3
Mohammed Al-Jaish,2,126.0,0,0,1,1,2
Mohammed Al-Khilaiwi,0,116.0,0,0,2,0,2
Mohammed Al-Musalami,1,90.0,0,0,1,0,1
Mohammed Al-Suwaiti,1,4.0,0,0,0,1,1
Mohammed Ali El Khider,1,33.0,1,0,1,0,1
Mohammed Boqshan,1,56.0,0,0,1,0,1
Mohammed Chaouch,1,158.0,0,0,5,1,6
Mohammed Diarra,0,81.0,0,0,1,0,1
Mohammed El Filali,0,91.0,0,0,2,0,2
Mohammed Gargo,1,214.0,0,1,3,0,3
Mohammed Ghaddar,0,427.0,0,2,3,4,7
Mohammed Gholam,1,61.0,0,0,1,0,1
Mohammed Jewel Rana,2,100.0,0,0,2,0,2
Mohammed Jumaa,0,90.0,0,0,1,0,1
Mohammed Karam,0,90.0,0,0,1,0,1
Mohammed Kasola,0,179.0,0,0,3,1,4
Mohammed Khalifa Al-Ammari,0,71.0,0,0,1,0,1
Mohammed Khamis Al-Araimi,0,200.0,0,0,3,1,4
Mohammed Kudus,2,107.0,0,0,1,2,3
Mohammed Lashaf,0,40.0,0,0,1,0,1
Mohammed Lawal,0,120.0,0,1,1,1,2
Mohammed Muntari,1,262.0,0,0,4,2,6
Mohammed Musa,0,210.0,0,0,3,1,4
Mohammed Noor,0,192.0,0,2,2,1,3
Mohammed Ouseb,0,161.0,0,1,2,0,2
Mohammed Razak,0,89.0,0,0,1,1,2
Mohammed Sahil,1,85.0,0,0,0,1,1
Mohammed Salem,0,44.0,0,0,1,0,1
Mohammed Salem Al-Enazi,4,671.0,0,0,12,4,16
Mohammed Salem Al-Mal,0,60.0,0,0,1,0,1
Mohammed Salim,0,85.0,0,0,0,1,1
Mohammed Salisu,1,24.0,0,0,0,1,1
Mohammed Sama,0,88.0,0,1,0,1,1
Mohammed Sangare,0,82.0,0,1,1,0,1
Mohammed Sujan,2,162.0,0,0,2,0,2
Mohammed Tayeb Al Alawi,0,77.0,0,0,2,0,2
Mohammed Zughair,0,30.0,0,0,0,1,1
Mohanad Ali,4,221.0,0,0,4,3,7
Mohanad Salem,0,16.0,0,0,1,0,1
Mohannad Abdul-Raheem,6,272.0,0,0,6,0,6
Mohd Aidil Zafuan Abdul Radzak,0,8.0,0,0,0,1,1
Mohd Amri Yahyah,0,19.0,0,0,0,1,1
Mohd Bunyamin Omar,0,45.0,0,0,0,1,1
Mohd Noor Ali,0,65.0,0,0,1,0,1
Mohd Rafi Ali,1,129.0,0,0,1,1,2
Mohd Safiq Rahim,0,68.0,0,0,1,1,2
Mohieddine Habita,0,119.0,0,1,2,0,2
Mohsen Garousi,0,144.0,0,0,2,1,3
Mohsen Khalili,0,90.0,0,0,0,1,1
Mohsen Labidi,1,36.0,0,0,1,0,1
Mohsen Qarawi,1,53.0,0,0,1,1,2
Mohsin Al-Khaldi,0,97.0,0,0,2,0,2
Mohsin Harthi,0,5.0,0,0,1,0,1
Mohsin Yousifi,0,10.0,0,0,1,0,1
Moise Adilehou,1,53.0,0,0,0,1,1
Moise Brou,0,81.0,0,0,1,0,1
Moise Kean,0,183.0,0,0,4,0,4
Moise Poida,1,55.0,0,0,0,1,1
Moisés Caicedo,1,171.0,0,0,2,1,3
Moisés Hernández,1,77.0,0,1,1,1,2
Moisés Villarroel,0,37.0,0,0,0,1,1
Moisés Villarroel Angulo,0,53.0,0,0,1,0,1
Mojtaba Jabbari,0,145.0,0,0,1,2,3
Mokhtar Dahari,1,50.0,0,0,0,1,1
Mokhtar Dhouieb,1,87.0,0,0,0,1,1
Mokhtar Kalem,1,125.0,0,0,2,0,2
Mokhtar Mokhtar,1,70.0,0,0,2,0,2
Molesi Tokuma,1,48.0,1,0,0,1,1
Momath Gueye,1,46.0,0,1,1,0,1
Momo Soumah,0,218.0,0,0,3,1,4
Momodou Ceesay,0,8.0,0,0,0,1,1
Momčilo Vukotić,0,44.0,0,0,2,0,2
Moncef Cherif,0,29.0,0,0,0,1,1
Moncef Khouini,0,62.0,0,0,1,0,1
Monduone N'Kama,0,23.0,0,0,1,0,1
Mone Wamowe,0,37.0,0,0,0,2,2
Mongi Delhoum,0,80.0,0,0,1,0,1
Mongkol Tossakrai,1,191.0,0,0,2,1,3
Monsef Zerka,1,74.0,0,0,0,1,1
Monès Chéry,1,85.0,0,1,0,2,2
Moon Jung-sik,0,110.0,0,0,2,0,2
Morciré Sylla,3,178.0,0,0,2,1,3
Mordechai Spiegler,4,449.0,0,1,6,3,9
Mordon Malitoli,1,87.0,0,0,0,1,1
Morgan Gould,0,14.0,0,0,0,1,1
Morten Bisgaard,0,48.0,0,0,0,1,1
Morten Gamst Pedersen,0,426.0,0,0,4,3,7
Morten Nordstrand,0,128.0,0,0,2,1,3
Morten Rasmussen,0,129.0,0,0,3,0,3
Morten Wieghorst,0,147.0,0,0,0,2,2
Morteza Pouraliganji,2,173.0,0,0,2,1,3
Mory Koné,0,39.0,0,0,1,0,1
Moses Chavula,0,220.0,1,0,1,2,3
Moses Chikwalakwala,0,50.0,0,0,0,2,2
Moses Msereko,1,32.0,0,0,0,1,1
Moses Ramafole,0,64.0,0,0,0,1,1
Moses Simon,1,127.0,0,0,2,1,3
Moses Simwala,0,204.0,0,0,2,1,3
Moses Toata,1,89.0,0,0,1,0,1
Moshe Leon,0,20.0,0,0,1,0,1
Moshe Onana,5,336.0,0,0,5,0,5
Moshe Romano,3,123.0,0,0,2,1,3
Moshe Selecter,0,75.0,0,0,1,0,1
Moshe Sinai,0,56.0,0,0,0,1,1
Mostafa Mohamed,0,135.0,0,0,0,2,2
Mostafa Taha,0,100.0,0,0,2,0,2
Motasem Sabbou,0,87.0,0,0,0,1,1
Mothobi Mvala,0,71.0,0,0,0,1,1
Motohiro Yamaguchi,0,67.0,0,0,1,0,1
Mouagi,1,90.0,0,0,0,1,1
Mouhanad Boushi,0,163.0,0,0,3,0,3
Moulay Khanousi,1,27.0,0,0,0,1,1
Moumi Ngamaleu,0,61.0,0,1,0,1,1
Moumouni Dagano,2,1008.0,0,2,10,9,19
Mounir Diane,0,46.0,0,0,1,0,1
Mounir El Hamdaoui,0,83.0,0,0,1,0,1
Mourad Meziane,0,155.0,0,0,2,0,2
Mouritala Ogunbiyi,0,98.0,0,0,2,0,2
Mousa Dembélé,0,315.0,0,0,5,0,5
Moussa Badiane,0,83.0,0,0,2,0,2
Moussa Camara,1,8.0,0,0,1,0,1
Moussa Diakhité,1,42.0,0,0,0,1,1
Moussa Djenepo,0,19.0,0,0,0,1,1
Moussa Doumbia,1,85.0,0,0,1,0,1
Moussa Hirir,0,85.0,0,0,0,1,1
Moussa Hojeij,0,277.0,0,0,3,1,4
Moussa Kanfideni,0,82.0,0,0,1,1,2
Moussa Konaté,0,53.0,0,0,1,0,1
Moussa Latoundji,1,90.0,0,0,0,1,1
Moussa Mallam,0,20.0,0,0,0,1,1
Moussa Marega,1,45.0,0,1,1,0,1
Moussa Maâzou,2,169.0,0,1,2,2,4
Moussa N'Dao,1,56.0,0,0,0,1,1
Moussa N'Diaye,0,248.0,0,0,2,2,4
Moussa Samba,0,84.0,0,0,1,0,1
Moussa Saïb,0,125.0,0,1,1,1,2
Moussa Sissako,0,36.0,1,0,0,1,1
Moussa Sissoko,1,73.0,0,0,0,1,1
Moussa Sow,4,424.0,0,1,4,2,6
Moussa Traoré,2,159.0,0,0,0,2,2
Moussa Wagué,1,71.0,0,0,0,1,1
Moussa Yahaya,0,112.0,0,0,2,0,2
Moustafa Abdou,2,155.0,0,0,6,0,6
Moustapha Bangura,0,20.0,0,0,1,0,1
Moustapha Bayal Sall,1,45.0,0,0,0,1,1
Moustapha Choukri,0,179.0,0,0,1,2,3
Moustapha Salifou,1,215.0,0,0,4,2,6
Moysés Ferreira Alves,1,80.0,0,0,1,0,1
Mrisho Ngassa,0,11.0,0,0,0,1,1
Mthunzi Mkhontfo,0,45.0,0,0,0,1,1
Mu Kanazaki,0,98.0,0,0,1,1,2
Mu'nas Dabbur,0,497.0,0,1,8,3,11
Muayad Al-Haddad,1,26.0,0,0,0,1,1
Mubarak Anber,1,47.0,1,0,0,1,1
Mubarak Mustafa,3,613.0,0,2,8,3,11
Mubarak Wakaso,4,331.0,0,3,6,2,8
Muda Lawal,1,71.0,0,0,2,1,3
Mudashiru Lawal,2,166.0,0,0,1,2,3
Mudather El Tahir,2,161.0,0,1,4,0,4
Muhadjiri Hakizimana,0,111.0,0,0,1,1,2
Muhamad El-Basheer El-Asyad,0,185.0,0,0,2,0,2
Muhamed Konjić,0,37.0,0,0,1,1,2
Muhamed Mujić,0,203.0,0,0,2,2,4
Muhammad Arshad,2,29.0,0,0,1,1,2
Muhammad Ilham,0,30.0,0,0,0,1,1
Muhammad Ridwan,0,76.0,0,0,1,0,1
Muhammet Akagündüz,0,88.0,0,0,0,1,1
Muhannad El Tahir,0,103.0,0,1,2,0,2
Muhedin Targaj,0,213.0,0,2,2,1,3
Muhsen Al-Ghassani,2,250.0,0,1,3,1,4
Muhsin Musabah,0,26.0,1,0,1,0,1
Mujahid Ahmed,0,231.0,0,0,2,1,3
Mukhsin Mukhamadiev,0,80.0,0,0,1,0,1
Mulugeta Kebede,0,99.0,0,0,1,1,2
Mumamba Numba,0,136.0,0,0,0,2,2
Mumba Mwila,0,42.0,0,0,0,1,1
Mun In-Guk,0,118.0,0,0,2,0,2
Munaf Ramadan,0,12.0,0,0,1,0,1
Munif Shaef Noman,0,50.0,0,0,1,0,1
Munir El Haddadi,0,82.0,0,0,1,0,1
Munther Abu Amarah,0,33.0,0,0,0,1,1
Munthir Khalaf,1,152.0,0,0,0,2,2
Murad Alyan,1,117.0,0,0,2,1,3
Murad Hüseynov,0,89.0,0,0,1,0,1
Murat Yakin,0,134.0,0,0,1,2,3
Murray Barnes,0,56.0,0,0,1,1,2
Murtaz Khurtsilava,0,73.0,0,0,2,0,2
Musa Al-Taamari,1,26.0,0,0,1,0,1
Musa Barrow,2,161.0,0,1,1,1,2
Musa Noah Kamara,1,55.0,0,0,0,1,1
Musa Otieno,0,183.0,0,0,2,1,3
Musa Shannon,0,89.0,0,0,0,1,1
Musab Al-Battat,0,9.0,0,0,0,1,1
Musaed Neda,0,202.0,0,0,2,2,4
Muslim Agaev,0,136.0,0,0,0,3,3
Mussab Al-Laham,0,30.0,0,0,1,0,1
Mussad Nur,1,38.0,0,0,1,0,1
Mustafa Denizli,0,25.0,0,0,0,1,1
Mustafa El Haddaoui,0,62.0,0,0,2,0,2
Mustafa Ertan,1,21.0,0,0,0,1,1
Mustafa Karim,1,48.0,0,0,1,0,1
Mustafa Shehdeh,0,90.0,0,0,1,0,1
Mustafa Zazai,1,128.0,0,0,1,1,2
Mustamu Yessy,0,67.0,0,0,0,1,1
Mustapha Hadji,2,229.0,0,0,2,2,4
Mustapha Jarju,0,112.0,0,0,2,1,3
Mustapha Merry,0,242.0,0,1,3,1,4
Mustapha Tahir,1,62.0,0,0,0,2,2
Mustapha Yaghcha,0,25.0,0,1,0,1,1
Mustapha Yatabaré,0,90.0,0,0,0,1,1
Mustaqim,0,60.0,0,0,1,0,1
Mutaz Kablan,0,45.0,0,0,2,0,2
Muteba N'Daye,0,169.0,0,0,2,1,3
Mutiu Adepoju,4,204.0,0,0,2,3,5
Mwape Miti,0,85.0,0,0,1,0,1
Mwepu Ilunga,0,41.0,1,0,1,0,1
Mxolisi Lukhele,0,84.0,0,0,0,1,1
Myer Bevan,0,14.0,0,0,0,1,1
Mykola Shaparenko,0,44.0,0,0,1,0,1
Myles Weston,0,72.0,0,1,1,0,1
Myron Boadu,0,87.0,0,0,1,0,1
Myron Samuel,0,145.0,0,1,2,2,4
Myrto Uzuni,0,165.0,0,0,1,1,2
Mágico González,0,277.0,0,0,4,2,6
Márcio Amoroso,4,179.0,0,0,3,1,4
Márcio Roberto dos Santos,1,66.0,0,0,1,0,1
Márcio Santos,1,54.0,0,0,1,0,1
Mário Coluna,0,328.0,0,0,5,1,6
Mário Fernandes,0,310.0,0,0,2,2,4
Mário Moínhos,0,87.0,0,0,0,1,1
Mário Zagallo,1,124.0,0,0,1,1,2
Márton Esterházy,1,118.0,0,0,2,1,3
Máté Fenyvesi,0,101.0,0,0,1,2,3
Máté Pátkai,0,156.0,0,0,2,0,2
Máximo Alcócer,2,576.0,0,0,11,0,11
Máximo Mosquera,3,278.0,0,0,3,3,6
Máximo Rolón,6,306.0,0,1,3,4,7
Máximo Tenorio,0,65.0,0,0,1,0,1
Mërgim Mavraj,0,81.0,1,0,1,1,2
Mërgim Vojvoda,0,105.0,1,0,2,0,2
Míchel,5,724.0,1,7,10,7,17
Müller,4,205.0,0,0,5,0,5
Mārcis Ošs,0,65.0,0,0,1,0,1
Māris Verpakovskis,1,952.0,0,1,9,14,23
N'Kiambi Mapuata,0,56.0,0,0,2,0,2
Na Sang-ho,0,13.0,0,0,0,1,1
Nabeel Mubar Al Siyabi,0,98.0,0,0,2,0,2
Nabil Al-Siyabi,1,74.0,0,0,0,1,1
Nabil Ashoor,0,27.0,1,0,0,1,1
Nabil Baha,1,90.0,0,0,1,0,1
Nabil Bentaleb,1,148.0,0,0,0,2,2
Nabil Dirar,0,24.0,0,0,0,1,1
Nabil El Zhar,0,49.0,0,0,1,0,1
Nabil Ghilas,0,78.0,0,0,0,1,1
Nabil Maâloul,0,85.0,0,1,2,0,2
Nabil Nano,1,65.0,0,0,1,0,1
Nabil Taïder,0,24.0,0,0,0,1,1
Naby Keïta,2,199.0,0,0,3,2,5
Naby Laye Camara,0,52.0,0,1,1,0,1
Naby Soumah,1,86.0,0,0,0,1,1
Nacer Bouiche,1,44.0,0,0,1,0,1
Nacer Chadli,1,352.0,0,0,4,2,6
Nacho,1,58.0,0,0,0,1,1
Nacho Monreal,0,84.0,0,0,1,0,1
Nader Joukhadar,2,191.0,0,0,3,2,5
Nader Kara,0,168.0,0,0,2,1,3
Nader Matar,0,64.0,0,0,1,0,1
Nadir Belhadj,0,45.0,0,0,1,0,1
Naea Bennett,4,209.0,0,0,0,4,4
Naeem Saddam,2,134.0,0,0,1,1,2
Naeim Saadavi,1,38.0,0,0,0,1,1
Nahki Wells,2,419.0,0,2,5,2,7
Nahuel Molina,1,35.0,0,0,0,1,1
Nahum Stelmach,4,422.0,0,0,8,1,9
Naif Hazazi,1,350.0,0,0,2,3,5
Naiz Hassan,0,90.0,0,0,1,0,1
Najeh Braham,0,132.0,0,0,1,1,2
Najwan Ghrayib,0,157.0,0,0,1,1,2
Naldo Kwasie,0,81.0,0,0,1,0,1
Nam Song-Chol,0,61.0,0,0,0,1,1
Nam Tae-hee,1,234.0,0,0,3,1,4
Nana Arhin Duah,0,81.0,0,0,2,0,2
Nando Maria Neves,1,33.0,1,0,0,1,1
Nang Yan Leung,0,75.0,0,0,0,2,2
Nani,5,557.0,0,0,10,6,16
Naohiro Takahara,9,360.0,0,0,6,4,10
Naoki Soma,2,135.0,0,0,1,1,2
Narasek Boongeang,0,76.0,0,0,0,1,1
Narcisse Yaméogo,0,90.0,0,0,1,0,1
Narender Thapa,0,89.0,0,0,1,0,1
Narubadin Weerawatnodom,1,5.0,0,0,1,0,1
Nasema,1,85.0,0,0,1,0,1
Naser Al-Sauhi,1,72.0,0,0,0,1,1
Nashat Akram,4,415.0,0,1,3,6,9
Nasir Khamees,0,10.0,0,0,1,0,1
Nasir Khamees Mubarak,0,38.0,0,0,1,0,1
Nasko Sirakov,2,640.0,0,0,8,6,14
Nasr Eddin Abbas,4,420.0,0,0,2,4,6
Nasr El-Din Abbas,0,66.0,0,0,1,1,2
Nasreddine Kraouche,1,90.0,0,0,0,1,1
Nasser Al-Gahwashi,1,85.0,0,0,1,0,1
Nasser Al-Shamrani,0,368.0,0,0,5,2,7
Nasser Bouiche,1,94.0,0,0,2,0,2
Nasser Kamil Mubarak,0,42.0,0,0,0,1,1
Nasser Khaleefa,0,90.0,0,0,0,1,1
Nasser Mohammadkhani,3,224.0,0,0,2,1,3
Nasser Nouraei,0,127.0,0,0,3,0,3
Nasser Zayid,0,62.0,0,1,1,0,1
Nassim Akrour,1,214.0,0,0,3,1,4
Nassir Al-Ghanem,0,130.0,0,0,2,0,2
Nassoro Mashoto,0,58.0,0,0,1,0,1
Nastja Čeh,0,181.0,0,0,4,1,5
Nat Lofthouse,3,323.0,0,0,2,4,6
Nate Burkey,0,50.0,0,0,0,1,1
Nathalie Suiverstin,0,18.0,0,0,1,0,1
Nathan Aké,0,19.0,0,0,1,0,1
Nathan Blake,0,159.0,0,0,2,2,4
Nathan Burns,0,183.0,0,0,3,0,3
Nathan Fasika,0,66.0,0,0,0,1,1
Nathan Patterson,0,38.0,0,0,0,1,1
Nathan Pond,1,39.0,0,0,1,0,1
Nathan Sinkala,0,71.0,0,0,0,1,1
Nathaniel Lepani,0,55.0,0,0,0,1,1
Natia Natia,1,39.0,0,0,1,0,1
Natipong Sritong-In,0,122.0,0,0,1,1,2
Natiq Hashim,0,85.0,0,0,1,0,1
Nauris Bulvītis,0,20.0,0,0,1,0,1
Nawaf Al-Abed,3,428.0,0,4,2,4,6
Nawaf Al-Temyat,3,304.0,0,1,1,3,4
Nawaf Humaidan,0,70.0,0,0,0,1,1
Nawaf Mubarak,0,90.0,0,0,1,0,1
Nawayug Shrestha,1,80.0,0,0,1,0,1
Nayef Aguerd,2,131.0,2,0,3,0,3
Nayef Mubarak Al Khater,0,75.0,0,0,1,0,1
Nazar Ashraf,1,34.0,0,0,1,0,1
Nazar Bayramov,1,6.0,0,0,0,1,1
Nazar Baýramow,0,83.0,0,0,2,0,2
Nazim Suleymanov,1,198.0,0,2,2,1,3
Nazir McBurnette,0,90.0,0,0,0,1,1
Naïm Sliti,3,165.0,0,1,0,3,3
Nchimunya Mweetwa,0,114.0,0,0,0,2,2
Ndaye Mulamba,8,554.0,0,0,4,6,10
Ndubuisi Okosieme,1,33.0,0,0,0,1,1
Necati Ateş,0,55.0,0,2,2,0,2
Neco,2,280.0,0,0,7,1,8
Neco Williams,0,20.0,0,0,1,0,1
Ned Zelić,0,63.0,0,0,3,0,3
Nedim Doğan,0,48.0,0,0,1,0,1
Nedžmedin Memedi,0,60.0,0,0,0,1,1
Neeskens Kebano,1,154.0,0,0,1,2,3
Neftali Díaz,0,70.0,0,0,1,0,1
Neider Morantes,3,73.0,0,0,3,0,3
Neil Danns,3,314.0,0,3,4,1,5
Neil Jones,1,72.0,0,0,1,0,1
Neil Lennon,0,92.0,0,0,2,0,2
Neil McCann,0,157.0,0,0,1,2,3
Neil Paynter,0,66.0,0,0,0,1,1
Neil Slatter,0,68.0,0,0,0,1,1
Neil Taylor,1,20.0,0,0,0,1,1
Neil Webb,0,171.0,0,0,2,0,2
Nejc Pečnik,0,337.0,0,0,1,3,4
Nelinho,2,172.0,0,1,5,0,5
Nelson Abeijon,0,83.0,0,0,1,0,1
Nelson Barahona,1,202.0,0,0,2,1,3
Nelson Bonilla,3,490.0,0,0,3,6,9
Nelson Cuevas,3,235.0,0,0,1,2,3
Nelson Gabolwelwe,0,69.0,0,0,2,0,2
Nelson Luís Kerchner,1,72.0,0,0,1,0,1
Nelson Melgar,0,88.0,0,0,1,0,1
Nelson Moreno,1,30.0,0,0,0,1,1
Nelson Peña,0,73.0,0,0,1,0,1
Nelson Pérez,1,27.0,0,0,1,0,1
Nelson Sale,0,21.0,1,0,0,1,1
Nelson Valdez,2,365.0,0,0,4,4,8
Nemanja Matić,0,144.0,0,0,0,2,2
Nemanja Nikolić,0,214.0,0,1,1,2,3
Nemanja Radonjić,0,125.0,0,0,1,1,2
Nemesio Mosquera,1,54.0,0,0,0,2,2
Nemesio Rojas,1,77.0,0,0,1,0,1
Nenad Jestrović,0,98.0,0,0,0,2,2
Nenad Milijaš,0,19.0,0,2,2,0,2
Nenad Stojković,0,36.0,0,0,0,1,1
Nené,1,493.0,0,0,6,6,12
Nermin Šabić,0,69.0,0,0,1,0,1
Nery Castillo,5,225.0,0,2,4,2,6
Nery Medina,0,52.0,0,0,0,1,1
Nesley Jean,0,160.0,0,0,1,2,3
Nestor Subiat,0,158.0,0,0,0,2,2
Nestoras Mitidis,0,152.0,0,0,1,3,4
Neto,1,5.0,0,1,0,1,1
Neven Subotić,0,69.0,0,0,0,1,1
Ney Avilés,3,324.0,0,0,3,3,6
Neymar,7,1504.0,0,8,24,7,31
Ng Chi Kit,0,44.0,1,0,0,1,1
Ng Wai Chiu,0,17.0,0,0,0,1,1
Ngasanya Ilongo,0,58.0,0,0,1,0,1
Ngidi Yemweni,0,328.0,0,0,4,1,5
Nguyen Cong Vinh,0,71.0,0,0,0,1,1
Nguyen Hong Son,1,30.0,0,0,0,1,1
Nguyễn Công Phượng,3,160.0,0,0,1,2,3
Nguyễn Hồng Sơn,5,241.0,0,2,2,3,5
Nguyễn Lương Phúc,2,90.0,0,0,2,0,2
Nguyễn Minh Hải,0,13.0,0,0,1,0,1
Nguyễn Ngọc Thanh,0,67.0,0,0,1,0,1
Nguyễn Quang Hải,2,241.0,0,0,4,2,6
Nguyễn Thanh Bình,0,19.0,0,0,0,1,1
Nguyễn Tiến Linh,3,413.0,0,0,3,5,8
Nguyễn Trung Vĩnh,1,77.0,0,0,0,1,1
Nguyễn Trọng Hoàng,0,60.0,0,0,1,0,1
Nguyễn Vinh Quang,1,54.0,1,0,0,1,1
Nguyễn Văn Quyết,0,89.0,0,0,1,0,1
Nguyễn Văn Sỹ,1,65.0,0,0,0,1,1
Nguyễn Văn Toàn,0,71.0,0,0,2,0,2
Nguyễn Văn Tu,0,70.0,0,0,0,1,1
Niall McGinn,1,310.0,0,0,1,4,5
Niall Quinn,1,646.0,0,0,10,4,14
Niall Reid-Stephen,0,42.0,0,0,0,1,1
Nian Weisi,0,9.0,0,0,1,0,1
Nicaise Ondeno,0,32.0,0,0,1,0,1
Nicaise Zimbori-Auzingoni,0,79.0,0,0,0,2,2
Nicholas Gioacchini,0,90.0,0,0,1,0,1
Nicholas Ioannou,0,98.0,0,0,0,2,2
Nick Dasovic,1,166.0,1,0,2,1,3
Nick Deacy,0,135.0,0,0,2,0,2
Nick Papadakis,0,100.0,0,0,2,0,2
Nicki Bille Nielsen,0,84.0,0,0,1,0,1
Nicklas Bendtner,3,936.0,0,1,9,8,17
Nicko Williams,0,67.0,1,0,0,1,1
Nicky Barmby,0,24.0,0,0,0,1,1
Nicky Saliba,1,6.0,0,0,0,1,1
Niclas Alexandersson,1,261.0,0,0,3,2,5
Niclas Füllkrug,2,172.0,0,0,0,2,2
Niclas Nyhlén,0,90.0,0,0,1,0,1
Nico Braun,0,122.0,0,1,4,1,5
Nico Claesen,3,580.0,0,1,5,6,11
Nico Schulz,0,90.0,0,0,0,1,1
Nico Van Kerckhoven,0,28.0,0,0,1,0,1
Nicodème Kabamba,2,78.0,0,1,0,2,2
Nicola Albani,0,59.0,0,0,0,1,1
Nicola Bacciocchi,0,53.0,0,0,0,1,1
Nicola Nanni,0,48.0,0,0,1,0,1
Nicolae Dică,0,200.0,0,1,2,2,4
Nicolae Dobrin,0,211.0,0,0,4,2,6
Nicolae Georgescu,0,56.0,0,0,1,1,2
Nicolae Josan,0,43.0,0,0,1,1,2
Nicolae Lupescu,0,46.0,0,0,1,1,2
Nicolae Milinceanu,0,140.0,0,0,1,1,2
Nicolae Mitea,0,76.0,0,0,0,2,2
Nicolae Oaidă,0,62.0,0,0,1,0,1
Nicolae Pantea,0,55.0,0,0,1,0,1
Nicolae Stanciu,0,112.0,0,0,0,2,2
Nicolae Tătaru,0,66.0,0,0,2,0,2
Nicolae Ungureanu,0,48.0,0,0,1,0,1
Nicolai Jørgensen,0,166.0,0,0,1,2,3
Nicolas Anelka,0,495.0,0,0,4,5,9
Nicolas Hasler,0,61.0,0,0,0,1,1
Nicolas Hoffmann,0,83.0,0,0,1,0,1
Nicolas Lombaerts,0,89.0,0,0,1,0,1
Nicolas Nkoulou,1,59.0,0,0,0,1,1
Nicolas Pépé,3,121.0,0,0,3,0,3
Nicolas Vallar,3,47.0,1,2,2,1,3
Nicolás Falero,7,376.0,0,0,0,9,9
Nicolás González,0,92.0,0,0,2,1,3
Nicolás Lodeiro,2,165.0,0,0,3,1,4
Nicolás Martínez,0,6.0,0,0,1,0,1
Nicolás Olivera,2,282.0,0,1,3,3,6
Nicolás Otamendi,1,89.0,0,0,1,1,2
Nicolás Ramírez,0,78.0,1,0,1,1,2
Nicolás Suazo,0,359.0,0,0,5,3,8
Nicolás Tellez,0,34.0,0,0,1,0,1
Nicolò Barella,1,90.0,0,0,2,2,4
Nicolò Zaniolo,0,73.0,0,0,2,0,2
Nicos Kantzilieris,0,47.0,0,0,0,1,1
Nicușor Bancu,0,87.0,0,0,0,1,1
Niel Hans,1,89.0,0,1,1,0,1
Niels Tune-Hansen,0,19.0,0,0,0,1,1
Nigel Bishop,0,34.0,0,0,1,0,1
Nigel Codrington,0,84.0,0,0,1,0,1
Nigel Dabinyaba,0,259.0,0,0,4,0,4
Nigel Hasselbaink,4,307.0,0,0,4,3,7
Nigel Pierre,0,164.0,0,1,2,1,3
Nigel de Jong,0,8.0,0,0,0,1,1
Niginho,2,134.0,0,0,2,0,2
Nihad Al Boushi,0,166.0,0,0,4,0,4
Nihad Boshi,1,244.0,0,0,2,2,4
Nihat Kahveci,3,699.0,0,0,6,6,12
Nihat Yayöz,0,83.0,0,0,0,1,1
Nik Viljoen,0,80.0,0,0,1,0,1
Nika Kacharava,0,6.0,0,0,1,0,1
Niki Temiha,1,4.0,0,0,0,1,1
Niki Zimling,0,83.0,0,0,0,1,1
Nikica Jelavić,1,112.0,0,0,1,1,2
Nikita Naumov,0,48.0,0,0,0,1,1
Nikita Simonyan,2,121.0,0,0,1,4,5
Niklas Moisander,0,77.0,0,0,1,0,1
Niko Kata,1,75.0,1,0,1,0,1
Niko Kovač,2,307.0,0,0,5,3,8
Niko Kranjčar,0,468.0,0,1,3,7,10
Nikodimos Papavasiliou,0,143.0,0,0,1,2,3
Nikola Drinčić,0,27.0,0,0,1,0,1
Nikola Jerkan,0,58.0,0,0,1,0,1
Nikola Jurčević,0,55.0,0,0,0,1,1
Nikola Kalinić,2,432.0,0,0,6,1,7
Nikola Kotkov,0,199.0,0,1,6,0,6
Nikola Lazetić,1,52.0,0,0,1,0,1
Nikola Milenković,0,245.0,1,0,3,0,3
Nikola Tsanev,0,61.0,0,0,2,0,2
Nikola Vlašić,0,217.0,0,0,2,3,5
Nikola Vujnović,0,86.0,0,0,1,0,1
Nikola Vukčević,0,59.0,0,0,1,0,1
Nikola Žigić,1,869.0,0,0,9,5,14
Nikolai Pisarev,0,72.0,0,0,1,0,1
Nikolaos Karelis,0,24.0,0,0,0,1,1
Nikolas Ledgerwood,0,53.0,0,0,1,0,1
Nikolay Bodurov,0,79.0,1,0,0,2,2
Nikolay Iliev,0,84.0,0,0,1,0,1
Nikolay Komlichenko,0,78.0,0,0,0,1,1
Nikolay Larionov,0,86.0,0,0,1,0,1
Nikolay Shirshov,0,257.0,0,0,4,2,6
Nikolay Todorov,0,198.0,0,0,1,2,3
Nikoloz Gelashvili,1,9.0,0,0,0,1,1
Nikolče Noveski,0,107.0,0,0,1,2,3
Nikos Anastopoulos,1,515.0,0,1,8,5,13
Nikos Charalambous,0,42.0,0,0,1,0,1
Nikos Liberopoulos,0,404.0,0,0,4,2,6
Nikos Machlas,0,669.0,0,1,8,3,11
Nikos Nioplias,0,49.0,0,0,1,0,1
Nikos Pantziaras,0,93.0,1,0,2,0,2
Nikos Patikkis,0,58.0,1,0,0,1,1
Nikos Spyropoulos,0,188.0,1,0,1,2,3
Nikos Tsiantakis,0,37.0,0,0,1,0,1
Nildeson,0,123.0,0,0,2,1,3
Nilmar,0,300.0,0,0,4,1,5
Nilo Braga,3,228.0,0,0,2,4,6
Nils Liedholm,0,130.0,0,1,3,0,3
Nils Rikberg,0,70.0,0,0,1,0,1
Nils-Åke Sandell,0,165.0,0,0,2,2,4
Nininho,0,141.0,0,0,3,0,3
Nir Bitton,0,131.0,0,0,2,1,3
Nir Klinger,0,37.0,0,0,0,1,1
Nir Sivilia,0,84.0,0,0,1,0,1
Nirajan Rayamajhi,6,310.0,0,0,2,5,7
Nirut Surasiang,0,114.0,0,0,0,2,2
Nissim Cohen,0,67.0,0,0,1,0,1
Nitder Pizzani,0,94.0,0,0,2,0,2
Nitsavong Khouphachansy,0,135.0,1,0,0,2,2
Niwat Srisawat,2,124.0,0,0,1,1,2
Niweat Siriwong,0,168.0,0,0,2,0,2
Nizar Khalfan,0,19.0,0,0,0,1,1
Nizar Mahrous,1,363.0,0,0,3,3,6
Njiva Rakotoharimalala,0,135.0,0,0,3,1,4
Njogu Demba-Nyrén,0,90.0,0,0,2,0,2
Nkau Lerotholi,0,50.0,1,0,0,1,1
Nkiere Wawa,0,61.0,0,0,1,0,1
Nnamdi Oduamadi,3,202.0,0,0,1,3,4
Noah Frick,0,80.0,0,0,0,1,1
Noah Frommelt,0,83.0,1,0,0,1,1
Noah Hickey,0,130.0,0,0,2,0,2
Noah Okafor,0,48.0,0,0,1,0,1
Noel Barkley,0,57.0,0,0,1,0,1
Noel Berry,3,321.0,0,0,6,1,7
Noel Brotherston,0,24.0,0,0,1,0,1
Noel Cantwell,0,406.0,0,2,5,1,6
Noel Mkandawire,0,230.0,0,0,3,1,4
Noel Valladares,1,48.0,1,0,1,0,1
Noh Alam Shah,1,197.0,0,0,1,2,3
Noh Jung-yoon,1,143.0,0,0,2,0,2
Noh Soo-Jin,0,176.0,0,0,1,2,3
Nolberto Molina,0,60.0,0,1,1,0,1
Nolberto Solano,1,439.0,0,2,5,4,9
Nolito,1,100.0,0,0,1,1,2
Nontapan Jeansatawong,0,10.0,0,0,1,0,1
Norbert Eschmann,0,81.0,0,0,1,0,1
Norbert Hof,0,85.0,0,0,1,0,1
Norbert Owona,0,101.0,0,0,1,1,2
Norberto Conde,0,61.0,0,0,0,1,1
Norberto Doroteo Méndez,10,667.0,0,0,15,2,17
Norberto Maurito,1,86.0,0,0,1,0,1
Norberto Menéndez,1,173.0,0,0,3,1,4
Norfran Lazo,0,63.0,0,0,1,0,1
Norio Omura,1,86.0,0,0,0,2,2
Norival Pereira Da Silva,1,63.0,0,0,1,0,1
Norjmoogiin Tsedenbal,0,113.0,0,2,2,1,3
Norlla Amiri,2,122.0,0,0,1,1,2
Norm McLeod,0,32.0,0,0,1,0,1
Norman Forde,0,35.0,0,0,0,1,1
Norman Hunter,0,122.0,0,0,1,1,2
Norman Lockhart,0,72.0,0,1,1,0,1
Norman Patterson,0,79.0,0,0,1,0,1
Norman Whiteside,1,331.0,0,0,5,2,7
Norshahrul Idlan,0,43.0,0,0,1,0,1
Noud van Melis,0,97.0,0,0,1,2,3
Noureddine Naybet,0,24.0,0,0,1,0,1
Nourken Mazbaev,0,57.0,0,0,1,1,2
Nourredine Kourichi,0,53.0,0,0,1,0,1
Novatus Dismas,0,26.0,0,0,1,0,1
Nowend Lorenzo,2,71.0,0,0,0,2,2
Noël Birindi Minga,1,112.0,0,0,1,1,2
Noël Kouamé,0,59.0,0,0,1,1,2
Noël Minga,0,88.0,0,0,1,0,1
Nqobizitha Ncube,0,20.0,0,0,1,0,1
Nsumbu Ngoy,0,55.0,0,0,0,1,1
Numon Khasanov,0,45.0,0,0,1,1,2
Numondzhon Khakimov,0,280.0,0,2,3,2,5
Nuno Gomes,9,1007.0,0,0,7,11,18
Nuno Miguel Monteiro Rocha,0,71.0,0,1,2,0,2
Nurbol Zhumaskaliyev,0,61.0,0,0,1,0,1
Nurdin Bakari,0,80.0,0,0,0,1,1
Nwankwo Kanu,0,379.0,0,1,5,1,6
Nyam-Osor Naranbold,0,69.0,0,0,1,0,1
Nyasha Mushekwi,1,29.0,0,1,0,1,1
Nyron Nosworthy,0,18.0,0,0,1,0,1
Nzelo Hervé Lembi,0,13.0,0,0,1,0,1
Nándor Hidegkuti,4,192.0,0,0,1,5,6
Néjib Ghommidh,1,79.0,0,0,0,1,1
Néjib Liman,0,40.0,0,0,2,0,2
Nélson Oliveira,0,85.0,0,0,1,0,1
Nélson Veiga,0,62.0,1,0,1,0,1
Néstor Araujo,1,115.0,0,0,1,2,3
Néstor Ayala,0,82.0,0,0,1,0,1
Néstor Azón,1,84.0,0,0,0,1,1
Néstor Clausen,0,88.0,0,0,1,0,1
Néstor Combin,0,73.0,0,0,2,2,4
Néstor Craviotto,1,63.0,1,0,1,1,2
Néstor Gorosito,0,41.0,0,1,0,1,1
Nílton Santos,2,62.0,0,0,1,1,2
Oalex Anderson,1,211.0,0,1,2,4,6
Obafemi Martins,3,923.0,0,2,7,6,13
Obaidullah Karimi,1,16.0,0,0,1,0,1
Obby Kapita,1,149.0,0,0,0,4,4
Obdulio Varela,4,263.0,0,0,1,4,5
Obeid Al-Dosari,2,744.0,0,0,10,3,13
Obinna Nwaneri,0,45.0,0,0,1,0,1
Oceano da Cruz,0,82.0,0,1,2,0,2
Octavio Mora,0,68.0,0,0,3,0,3
Octavio Sergio da Costa,0,10.0,0,0,1,0,1
Octávio Machado,0,79.0,0,0,0,1,1
Odai Al-Saify,1,59.0,0,0,1,0,1
Oday Al-Jafal,1,59.0,0,0,1,0,1
Oday Dabbagh,3,210.0,0,0,4,0,4
Odaïr Fortes,0,26.0,0,0,1,0,1
Odd Iversen,0,354.0,0,1,4,2,6
Oded Machnes,0,84.0,0,0,2,0,2
Odil Ahmedov,4,724.0,0,0,8,7,15
Odilon Polleunis,0,479.0,0,0,7,1,8
Odion Ighalo,5,263.0,0,1,4,2,6
Odise Roshi,0,223.0,0,0,3,1,4
Odkhuu Selenge,0,90.0,0,0,1,0,1
Oeki Hoekema,0,54.0,0,0,1,0,1
Ofentse Nato,0,124.0,0,0,2,0,2
Oghenekaro Etebo,1,32.0,1,0,1,0,1
Ognjen Koroman,1,53.0,0,0,1,0,1
Ognjen Vukojević,0,21.0,0,0,0,2,2
Oguchi Onyewu,0,179.0,0,0,2,0,2
Ogün Altıparmak,0,175.0,0,0,1,2,3
Ogün Temizkanoğlu,0,130.0,0,0,1,1,2
Oh Seok-Jae,1,68.0,0,0,1,0,1
Oh Yong-Nam,0,88.0,1,0,1,0,1
Okan Buruk,1,336.0,0,0,5,3,8
Okan Yılmaz,3,207.0,0,1,1,2,3
Okeem Challenger,0,86.0,0,0,1,0,1
Okey Isima,1,136.0,1,0,3,0,3
Okita Katschi,0,85.0,0,1,1,0,1
Oktay Derelioğlu,0,313.0,0,0,8,0,8
Ola Dybwad-Olsen,0,306.0,0,0,4,0,4
Ola Kamara,0,90.0,0,0,1,0,1
Ola Toivonen,1,350.0,0,0,5,2,7
Olaf Marschall,0,85.0,0,0,1,0,1
Olaf Thon,0,85.0,0,0,1,0,1
Olav Nilsen,0,269.0,0,0,1,3,4
Olavi Lahtinen,1,192.0,0,0,1,2,3
Olavi Rissanen,0,198.0,0,0,3,0,3
Oldřich Nejedlý,7,636.0,0,1,8,1,9
Ole Bjørnmose,0,15.0,0,0,1,0,1
Ole Fritsen,0,60.0,0,0,1,1,2
Ole Gunnar Solskjær,0,795.0,0,1,6,8,14
Ole Madsen,1,508.0,0,0,9,5,14
Ole Martin Årst,0,89.0,0,0,1,0,1
Ole Rasmussen,0,21.0,0,0,0,1,1
Ole Selnæs,0,58.0,0,0,0,1,1
Ole Stavrum,0,8.0,0,0,0,1,1
Ole Sørensen,0,103.0,0,0,3,0,3
Ole Tobiasen,0,90.0,0,0,0,1,1
Oleg Blokhin,5,682.0,0,0,10,4,14
Oleg Kuzmin,0,33.0,0,0,1,0,1
Oleg Litvinenko,3,128.0,0,0,2,2,4
Oleg Salenko,6,251.0,0,2,5,1,6
Oleg Shatskikh,1,598.0,0,0,3,6,9
Oleg Zoteev,0,72.0,0,0,1,0,1
Oleg Șișchin,0,76.0,0,0,0,1,1
Oleh Husyev,0,268.0,0,0,3,4,7
Oleh Kuznetsov,0,60.0,0,0,1,0,1
Oleh Protasov,10,643.0,0,0,9,4,13
Oleh Shelayev,0,7.0,0,0,0,1,1
Oleksandr Kucher,0,60.0,0,0,1,0,1
Oleksandr Zavarov,3,250.0,0,0,3,2,5
Oleksandr Zinchenko,1,93.0,0,0,0,3,3
Oleksiy Byelik,0,26.0,0,0,1,1,2
Oleksiy Gai,0,54.0,0,0,0,1,1
Oleksiy Mykhaylychenko,2,273.0,0,0,3,3,6
Oli,0,28.0,0,0,1,0,1
Oliver Bierhoff,6,1122.0,0,0,11,8,19
Oliver Burke,0,89.0,0,0,1,0,1
Oliver Makor,1,345.0,0,0,3,1,4
Oliver Neuville,1,226.0,0,0,4,0,4
Olivier Dacourt,0,71.0,0,0,0,1,1
Olivier Deschacht,0,82.0,1,0,1,0,1
Olivier Djappa,0,20.0,0,0,1,0,1
Olivier Giroud,5,1032.0,0,2,12,8,20
Olivier Kapo,0,17.0,0,0,1,0,1
Olivier Karekezi,0,161.0,0,0,4,0,4
Olivier Niere,0,128.0,0,0,2,0,2
Olivier Niyonzima,0,66.0,0,0,0,1,1
Olivier Occéan,0,167.0,0,0,1,3,4
Olivier Thill,0,80.0,0,0,1,1,2
Ollie Watkins,0,83.0,0,0,1,0,1
Olof Mellberg,1,289.0,0,0,6,2,8
Olumuyiwa Oshode,0,154.0,0,0,1,1,2
Omar Abdulrahman,0,74.0,0,0,1,1,2
Omar Al Ariki,0,148.0,0,0,5,0,5
Omar Al Khouja,0,43.0,0,0,0,1,1
Omar Al Somah,9,689.0,0,2,7,6,13
Omar Al-Dahi,2,91.0,0,0,2,0,2
Omar Ali Hasab El-Rasoul,1,174.0,0,0,4,0,4
Omar Berdiýew,0,42.0,0,0,1,0,1
Omar Betrouni,0,83.0,0,0,1,0,1
Omar Bravo,6,523.0,0,0,9,0,9
Omar Cummings,1,155.0,0,0,1,1,2
Omar Daley,1,173.0,0,0,2,0,2
Omar Daoud,0,50.0,0,0,1,0,1
Omar Gonzalez,0,156.0,1,0,4,0,4
Omar Hawsawi,0,90.0,0,0,0,1,1
Omar Higinio García,1,2.0,0,0,1,0,1
Omar Khribin,8,591.0,0,2,6,7,13
Omar Marmoush,0,49.0,0,0,1,0,1
Omar Midani,0,50.0,0,0,0,1,1
Omar Mohamed,0,85.0,0,0,0,1,1
Omar Mubarak,2,73.0,0,0,2,0,2
Omar Méndez,1,12.0,0,0,0,1,1
Omar Sivori,0,221.0,0,0,4,0,4
Omar Sívori,3,114.0,0,0,3,1,4
Omar Traoré,0,80.0,0,0,0,1,1
Omar Zapata,1,190.0,0,0,3,1,4
Omari Glasgow,1,75.0,0,0,1,0,1
Omari Sterling-James,0,82.0,0,0,0,1,1
Omari Tetradze,1,54.0,0,0,1,0,1
Omer Damari,0,209.0,0,0,1,4,5
Omer Golan,0,296.0,0,0,3,2,5
Omid Popalzay,1,23.0,0,0,1,0,1
Omri Afek,1,4.0,0,0,1,1,2
Onandi Lowe,1,246.0,0,0,3,4,7
Ondrej Duda,1,387.0,0,1,3,4,7
Ondrej Krištofík,0,27.0,1,0,1,0,1
Ondřej Čelůstka,0,79.0,0,0,1,0,1
Onel Hernández,2,95.0,0,0,2,0,2
Oniel Fisher,0,79.0,0,0,0,1,1
Onur Dogan,0,52.0,0,0,0,1,1
Opa Nguette,0,55.0,0,0,1,0,1
Opoku Afriyie,0,206.0,0,0,4,0,4
Opoku Nti,2,248.0,0,0,2,2,4
Oppe Quiñónez,1,82.0,0,0,0,1,1
Orbelín Pineda,4,262.0,0,2,3,2,5
Orestas Buitkus,0,222.0,0,0,1,2,3
Oreste Corbatta,5,486.0,0,6,12,2,14
Orhan Çıkırıkçı,0,87.0,0,0,1,0,1
Oribe Peralta,8,827.0,0,0,11,7,18
Orin de Waard,0,12.0,0,0,1,0,1
Orkun Kökçü,0,60.0,0,0,0,1,1
Orlando Gando,0,50.0,0,0,0,1,1
Orlando Maturana,1,18.0,0,1,1,0,1
Orlando Mesa,0,18.0,0,0,0,1,1
Orlando Mitchum,0,302.0,0,0,4,1,5
Orlando Torres,0,8.0,0,0,1,0,1
Orlando de Azevedo Viarina,0,132.0,0,0,2,0,2
Orly Klinger,0,48.0,0,0,1,0,1
Osael Romero,3,533.0,0,1,6,5,11
Osama Al Fazzani,0,4.0,0,0,1,0,1
Osama Al-Muwallad,0,132.0,0,0,1,1,2
Osama Hawsawi,0,189.0,0,0,1,2,3
Osama Idris,0,7.0,0,0,1,0,1
Osama Omari,4,213.0,0,0,4,1,5
Osamu Maeda,0,16.0,0,0,1,0,1
Osaze Odemwingie,3,216.0,0,0,3,0,3
Oscar,1,228.0,0,0,3,0,3
Oscar Arriaza,0,22.0,0,0,1,0,1
Oscar Black,0,11.0,0,0,1,0,1
Oscar Chirimini,1,198.0,0,0,1,2,3
Oscar Crino,0,67.0,0,0,2,0,2
Oscar Fornari,0,17.0,0,0,0,1,1
Oscar Heisserer,0,10.0,0,0,1,0,1
Oscar Hiljemark,0,45.0,0,0,1,0,1
Oscar Mas,1,23.0,0,0,1,0,1
Oscar Ruggeri,2,46.0,0,0,2,0,2
Oscar Santis,0,16.0,0,0,1,0,1
Oscar Zubía,0,60.0,0,0,0,1,1
Osea Vakatalesau,0,113.0,0,0,2,0,2
Osei Kofi,6,486.0,0,1,4,5,9
Oskars Kļava,0,27.0,0,0,0,1,1
Osman Arpacıoğlu,0,45.0,0,0,2,0,2
Osman Bukari,1,89.0,0,0,0,1,1
Osmin Hernández,0,19.0,0,0,1,0,1
Ossama Khalil,1,99.0,0,0,2,0,2
Ostap Steckiw,0,14.0,0,0,0,1,1
Osvaldo Ardiles,1,185.0,0,0,2,1,3
Osvaldo Balseiro,4,260.0,0,0,0,4,4
Osvaldo Castro,0,40.0,0,0,1,0,1
Osvaldo Fernando Saturnino de Oliveira,0,78.0,0,0,0,1,1
Osvaldo Héctor Cruz,2,95.0,0,0,2,0,2
Osvaldo Sáez,3,207.0,0,0,2,1,3
Osvaldo de Oliveira,0,73.0,0,0,1,1,2
Oswalding Mackay,0,85.0,0,0,1,0,1
Oswaldo Alanís,0,35.0,0,0,1,0,1
Oswaldo Calero,0,42.0,0,0,1,0,1
Oswaldo Palencia,0,14.0,0,0,1,0,1
Oswaldo Ramírez,0,219.0,0,1,2,3,5
Oswaldo Taurisano,3,121.0,0,0,3,0,3
Oswaldo Vizcarrondo,1,59.0,0,0,1,1,2
Otabek Shukurov,0,141.0,0,1,2,0,2
Otar Kakabadze,0,76.0,1,0,1,0,1
Othman Ferjani,0,50.0,0,0,0,1,1
Otis Roberts,0,124.0,0,0,1,1,2
Otis Steede,0,43.0,0,0,1,0,1
Ottmar Walter,4,286.0,0,0,3,2,5
Otto Addo,0,37.0,0,0,1,0,1
Otto Siffling,1,108.0,0,0,2,1,3
Otto Walzhofer,0,51.0,0,0,1,0,1
Otávio,0,15.0,0,0,1,0,1
Oumar Barro,0,62.0,0,0,2,0,2
Oumar Ben Salah,1,187.0,0,0,5,1,6
Oumar Kalabane,0,103.0,0,0,0,2,2
Oumar N'Diaye,0,22.0,0,0,1,0,1
Oumar Tchomogo,0,210.0,0,2,5,0,5
Oumed Alidodov,0,32.0,0,0,1,1,2
Oumed Oukri,0,5.0,0,0,1,0,1
Oupa Manyisa,1,47.0,0,0,1,0,1
Ousman Jallow,0,26.0,0,0,1,0,1
Ousmane Badara Bangoura,0,15.0,0,0,0,1,1
Ousmane Bangoura,2,253.0,0,0,0,4,4
Ousmane Dembélé,0,19.0,0,0,0,1,1
Ousmane Sanou,2,169.0,0,0,2,1,3
Ousmane Sidibé,0,61.0,1,0,1,0,1
Ousmane Thiam Tollo,1,50.0,0,1,1,1,2
Oussama Darragi,0,355.0,0,2,2,3,5
Ovays Azizi,1,75.0,1,0,1,0,1
Ove Bech Nielsen,0,91.0,0,0,0,2,2
Ove Grahn,1,254.0,0,1,3,1,4
Ove Kindvall,0,386.0,0,1,5,4,9
Ove Ødegaard,0,54.0,0,0,0,2,2
Ovidio Mezza,0,198.0,0,1,2,2,4
Ovidiu Hanganu,0,86.0,0,0,0,1,1
Ovidiu Hoban,0,90.0,0,0,1,0,1
Ovidiu Petre,0,29.0,0,0,1,0,1
Oyunbaataryn Mijiddorj,1,34.0,0,0,0,1,1
Ozan Tufan,4,344.0,0,0,2,4,6
Oğuz Çetin,0,130.0,0,0,2,0,2
Oğuzhan Özyakup,0,8.0,0,0,1,0,1
Oļegs Aleksejenko,0,3.0,0,0,0,1,1
Pa Dibba,0,9.0,0,0,0,1,1
Paa Nii Lutterodt,1,52.0,0,0,1,0,1
Pablo Aimar,2,312.0,0,0,4,2,6
Pablo Armero,1,95.0,0,0,2,0,2
Pablo Barrera,3,286.0,0,0,2,3,5
Pablo Bengoechea,2,218.0,0,0,2,2,4
Pablo Cardozo,1,43.0,0,0,0,1,1
Pablo Contreras,0,28.0,0,0,1,0,1
Pablo César Aguilar,0,52.0,0,0,1,0,1
Pablo Daniel Escobar,0,195.0,0,0,4,0,4
Pablo Dorado,0,19.0,0,0,2,0,2
Pablo Fornals,0,32.0,0,0,0,1,1
Pablo Ganet,1,122.0,0,0,1,1,2
Pablo García,0,90.0,0,0,1,1,2
Pablo Herrera Barrantes,1,158.0,0,0,1,1,2
Pablo León,1,89.0,0,0,0,1,1
Pablo Lima,1,87.0,0,0,1,0,1
Pablo Palacios,0,83.0,0,0,1,0,1
Pablo Paz,0,58.0,0,0,1,0,1
Pablo Punyed,0,45.0,0,0,1,0,1
Pablo Ramírez,1,76.0,0,0,0,1,1
Pablo Rojas,0,38.0,0,0,0,1,1
Pablo Sarabia,1,246.0,0,1,3,2,5
Pablo Tamburrini,0,51.0,0,0,0,1,1
Pablo Thiam,0,24.0,0,0,0,1,1
Paco Alcácer,2,515.0,0,0,5,3,8
Paco Clos,0,48.0,0,0,1,0,1
Paddy McCourt,0,158.0,0,0,2,0,2
Paddy McNair,0,168.0,0,1,0,2,2
Paddy Moore,4,263.0,0,0,4,1,5
Pai Soe,0,62.0,0,0,1,0,1
Paik Seung-ho,1,76.0,0,0,0,1,1
Paisano Urbita Sosa,0,77.0,0,0,0,1,1
Pajtim Kasami,0,75.0,0,0,1,0,1
Pak Chol-min,0,96.0,0,0,2,1,3
Pak Doo-ik,2,57.0,0,0,1,1,2
Pak Jong-hun,2,109.0,0,1,0,2,2
Pak Kwang-ryong,1,58.0,0,1,2,1,3
Pak Nam-Chol,0,115.0,0,0,3,0,3
Pak Seung-zin,5,276.0,0,0,3,2,5
Pak Song-Gwan,0,63.0,0,0,1,0,1
Pak Sung-Jin,0,48.0,0,0,0,1,1
Palhinha,3,573.0,0,0,5,4,9
Pambos Papadopoulos,0,46.0,0,0,1,0,1
Pambos Pittas,1,184.0,0,3,4,0,4
Panagiotis Kone,0,86.0,0,0,1,0,1
Panagiotis Sofianopoulos,0,25.0,0,0,1,0,1
Panagiotis Tachtsidis,0,57.0,0,0,1,0,1
Panagiotis Tsalouchidis,0,392.0,0,0,1,6,7
Panajot Pano,0,67.0,0,0,2,0,2
Panayiotis Engomitis,0,70.0,0,0,2,0,2
Panayiotis Marangos,0,8.0,0,0,0,1,1
Panayiotis Xiourouppas,0,20.0,0,0,1,1,2
Panayot Panayotov,0,61.0,0,0,2,0,2
Pang Gwang-Chol,1,4.0,0,0,0,1,1
Panicos Efthimiadis,0,89.0,0,0,1,0,1
Paolo Amodio,0,14.0,0,0,1,0,1
Paolo Barison,1,265.0,0,0,3,1,4
Paolo Guerrero,14,1484.0,0,1,13,12,25
Paolo Hurtado,0,95.0,0,0,0,2,2
Paolo Maldini,0,226.0,0,0,5,0,5
Paolo Montero,1,256.0,0,0,4,1,5
Paolo Rossi,9,418.0,0,1,5,5,10
Papa Bouba Diop,6,350.0,0,0,3,5,8
Papa Camara,2,178.0,0,0,4,0,4
Papa Dia,0,84.0,0,0,0,1,1
Papa Yakhya Lette,0,34.0,0,0,0,1,1
Papakouli Diop,1,43.0,0,0,1,0,1
Pape Abou Cissé,0,45.0,1,0,1,0,1
Pape Fall,1,28.0,0,0,0,1,1
Pape Sarr,1,45.0,0,0,0,1,1
Pape Seydou Diop,0,16.0,0,0,0,1,1
Pape Thiaw,0,45.0,0,0,0,2,2
Papi Kimoto,2,117.0,0,1,1,1,2
Papiss Cissé,0,221.0,0,1,0,5,5
Papito Merencia,0,24.0,0,0,1,1,2
Papu Gómez,2,16.0,0,0,2,0,2
Papy Okitankoy Kimoto,0,90.0,0,0,1,0,1
Paramasivan Ravindran,2,162.0,0,0,0,2,2
Park Chang-Sun,1,85.0,0,0,1,1,2
Park Chu-young,2,620.0,1,2,6,8,14
Park Ji-sung,2,565.0,0,0,6,3,9
Park Jin-seop,1,51.0,1,0,0,1,1
Park Jung-bae,1,57.0,0,0,1,1,2
Park Kun-Ha,0,86.0,0,0,1,0,1
Park Kyung-Hoon,1,41.0,0,0,0,1,1
Park Lee-chun,3,260.0,0,1,1,3,4
Park Nam-Yeol,0,63.0,0,0,1,0,1
Park Sang-in,0,234.0,0,0,3,0,3
Park Seung-ok,1,74.0,0,0,0,1,1
Park Soo-Il,0,68.0,0,0,2,0,2
Park Su-deok,1,37.0,0,0,0,1,1
Park Yi-Chun,0,52.0,0,0,1,0,1
Parviz Ghelichkhani,1,240.0,0,1,5,0,5
Pascal Anicet,0,53.0,1,0,1,0,1
Pascal Feindouno,8,1010.0,0,4,10,9,19
Pascal Miézan,0,91.0,0,0,1,1,2
Pascal Ochieng,0,41.0,0,0,0,1,1
Paschalis Christoforou,0,72.0,0,0,1,0,1
Pascual Somma,0,88.0,0,0,1,0,1
Pat Nevin,0,262.0,0,1,4,0,4
Pat Stanton,0,22.0,1,0,1,0,1
Patesko,6,205.0,0,0,6,0,6
Patiparn Phetphun,0,82.0,0,0,1,0,1
Patou Ebunga-Simbi,0,81.0,0,0,0,1,1
Patrice Abanda,0,18.0,0,0,1,0,1
Patrice Bernier,1,25.0,0,0,0,1,1
Patrice Loko,2,146.0,0,0,1,1,2
Patricio Urrutia,0,69.0,0,0,0,1,1
Patricio Yáñez,1,209.0,0,0,3,1,4
Patrick Aisa,0,123.0,0,0,0,2,2
Patrick Battiston,0,73.0,0,0,0,2,2
Patrick Blair,0,51.0,0,0,1,0,1
Patrick Bühlmann,0,59.0,0,0,0,1,1
Patrick Diaike,0,87.0,0,0,1,0,1
Patrick Kaddu,1,14.0,0,0,0,1,1
Patrick Kluivert,5,1154.0,0,0,13,9,22
Patrick M'Boma,13,1351.0,0,0,14,10,24
Patrick Mabedi,0,174.0,0,1,1,1,2
Patrick Mayo,1,29.0,0,0,0,1,1
Patrick Mkontwana,0,53.0,0,0,0,1,1
Patrick Modeste,0,105.0,0,0,1,1,2
Patrick Mutesa Mafisango,0,19.0,0,0,0,1,1
Patrick Müller,0,74.0,0,0,1,0,1
Patrick Nachok,0,88.0,0,0,1,0,1
Patrick Percin,1,51.0,0,0,0,1,1
Patrick Phiri,1,20.0,0,0,0,1,1
Patrick Ranaivoson,0,42.0,1,0,1,0,1
Patrick Reichelt,0,12.0,0,0,0,1,1
Patrick Ronaldinho Wleh,0,32.0,0,0,1,0,1
Patrick Vervoort,2,123.0,0,0,2,1,3
Patrick Vieira,2,197.0,0,0,1,4,5
Patrick Zinhagel,0,153.0,0,0,1,1,2
Patrik Andersson,0,110.0,0,0,1,1,2
Patrik Berger,1,737.0,0,4,12,2,14
Patrik Schick,5,467.0,0,2,4,7,11
Patson Daka,0,125.0,0,0,2,1,3
Patterson Daudau,4,156.0,0,0,4,0,4
Pau Torres,0,62.0,0,0,1,0,1
Paul Agostino,3,139.0,0,0,3,0,3
Paul Aguilar,1,64.0,0,0,1,1,2
Paul Arriola,0,200.0,0,0,4,0,4
Paul Bodin,0,166.0,0,2,1,1,2
Paul Bravo,1,27.0,0,0,1,0,1
Paul Breitner,1,354.0,0,2,6,1,7
Paul Caligiuri,1,60.0,0,0,1,0,1
Paul Cam,0,22.0,0,0,0,1,1
Paul Cann,0,70.0,0,0,0,1,1
Paul Cominges,2,72.0,0,0,2,0,2
Paul Courant,0,60.0,0,0,1,0,1
Paul Davis,2,333.0,0,0,3,3,6
Paul Dickov,0,45.0,0,0,1,0,1
Paul Fenech,0,40.0,0,0,1,0,1
Paul Fenwick,0,81.0,1,0,1,0,1
Paul Gascoigne,0,445.0,0,0,6,2,8
Paul Hall,2,159.0,0,0,0,3,3
Paul Hartley,0,84.0,0,0,0,1,1
Paul Ince,2,95.0,0,0,0,2,2
Paul Kakai,1,16.0,0,0,0,1,1
Paul Kay,2,213.0,0,0,2,2,4
Paul Komboi,2,81.0,0,0,0,2,2
Paul Lambert,0,62.0,0,0,0,1,1
Paul Mariner,1,385.0,0,0,4,3,7
Paul May,0,33.0,0,0,0,1,1
Paul McGee,0,46.0,0,0,0,2,2
Paul McGrath,0,368.0,0,0,4,3,7
Paul McStay,1,190.0,0,0,5,2,7
Paul Moukila,2,91.0,0,0,2,0,2
Paul Papp,0,153.0,0,0,2,0,2
Paul Peschisolido,0,148.0,0,0,4,0,4
Paul Philipp,0,129.0,0,2,2,1,3
Paul Poatinda,3,147.0,0,0,3,0,3
Paul Pogba,3,394.0,0,0,5,2,7
Paul Ritchie,0,30.0,0,0,0,1,1
Paul Ruben Corte,0,180.0,0,0,2,0,2
Paul Scholes,3,476.0,0,0,5,6,11
Paul Sixsmith,0,69.0,0,0,1,0,1
Paul Stalteri,1,59.0,0,0,0,1,1
Paul Sturrock,0,84.0,0,0,1,1,2
Paul Trimboli,3,572.0,0,0,10,1,11
Paul Urlovic,0,189.0,0,0,3,0,3
Paul Van Himst,0,694.0,0,1,10,5,15
Paul Vandenberg,0,246.0,0,0,1,3,4
Paul Wade,1,169.0,0,1,2,1,3
Paul Young,0,125.0,0,0,1,2,3
Paul-Gaston N'Dongo,2,224.0,0,0,4,1,5
Paul-José M'Poku,2,195.0,0,0,2,1,3
Pauleta,5,1283.0,0,0,17,8,25
Paulinho,1,524.0,0,1,5,5,10
Paulinho Santos,0,82.0,0,0,0,2,2
Paulino Vieira Dias,0,30.0,0,0,1,0,1
Paulo Alves,0,383.0,0,0,2,3,5
Paulo António Alves,1,445.0,0,1,8,2,10
Paulo César Chávez,0,1.0,0,0,1,0,1
Paulo Dybala,2,112.0,0,0,1,1,2
Paulo Figueiredo,0,60.0,0,0,0,1,1
Paulo Futre,0,232.0,0,1,2,3,5
Paulo Jorge Da Silva,2,136.0,0,2,2,2,4
Paulo Madeira,0,181.0,0,0,1,2,3
Paulo Pisaneschi,3,142.0,0,0,3,1,4
Paulo Roberto Falcão,3,248.0,0,0,3,1,4
Paulo Roberto Jamelli Júnior,2,92.0,0,0,0,2,2
Paulo Silas,0,37.0,0,0,1,0,1
Paulo Valentim,5,275.0,0,0,3,2,5
Paulo Wanchope,15,1962.0,0,0,22,15,37
Paulo da Silva,0,110.0,0,0,1,2,3
Paulus Arajuuri,0,181.0,0,0,3,0,3
Paulus Roiha,0,87.0,0,0,0,1,1
Paulus Shipanga,0,83.0,0,0,2,0,2
Pavel Badea,0,77.0,0,0,1,0,1
Pavel Chaloupka,0,70.0,0,0,0,1,1
Pavel Hapal,1,23.0,0,0,1,0,1
Pavel Kadeřábek,0,69.0,0,0,1,1,2
Pavel Kuka,1,715.0,0,0,8,5,13
Pavel Matyash,1,50.0,1,0,1,0,1
Pavel Nedvěd,3,511.0,0,0,8,6,14
Pavel Panov,0,210.0,0,0,3,2,5
Pavel Pashayev,0,26.0,1,0,1,0,1
Pavel Pogrebnyak,0,237.0,0,1,2,2,4
Pavel Savitski,0,241.0,0,0,3,0,3
Pavel Sedko,1,31.0,0,0,1,0,1
Pavel Sitko,0,28.0,0,0,1,0,1
Pavel Solomin,1,82.0,0,0,0,1,1
Pavel Verbíř,0,84.0,0,0,1,0,1
Pavel Yevteyev,0,187.0,0,0,2,1,3
Pavlo Yakovenko,1,2.0,0,0,1,0,1
Pavlos Savva,0,60.0,0,0,0,1,1
Pavol Molnár,0,89.0,0,0,1,0,1
Pawel Janas,0,5.0,1,0,0,1,1
Paweł Brożek,0,27.0,0,0,1,0,1
Paweł Kaczorowski,0,75.0,0,0,0,1,1
Paweł Kryszałowicz,1,122.0,0,0,2,1,3
Paweł Król,0,90.0,0,0,0,1,1
Pedri,1,20.0,1,0,1,0,1
Pedro,1,392.0,0,0,3,4,7
Pedro Acosta,1,105.0,1,1,3,0,3
Pedro Alcides Bareiro,0,10.0,0,0,1,0,1
Pedro Alejandro García,0,76.0,0,0,0,1,1
Pedro Amorim,2,99.0,0,0,2,0,2
Pedro Antonio Cabral,1,90.0,0,0,0,1,1
Pedro Aquino,0,101.0,0,0,0,2,2
Pedro Araya,2,160.0,0,0,3,0,3
Pedro Arnauda,0,192.0,0,0,3,0,3
Pedro Barbosa,0,240.0,0,0,3,1,4
Pedro Calomino,1,15.0,0,0,1,0,1
Pedro Cea,0,249.0,0,0,5,0,5
Pedro Eugenio Callá,0,86.0,0,0,2,0,2
Pedro Febles,0,106.0,0,0,1,1,2
Pedro Fernández,1,51.0,0,0,0,1,1
Pedro González Vera,0,44.0,0,0,0,1,1
Pedro Hugo López,2,294.0,0,1,1,4,5
Pedro Lago,3,149.0,0,0,0,3,3
Pedro Monzón,1,62.0,0,0,1,0,1
Pedro Munitis,1,51.0,0,0,0,1,1
Pedro Pablo León,1,338.0,0,0,1,5,6
Pedro Pasculli,1,165.0,0,0,2,2,4
Pedro Petrone,3,544.0,0,0,7,3,10
Pedro Reyes,2,199.0,0,0,3,1,4
Pedro Rocha,1,347.0,0,0,6,3,9
Pedro Sarmiento,0,40.0,0,0,0,1,1
Pedro Troglio,1,27.0,0,0,1,0,1
Pedro Waldemar Manfredini,0,55.0,0,0,2,0,2
Pedro Zaballa,0,113.0,0,0,0,2,2
Pedro Zingone,0,73.0,0,0,1,0,1
Pelayo Ayala,1,83.0,0,0,0,1,1
Pele Kaimana,0,69.0,0,0,1,0,1
Pelé,17,1370.0,0,0,20,6,26
Peng Weiguo,3,183.0,0,0,2,3,5
Penieli Moa,1,71.0,0,1,0,1,1
Pep Guardiola,1,114.0,0,1,3,1,4
Pepe,5,273.0,0,0,3,3,6
Per Edmund Mordt,0,71.0,0,0,1,0,1
Per Kristoffersen,0,77.0,0,0,1,0,1
Per Mertesacker,0,84.0,0,0,2,1,3
Per Pedersen,0,28.0,0,0,1,0,1
Per Pettersen,0,80.0,0,0,0,1,1
Per Røntved,0,258.0,0,2,4,0,4
Percival Piggott,0,33.0,0,0,0,1,1
Percy Colque,0,54.0,0,0,1,0,1
Percy Rojas,1,149.0,0,0,2,1,3
Percy Tau,0,65.0,0,0,1,1,2
Peregrino Anselmo,0,82.0,0,0,3,0,3
Pereira Tavares,0,47.0,0,0,2,0,2
Peri Neufeld,1,36.0,0,0,1,0,1
Pertti Mäkipää,0,57.0,0,0,0,1,1
Pervis Estupiñán,0,99.0,0,0,1,1,2
Petar Radaković,1,152.0,0,0,1,1,2
Petar Stojanović,0,42.0,0,0,1,0,1
Petar Velichkov,0,86.0,0,0,1,0,1
Petar Zhekov,0,299.0,0,0,4,2,6
Pete Matevich,2,65.0,0,0,2,0,2
Peter Anieke,0,90.0,0,0,0,1,1
Peter Ankersen,0,78.0,0,0,1,0,1
Peter Artner,0,9.0,1,0,0,1,1
Peter Barnes,0,54.0,0,0,0,1,1
Peter Beardsley,1,286.0,0,0,5,1,6
Peter Byers,0,526.0,0,1,5,6,11
Peter Cargill,0,66.0,0,0,1,0,1
Peter Crouch,1,509.0,0,0,8,2,10
Peter Crève,0,81.0,0,0,1,0,1
Peter Dahl,0,86.0,0,0,0,1,1
Peter Dawo,0,47.0,0,0,1,0,1
Peter Dubovský,4,738.0,0,4,10,4,14
Peter Ducke,0,455.0,0,0,2,5,7
Peter Dzúrik,0,56.0,0,0,0,1,1
Peter Farrell,0,65.0,0,0,0,1,1
Peter Fregene,1,81.0,1,0,0,1,1
Peter Greenaway,0,23.0,0,0,0,1,1
Peter Hlinka,0,72.0,0,0,1,0,1
Peter Houtman,0,270.0,0,0,4,1,5
Peter Hrstic,0,2.0,0,0,1,0,1
Peter Isaacs,0,52.0,0,0,0,1,1
Peter Jehle,0,12.0,1,0,0,1,1
Peter Kaumba,2,56.0,0,0,0,3,3
Peter Kotte,0,3.0,0,1,1,0,1
Peter Larsson,0,97.0,0,1,1,2,3
Peter Lorimer,1,72.0,0,0,1,1,2
Peter McParland,5,276.0,0,0,0,7,7
Peter Mgangira,0,88.0,0,0,0,1,1
Peter Millar,0,175.0,0,0,3,0,3
Peter Méndez,3,134.0,0,1,0,3,3
Peter Møller,1,89.0,0,0,3,1,4
Peter Ndlovu,3,548.0,0,1,6,8,14
Peter Nicholas,0,15.0,0,0,0,1,1
Peter Nielsen,0,70.0,0,0,1,0,1
Peter Németh,0,126.0,0,0,1,1,2
Peter O'Sullivan,0,18.0,0,0,1,0,1
Peter Odemwingie,3,278.0,0,0,6,0,6
Peter Ollerton,0,273.0,0,0,2,4,6
Peter Ouma,1,100.0,0,0,2,0,2
Peter Pekarík,0,52.0,0,0,2,0,2
Peter Pumm,0,78.0,0,0,1,0,1
Peter Rasmussen,2,163.0,0,0,2,0,2
Peter Risi,0,125.0,0,0,0,2,2
Peter Rock,0,89.0,0,0,1,0,1
Peter Roronamahava,1,45.0,0,0,0,1,1
Peter Shalulile,1,209.0,0,0,2,2,4
Peter Sharne,4,388.0,0,0,4,1,5
Peter Stöger,0,438.0,0,0,8,1,9
Peter Tino,0,142.0,0,0,3,0,3
Peter Van Der Heyden,0,75.0,0,0,0,1,1
Peter Vermes,0,70.0,0,0,2,0,2
Peter Wilson,2,165.0,0,0,3,0,3
Peter Withe,0,70.0,0,0,1,0,1
Peter van Vossen,0,398.0,0,1,3,3,6
Peterkins Kayira,0,150.0,0,0,3,0,3
Petit,0,239.0,1,0,3,0,3
Petit Sory,1,126.0,0,0,1,2,3
Petko Petkov,0,48.0,0,0,1,0,1
Petr Janečka,0,388.0,0,0,6,2,8
Petr Jiráček,1,156.0,0,0,0,3,3
Petr Kachuro,0,73.0,0,1,0,1,1
Petr Rada,0,139.0,0,1,2,0,2
Petr Vrabec,1,13.0,0,0,1,0,1
Petri Helin,0,83.0,0,0,0,1,1
Petri Järvinen,0,105.0,0,0,1,1,2
Petri Pasanen,0,23.0,1,0,1,0,1
Petri Tiainen,0,82.0,0,0,1,0,1
Petros Mantalos,0,89.0,0,0,2,0,2
Petros Marinakis,0,67.0,0,0,0,1,1
Petru Racu,0,65.0,1,0,0,1,1
Petter Hansson,1,72.0,0,0,0,1,1
Petter Rudi,0,21.0,0,0,0,2,2
Petter Villegas,0,137.0,0,1,2,0,2
Phan Thanh Bình,0,32.0,0,0,1,0,1
Phan Thanh Hùng,1,77.0,0,0,1,0,1
Phan Văn Tài Em,0,118.0,0,0,3,0,3
Phan Văn Đức,0,76.0,0,0,1,0,1
Phengta Phounsamay,0,15.0,0,0,1,0,1
Phil Babb,0,88.0,1,0,1,0,1
Phil Evans,1,28.0,0,0,1,0,1
Phil Foden,1,51.0,0,0,0,1,1
Phil Gray,0,321.0,0,0,3,2,5
Phil Jagielka,0,25.0,0,0,1,0,1
Phil Masinga,1,231.0,0,0,5,2,7
Phil Neal,0,174.0,0,0,1,1,2
Phil Roberts,0,70.0,0,0,1,0,1
Phil Woosnam,0,7.0,0,0,1,0,1
Phil Younghusband,0,100.0,0,1,2,0,2
Philip Mulryne,0,118.0,0,0,0,2,2
Philip Zialor,0,137.0,0,0,3,0,3
Philipp Hosiner,0,28.0,0,0,2,0,2
Philipp Lahm,2,135.0,0,0,3,0,3
Philippe Albert,2,272.0,0,0,1,3,4
Philippe Anziani,0,89.0,0,0,1,0,1
Philippe Clement,0,55.0,0,0,0,1,1
Philippe Coutinho,5,713.0,0,2,14,0,14
Philippe Erne,0,7.0,0,0,1,0,1
Philippe Fargeon,0,55.0,0,0,1,0,1
Philippe Gondet,0,112.0,0,0,3,0,3
Philippe Mahut,0,5.0,1,0,1,0,1
Philippe Mexès,0,28.0,0,0,0,1,1
Philippe Michel Mouthé,0,34.0,0,0,1,0,1
Philippe Senderos,1,149.0,0,0,2,3,5
Philippe Vorbe,0,52.0,0,0,1,0,1
Phillemon Tegire,1,22.0,1,0,0,1,1
Phillip Cocu,3,349.0,0,0,6,4,10
Phillip Omondi,3,95.0,0,0,0,3,3
Phillip Skeal,0,68.0,1,0,0,1,1
Phutthadavong Chanthalome,0,88.0,0,0,1,0,1
Phạm Thành Lương,0,62.0,0,0,1,0,1
Phạm Văn Quyến,0,80.0,0,1,1,0,1
Pier Domenico Della Valle,0,34.0,0,0,0,1,1
Pier Janssen,0,48.0,0,0,1,0,1
Pierino Prati,0,250.0,0,0,3,2,5
Pierluigi Casiraghi,2,295.0,0,0,4,3,7
Piero Alva,0,47.0,0,0,2,0,2
Piero Hincapié,0,86.0,1,0,2,0,2
Pieros Sotiriou,1,479.0,0,2,7,2,9
Pierre Flamion,0,160.0,0,0,0,2,2
Pierre Issa,0,77.0,1,0,1,0,1
Pierre Kalala Mukendi,3,154.0,0,1,3,0,3
Pierre Lingongo,0,23.0,0,0,1,0,1
Pierre Littbarski,2,416.0,0,0,5,5,10
Pierre Njanka,1,77.0,0,0,1,0,1
Pierre Tchibota,2,58.0,0,0,0,2,2
Pierre Wacapo,1,90.0,0,0,1,0,1
Pierre Wajoka,3,180.0,0,1,5,0,5
Pierre Webó,0,360.0,0,0,3,5,8
Pierre Womé,1,44.0,0,0,1,0,1
Pierre van Hooijdonk,3,703.0,0,2,6,5,11
Pierre-Emerick Aubameyang,1,733.0,0,5,11,2,13
Pierre-Emile Højbjerg,0,208.0,0,0,2,1,3
Piet Keizer,0,412.0,0,1,6,2,8
Piet Kruiver,0,41.0,0,0,1,1,2
Piet Wildschut,0,19.0,0,0,0,1,1
Piet de Boer,0,228.0,0,0,3,0,3
Pietro Anastasi,1,145.0,0,0,2,1,3
Pietro Ferraris,1,2.0,0,0,1,0,1
Pietro Marsetti,0,72.0,0,0,1,0,1
Pietro Vierchowod,0,63.0,0,0,1,1,2
Pinga,4,176.0,0,0,2,2,4
Pini Balili,1,215.0,0,0,2,1,3
Pinula Contreras,0,169.0,0,0,3,1,4
Piotr Czachowski,0,59.0,0,0,1,0,1
Piotr Nowak,0,70.0,0,0,2,0,2
Piotr Trochowski,0,72.0,0,0,1,0,1
Piotr Włodarczyk,0,36.0,0,0,0,1,1
Piotr Zieliński,1,187.0,0,0,2,2,4
Pipat Thonkanya,0,148.0,0,0,2,0,2
Piqueti,1,60.0,0,0,0,3,3
Pirmurod Burkhanov,0,84.0,0,0,0,2,2
Pirri,1,388.0,0,2,8,2,10
Pita David Maki,1,74.0,0,0,0,1,1
Pita Rabo,1,24.0,0,0,1,0,1
Pius Ndiefi,1,73.0,0,0,1,1,2
Piyapong Pue-on,9,468.0,0,1,5,6,11
Pizzi,0,52.0,0,0,1,0,1
Plamen Getov,1,96.0,0,0,2,1,3
Plamen Markov,0,28.0,0,0,0,1,1
Plamen Nikolov,0,68.0,0,0,1,0,1
Platini,1,35.0,0,0,0,1,1
Pokklaw Anan,0,214.0,0,0,2,1,3
Pollen Ndlanya,1,77.0,0,0,0,1,1
Polly Ouma,0,163.0,0,0,1,1,2
Polo Carrera,0,96.0,0,0,2,0,2
Ponaryo Astaman,1,48.0,0,0,0,1,1
Ponciano Castro,0,121.0,0,0,1,1,2
Pongthorn Thiubthong,1,54.0,0,0,0,1,1
Pontus Wernbloom,0,124.0,0,0,2,0,2
Porfirio Jiménez,0,141.0,0,0,2,1,3
Porfirio Rolón,1,14.0,0,0,0,1,1
Poul Pedersen,0,17.0,0,0,1,0,1
Prapon Tantariyanond,0,237.0,0,0,3,0,3
Prasert Changmool,0,79.0,0,0,0,1,1
Preben Elkjær,6,1214.0,0,0,19,7,26
Predrag Mijatović,12,1067.0,0,4,13,10,23
Predrag Pašić,0,73.0,0,0,1,0,1
Predrag Spasić,0,11.0,0,0,1,0,1
Predrag Đorđević,1,51.0,0,0,1,0,1
Preguinho,3,202.0,0,0,1,2,3
Preki,1,232.0,0,0,3,1,4
Presley Carson,1,40.0,0,0,0,1,1
Primož Gliha,0,346.0,0,0,2,4,6
Prince Akim Daye,1,7.0,0,0,1,0,1
Prince Daye,0,5.0,0,0,1,0,1
Prince Mumba,0,57.0,0,0,0,1,1
Prince Oniangué,1,102.0,0,0,0,2,2
Prince Opoku Polley,1,42.0,0,0,1,0,1
Prince Polley,1,54.0,0,0,0,1,1
Prince Tagoe,0,47.0,0,0,3,0,3
Prvoslav Mihajlović,2,96.0,0,1,0,2,2
Przemysław Frankowski,0,74.0,0,0,1,0,1
Przemysław Kaźmierczak,0,84.0,0,0,1,0,1
Préjuce Nakoulma,1,490.0,0,0,6,3,9
Putut Widjanarko,1,55.0,0,0,1,0,1
Pyry Soiri,0,168.0,0,0,0,2,2
Pál Dárdai,0,108.0,0,0,0,2,2
Pál Teleki,1,11.0,0,0,0,1,1
Pál Titkos,2,138.0,0,0,4,0,4
Pável Pardo,2,491.0,0,1,7,1,8
Pär Zetterberg,0,217.0,0,1,2,2,4
Pål Jacobsen,0,49.0,0,0,2,0,2
Pål Lydersen,0,49.0,0,1,1,0,1
Péter Hannich,0,56.0,0,0,0,1,1
Péter Juhász,0,51.0,0,0,1,0,1
Péter Kovács,0,93.0,0,0,0,1,1
Péter Palotás,2,158.0,0,0,2,0,2
Péter Rajczi,0,175.0,0,0,2,0,2
Pétur Marteinsson,0,70.0,0,0,0,1,1
Pétur Ormslev,0,65.0,0,0,2,0,2
Pétur Pétursson,0,219.0,0,1,3,2,5
Pól Jóhannus Justinussen,0,73.0,1,0,0,1,1
Pāvels Šteinbors,0,76.0,1,0,1,0,1
Přemysl Bičovský,0,177.0,0,0,3,2,5
Qahtan Chathir,1,175.0,0,0,1,3,4
Qasim Said,0,1.0,0,0,0,1,1
Qazim Laçi,0,58.0,0,0,1,0,1
Qi Hong,3,372.0,0,0,5,2,7
Qiu Li,0,22.0,0,0,1,0,1
Qu Bo,0,194.0,0,0,3,2,5
Quah Kim Song,0,85.0,0,0,2,0,2
Quentin Clarke,1,135.0,0,0,1,2,3
Quincy Owusu-Abeyie,0,70.0,0,0,1,0,1
Quincy Promes,0,116.0,0,0,3,0,3
Quini,1,133.0,0,0,0,3,3
Quino Sierra,0,35.0,0,0,2,0,2
Quinton Fortune,1,111.0,0,2,1,1,2
Quinton Griffith,0,182.0,0,1,1,3,4
Quinzinho,1,52.0,0,0,0,1,1
Qusay Munir,4,294.0,0,0,3,2,5
Quế Ngọc Hải,2,201.0,0,3,1,2,3
Raafat Attia,0,21.0,0,1,0,1,1
Rabah Gamouh,0,129.0,0,0,0,2,2
Rabah Madjer,3,808.0,0,1,11,3,14
Rabia Al-Alawi,1,331.0,0,0,1,4,5
Rabih Ataya,1,73.0,0,0,0,1,1
Rachad Chitou,0,60.0,0,0,1,0,1
Rached Meddeb,1,128.0,0,0,1,1,2
Rachid Alioui,1,64.0,0,0,1,0,1
Rachid Benmahmoud,1,94.0,0,1,0,2,2
Rachid Daoudi,0,123.0,0,0,0,3,3
Rachid Maâtar,1,86.0,0,0,1,0,1
Rachid Rokki,0,49.0,0,0,1,0,1
Radamel Falcao,3,923.0,0,4,12,4,16
Rade Krunić,0,47.0,0,0,2,0,2
Radek Bejbl,1,142.0,0,0,2,1,3
Radek Drulák,0,170.0,0,0,3,0,3
Radhi Jaïdi,2,239.0,0,0,2,2,4
Radhi Shenaishil,1,90.0,0,0,1,0,1
Radhwan Nairooz,0,52.0,0,0,1,0,1
Radike Nawasu,0,110.0,0,0,0,2,2
Radivoje Ognjanović,1,18.0,0,0,0,1,1
Radja Nainggolan,2,167.0,0,0,0,4,4
Radomir Đalović,0,53.0,0,0,1,0,1
Radoslav Batak,0,13.0,0,0,1,0,1
Radoslav Dimitrov,0,9.0,0,0,0,1,1
Radoslav Kováč,0,69.0,0,0,1,1,2
Radoslav Látal,1,78.0,0,0,2,0,2
Radoslav Zabavník,0,90.0,0,0,1,0,1
Radostin Kishishev,0,77.0,1,0,2,0,2
Radosław Kałużny,0,229.0,0,0,3,3,6
Radosław Matusiak,0,95.0,0,0,1,2,3
Radu Gînsari,0,15.0,0,0,1,0,1
Radu Nunweiller,0,129.0,0,0,1,1,2
Radu Rebeja,0,158.0,0,0,0,2,2
Radwan Abduljabar,0,49.0,0,0,1,0,1
Radwan Al-Sheikh Hassan,1,52.0,0,0,2,0,2
Raed Ibrahim Saleh,0,7.0,0,0,1,0,1
Raf de Gregorio,1,117.0,0,0,1,1,2
Rafael Albrecht,1,231.0,0,1,3,0,3
Rafael Alsua,0,65.0,0,0,1,0,1
Rafael Arlex Castillo,0,82.0,0,0,0,1,1
Rafael Burgos,0,236.0,0,0,2,1,3
Rafael Castellín,0,55.0,0,0,0,1,1
Rafael Dick,0,56.0,0,0,1,0,1
Rafael Dudamel,0,87.0,0,0,1,0,1
Rafael García Torres,0,42.0,0,0,1,0,1
Rafael Gordillo,1,201.0,0,0,1,2,3
Rafael Granados,1,90.0,0,0,0,1,1
Rafael Iriarte,0,86.0,0,0,1,0,1
Rafael Leão,2,170.0,0,0,2,0,2
Rafael Maldonado,1,74.0,0,0,0,1,1
Rafael Morales,0,85.0,0,0,2,0,2
Rafael Márquez,6,684.0,0,0,8,5,13
Rafael Olarra,1,40.0,0,0,0,1,1
Rafael Santana,3,295.0,0,0,3,2,5
Rafael Urazbakhtin,1,21.0,0,0,0,1,1
Rafael van der Vaart,1,673.0,0,1,8,7,15
Rafael Ávalos,0,6.0,0,0,0,1,1
Rafał Boguski,0,28.0,0,0,2,0,2
Rafał Murawski,0,28.0,0,0,0,1,1
Rafał Siadaczka,0,22.0,0,0,0,1,1
Rafał Wolski,0,89.0,0,0,0,1,1
Rafi Ali,1,60.0,0,0,0,1,1
Rafi Joulfagi,1,122.0,0,0,1,1,2
Rafi Levi,1,13.0,0,0,1,0,1
Rafik Djebbour,0,91.0,0,0,2,0,2
Rafik Halliche,2,71.0,0,0,0,2,2
Rafik Saïfi,0,231.0,0,0,4,1,5
Rafik Yusupov,1,28.0,0,0,1,0,1
Rafiou Moutairou,1,56.0,0,0,0,1,1
Raghdan Shehadeh,0,92.0,0,0,2,0,2
Ragnar Klavan,0,165.0,3,0,2,1,3
Ragnar Margeirsson,0,48.0,0,0,0,1,1
Ragnar Sigurðsson,1,158.0,0,0,3,2,5
Rahamim Talbi,0,48.0,0,0,1,0,1
Raheem Sterling,1,830.0,0,0,12,4,16
Raheim Sargeant,0,4.0,0,0,0,1,1
Rahid Amirguliyev,0,177.0,0,0,0,3,3
Rahmad Darmawan,1,35.0,0,0,1,0,1
Rahman Hisham Abdullah,0,66.0,0,0,1,0,1
Rahman Rezaei,1,61.0,1,0,1,1,2
Rahmatullo Fuzailov,1,52.0,0,0,1,0,1
Raimondo Ponte,0,59.0,0,0,0,1,1
Raimonds Krollis,0,75.0,0,0,0,1,1
Raimundo Infante,3,208.0,0,1,2,1,3
Raimundo Orsi,0,170.0,0,0,3,0,3
Raimundo Sandoval,1,9.0,0,0,1,0,1
Rainer Bonhof,0,71.0,0,1,2,0,2
Rainer Ernst,0,591.0,0,1,4,5,9
Rainer Rauffmann,0,111.0,0,0,2,0,2
Rainford Kalaba,2,126.0,0,0,1,2,3
Raio Piiroja,0,488.0,3,0,4,5,9
Raja Rafe,2,481.0,0,0,4,4,8
Rajab Elharbi,0,35.0,0,0,1,0,1
Rajabu Mwinyi,0,16.0,1,0,1,0,1
Rajko Mitić,1,59.0,0,0,0,1,1
Raju Kaji Shakya,1,1.0,1,0,0,1,1
Ralf Edström,3,367.0,0,0,7,2,9
Ralf Minge,0,213.0,0,0,2,3,5
Ralph Bean,0,122.0,0,0,2,1,3
Ralph Brand,0,140.0,0,0,2,1,3
Ralph McPate,0,108.0,0,0,2,0,2
Ramadan Agab,0,154.0,0,0,0,3,3
Ramadan El Sayed,1,47.0,0,0,0,1,1
Ramadan Sobhi,0,72.0,0,0,0,1,1
Raman Vasilyuk,0,351.0,0,2,5,2,7
Raman Vijayan,1,81.0,0,0,1,0,1
Ramaz Shengelia,4,299.0,0,0,5,1,6
Ramazan Rragami,0,25.0,0,1,1,0,1
Ramez Dayoub,0,72.0,1,0,0,1,1
Rami Bedoui,1,90.0,1,0,1,0,1
Rami Gershon,0,160.0,0,0,1,1,2
Ramil Sheydayev,0,82.0,0,0,1,2,3
Ramin Ott,1,94.0,0,0,1,1,2
Ramin Rezaeian,1,139.0,0,0,0,2,2
Ramiro Blacut,0,83.0,0,0,2,0,2
Ramiro Borja,0,57.0,0,0,0,1,1
Ramiro Castillo,0,119.0,0,0,1,1,2
Ramiro Funes Mori,0,15.0,0,0,0,1,1
Ramiro Navarro,0,57.0,0,0,1,0,1
Ramiro Tobar,0,79.0,1,0,1,0,1
Ramiro Vaca,0,83.0,0,0,1,0,1
Ramiz Zerrouki,0,69.0,0,0,1,0,1
Ramkel Lok,0,74.0,0,0,1,0,1
Ramon Djamali,1,98.0,0,0,1,1,2
Ramon Gjamaci,0,66.0,0,0,0,1,1
Ramon Menezes,1,30.0,0,0,0,1,1
Ramoseli Thietsi,0,30.0,0,0,0,1,1
Ramy Bensebaini,0,27.0,0,0,1,0,1
Ramón Bóveda,0,80.0,0,0,1,0,1
Ramón Calderé,2,164.0,0,0,0,3,3
Ramón Castro,3,172.0,0,0,0,4,4
Ramón Colmán,1,81.0,0,0,0,1,1
Ramón Díaz,1,89.0,0,0,1,0,1
Ramón Grosso,0,63.0,0,0,1,0,1
Ramón Heredia,1,60.0,0,0,0,1,1
Ramón Hicks,0,15.0,0,0,1,0,1
Ramón Iriarte,0,14.0,0,0,1,0,1
Ramón Mariano,0,50.0,0,0,1,0,1
Ramón Medina Bello,0,217.0,0,0,1,3,4
Ramón Morales,2,62.0,0,0,0,3,3
Ramón Núñez,0,168.0,0,0,1,2,3
Ramón Quevedo,0,29.0,0,0,1,0,1
Ramón Ramírez,4,531.0,0,0,7,4,11
Ramón Santos,2,91.0,0,0,2,0,2
Ramón Sánchez,1,38.0,0,0,1,0,1
Ramón Víctor Castro,1,73.0,0,0,0,1,1
Ramūnas Stonkus,0,47.0,0,0,1,0,1
Randal Kolo Muani,1,79.0,0,0,1,0,1
Randall Azofeifa,0,160.0,0,0,1,1,2
Randall Brenes,3,368.0,0,1,5,1,6
Randolph Burton,0,262.0,0,0,2,2,4
Randolph Peltier,0,80.0,0,0,1,0,1
Rangelo Janga,0,87.0,0,0,0,1,1
Rangsan Viwatchaichok,1,15.0,1,0,1,0,1
Ranjae Christian,0,18.0,0,0,0,1,1
Raouf Bouzaiene,1,17.0,0,0,1,0,1
Raoul Lambert,2,709.0,0,5,11,2,13
Raphael Chukwu,0,45.0,0,0,1,0,1
Raphael Lea'i,4,233.0,0,0,4,0,4
Raphael Rohrer,0,69.0,0,0,0,1,1
Raphaël Guerreiro,1,178.0,1,0,2,1,3
Raphaël Mirval,1,45.0,0,0,0,1,1
Raphaël Varane,1,102.0,0,0,1,2,3
Raphaël Wicky,0,25.0,0,0,0,1,1
Raphel Ortiz,0,19.0,0,0,1,1,2
Raphinha,0,104.0,0,0,3,0,3
Rashad Sadygov,0,348.0,3,0,6,0,6
Rasheed Yekini,0,176.0,0,0,2,1,3
Rashid Abdulrahman,0,24.0,0,0,1,0,1
Rashid Al-Wahaibi,2,116.0,0,0,0,2,2
Rashid Juma Al-Farsi,0,90.0,1,0,1,0,1
Rashid Mohammed Rashid,0,90.0,0,0,1,0,1
Rashida Williams,0,43.0,0,0,0,1,1
Rashidi Yekini,14,781.0,0,1,15,6,21
Rasmus Elm,0,127.0,0,0,1,1,2
Rateb Al-Awadat,0,85.0,0,0,1,0,1
Rateb Al-Dawud,0,139.0,0,0,1,1,2
Rathnayake Mudyanselage,0,57.0,0,0,1,0,1
Ratu Jone,0,200.0,0,0,2,1,3
Rauf Aliyev,0,144.0,0,0,2,1,3
Raul Meireles,2,231.0,0,0,3,2,5
Raul Rusescu,0,45.0,0,0,1,0,1
Rauno Sappinen,1,12.0,0,0,1,0,1
Ravel Morrison,0,45.0,0,0,1,0,1
Ravshan Bazarav,0,90.0,0,0,1,0,1
Ravshan Bozorov,0,101.0,0,0,1,2,3
Ravuame Madigi,0,66.0,0,0,1,0,1
Ray Baartz,1,272.0,0,0,2,3,5
Ray Daniel,0,21.0,1,0,1,0,1
Ray Houghton,2,229.0,0,0,3,3,6
Ray Kennedy,0,96.0,0,0,1,1,2
Ray Pointer,0,46.0,0,0,2,0,2
Ray Richards,0,121.0,0,0,2,0,2
Ray Treacy,0,168.0,0,0,2,1,3
Ray Wilkins,1,26.0,0,0,0,1,1
Raydell Schuurman,1,88.0,0,0,0,1,1
Rayed Al-Boloushi,1,65.0,0,0,0,1,1
Raymond Braine,0,55.0,0,0,0,1,1
Raymond Cicci,0,41.0,0,0,0,1,1
Raymond Davelaar,0,98.0,0,1,1,1,2
Raymond Gunemba,0,382.0,0,0,6,1,7
Raymond Kalla,1,29.0,0,0,1,0,1
Raymond Kopa,4,323.0,0,3,5,2,7
Raymond Valette,0,90.0,0,0,0,1,1
Raymond Xuereb,0,84.0,0,0,1,0,1
Razak Omotoyossi,2,597.0,0,2,6,7,13
Razali Saad,0,214.0,0,0,3,0,3
Razimie Ramlli,0,39.0,0,0,2,0,2
Razmik Grigoryan,0,84.0,0,0,1,1,2
Razundara Tjikuzu,0,150.0,0,0,4,0,4
Razzaq Farhan,4,116.0,0,0,2,2,4
Raí,1,126.0,0,2,2,2,4
Raúl,6,1496.0,0,0,18,14,32
Raúl Alvarez,0,139.0,0,0,2,0,2
Raúl Armando Savoy,4,210.0,0,0,4,0,4
Raúl Avilés,0,166.0,0,0,1,1,2
Raúl Belén,0,150.0,0,0,3,0,3
Raúl Bernao,2,197.0,0,0,3,1,4
Raúl Cárdenas,1,77.0,1,0,2,0,2
Raúl Díaz Arce,2,1046.0,0,2,14,6,20
Raúl Echeverría,2,191.0,0,0,2,1,3
Raúl Fernández,1,57.0,0,0,1,0,1
Raúl Jiménez,9,1041.0,0,6,12,5,17
Raúl Justiniano,0,38.0,0,0,1,0,1
Raúl Leguías,0,174.0,0,0,1,4,5
Raúl Morales,0,30.0,0,0,1,0,1
Raúl Muñoz,1,3.0,0,0,1,0,1
Raúl Noriega,0,104.0,0,0,2,0,2
Raúl Núñez Velloso,1,78.0,0,0,0,1,1
Raúl Palacios,1,81.0,0,0,1,0,1
Raúl Pérez,0,20.0,0,0,1,0,1
Raúl Ruidíaz,1,165.0,0,0,1,1,2
Raúl Sarro,1,38.0,0,0,0,2,2
Raúl Schiaffino,1,57.0,0,0,0,1,1
Raúl Servín,0,61.0,0,0,1,0,1
Raúl Tamudo,0,14.0,0,0,0,1,1
Raúl Toro Julio,7,327.0,0,0,6,3,9
Raşit Çetiner,0,73.0,1,0,1,0,1
Recep Adanır,0,31.0,0,0,0,1,1
Recep Çetin,0,39.0,0,0,1,0,1
Reda Al-Senussi,0,33.0,0,0,1,0,1
Redha Abujabarah,0,90.0,0,0,1,0,1
Redha Tukar,0,188.0,0,0,3,0,3
Redjep Agabaev,0,39.0,0,0,1,0,1
Redouane Guezzar,1,87.0,0,0,1,0,1
Redwan Abrash,2,170.0,0,0,0,2,2
Reece Styche,0,147.0,0,1,1,2,3
Reg Ryan,0,106.0,0,2,2,0,2
Reginal Garo,0,27.0,0,0,0,1,1
Reginald Davani,6,237.0,0,0,1,6,7
Reid Klopp,0,147.0,0,0,1,1,2
Reidar Kvammen,2,143.0,0,0,2,2,4
Reinaldo Gomes,0,42.0,0,0,1,0,1
Reinaldo Navia,1,256.0,0,1,1,3,4
Reinhard Häfner,0,177.0,0,0,0,3,3
Reinhard Libuda,1,99.0,0,0,1,1,2
Reinhold Hintermaier,1,68.0,0,0,1,0,1
Rejepmyrat Agabaýew,1,262.0,0,0,4,0,4
Remo Eyoma,0,34.0,0,0,1,0,1
Remo Freuler,1,157.0,0,0,2,1,3
Renan Bardini Bressan,0,6.0,0,0,1,0,1
Renato Augusto,3,357.0,0,0,5,1,6
Renato Gaúcho,1,41.0,0,0,2,0,2
Renato Sanches,1,35.0,0,0,1,1,2
Renato Steffen,0,42.0,0,0,0,1,1
Renato Tapia,1,185.0,1,0,4,0,4
Renato Zaccarelli,1,125.0,0,0,1,1,2
Rene Krhin,0,163.0,0,0,0,2,2
Rene N'Djeya,1,32.0,0,0,1,0,1
Renedy Singh,0,68.0,0,0,2,0,2
Renne Regis,0,46.0,0,0,1,0,1
Renny Ribera,1,40.0,0,0,1,0,1
Renson Haynes,0,58.0,0,0,0,2,2
Rensy Barradas,0,76.0,0,0,0,1,1
Renán Bengoche,0,89.0,0,0,0,1,1
Renán López,0,16.0,0,0,1,0,1
René Aufhauser,0,295.0,0,0,5,0,5
René Bader,1,10.0,0,0,0,1,1
René Borjas,1,44.0,0,0,0,2,2
René Dereuddre,0,36.0,0,0,1,0,1
René Girard,1,13.0,0,0,0,1,1
René Higuita,2,121.0,1,1,1,1,2
René Houseman,3,125.0,0,0,4,0,4
René Maillard,0,21.0,0,0,1,1,2
René Meléndez,2,188.0,0,0,3,2,5
René Nsi-Akoue,0,25.0,1,0,1,0,1
René Peters,1,52.0,0,0,1,1,2
René Pontoni,8,225.0,0,0,8,0,8
René Vandereycken,1,96.0,0,2,2,0,2
René van de Kerkhof,1,212.0,0,0,2,2,4
René-Pierre Quentin,1,259.0,0,0,6,3,9
Renārs Rode,0,90.0,0,0,1,0,1
Reon Moore,1,12.0,0,0,0,1,1
Reung Bunheing,1,89.0,0,0,0,1,1
Reuven Atar,0,90.0,0,0,0,1,1
Reuven Young,0,38.0,0,0,1,0,1
Rey Manaj,0,240.0,0,0,2,2,4
Reynald Pedros,0,49.0,0,0,1,0,1
Reynald Temarii,1,8.0,0,1,1,0,1
Reynaldo Clavasquín,1,32.0,0,0,1,0,1
Reynaldo Mejia,0,73.0,0,0,1,0,1
Reynaldo Parks,1,58.0,0,0,1,0,1
Reynier Alcántara,2,97.0,0,0,0,2,2
Reynold Carrington,0,30.0,0,0,1,0,1
Reynold Saint Surin,0,90.0,0,0,1,0,1
Reza Enayati,1,139.0,0,0,1,2,3
Reza Ghoochannejhad,3,553.0,0,0,4,3,7
Reza Hassanzadeh,1,45.0,0,0,0,1,1
Reza Shahroudi,1,134.0,0,0,2,1,3
Rezaul Karim,0,56.0,0,0,1,0,1
Rhyan Grant,0,43.0,0,0,0,1,1
Rhys Browne,0,20.0,0,0,1,0,1
Ri Han-jae,0,1.0,0,0,1,0,1
Ri Hyok-chol,0,146.0,0,0,2,2,4
Ri Hyok-chon,0,102.0,0,0,2,0,2
Riadh Bouazizi,1,53.0,0,0,1,0,1
Riadh Jelassi,1,177.0,0,0,1,1,2
Ricard Fernández,0,89.0,0,0,0,1,1
Ricardo Adé,1,111.0,0,0,1,1,2
Ricardo Alcón,3,122.0,0,0,3,1,4
Ricardo Altamirano,1,67.0,0,0,1,0,1
Ricardo Aquino,1,88.0,0,0,0,1,1
Ricardo Bonelli,1,11.0,0,0,1,0,1
Ricardo Buitrago,0,82.0,0,0,1,1,2
Ricardo Cabanas,0,71.0,0,0,1,0,1
Ricardo Carvalho,0,151.0,1,0,3,1,4
Ricardo Clark,1,97.0,0,0,1,1,2
Ricardo Costa,0,28.0,0,0,1,0,1
Ricardo Díaz,0,89.0,0,0,1,0,1
Ricardo Francisco Rojas,0,64.0,0,0,0,1,1
Ricardo Fuller,1,127.0,0,0,1,2,3
Ricardo Gardner,0,73.0,0,0,2,0,2
Ricardo Gareca,0,136.0,0,0,2,0,2
Ricardo Gomes,0,135.0,0,0,3,0,3
Ricardo González,0,15.0,1,0,1,0,1
Ricardo Horta,1,5.0,0,0,0,1,1
Ricardo Hyde,0,57.0,0,0,1,0,1
Ricardo José Maria Ramaciotti,0,75.0,0,0,0,1,1
Ricardo Mannetti,1,70.0,0,0,0,1,1
Ricardo Oliveira,1,239.0,0,0,1,2,3
Ricardo Osorio,1,97.0,1,0,2,0,2
Ricardo Pavoni,1,87.0,0,0,0,1,1
Ricardo Peláez,4,351.0,0,0,2,4,6
Ricardo Pepi,0,186.0,0,0,2,1,3
Ricardo Phillips,2,123.0,0,0,1,2,3
Ricardo Páez,0,111.0,0,0,1,1,2
Ricardo Quaresma,4,354.0,0,0,2,3,5
Ricardo Rivera,1,140.0,0,1,3,1,4
Ricardo Rodríguez,0,228.0,0,2,1,3,4
Ricardo Sá Pinto,1,396.0,0,0,4,4,8
Riccardo Carapellese,2,19.0,0,0,2,0,2
Riccardo Ferri,0,12.0,0,0,0,1,1
Riccardo Montolivo,0,34.0,0,0,1,0,1
Riccardo Orsolini,0,78.0,0,0,1,0,1
Richard Aquilina,0,33.0,0,0,1,0,1
Richard Báez,0,5.0,0,0,0,1,1
Richard Daddy Owubokiri,0,34.0,0,0,1,0,1
Richard Daniel,0,15.0,0,0,1,0,1
Richard Dunne,0,187.0,0,0,3,3,6
Richard Dürr,0,56.0,0,1,1,0,1
Richard Gough,0,175.0,0,0,1,2,3
Richard Hastings,1,92.0,0,0,0,1,1
Richard Herrmann,1,84.0,0,0,1,0,1
Richard Iwai,9,414.0,0,0,2,7,9
Richard José Blanco,0,55.0,0,0,0,1,1
Richard Kreß,0,29.0,0,0,1,0,1
Richard Kuremaa,0,117.0,0,0,0,2,2
Richard Mbulu,1,10.0,0,0,1,0,1
Richard Morales,2,238.0,0,0,2,2,4
Richard O'Connor,0,40.0,0,1,0,1,1
Richard Odada,0,15.0,0,1,1,0,1
Richard Orlans,0,61.0,0,0,2,0,2
Richard Ortiz,0,260.0,0,0,2,1,3
Richard Pacquette,0,21.0,0,0,1,0,1
Richard Rodríguez,0,25.0,0,0,1,0,1
Richard Sele,0,73.0,0,0,1,0,1
Richard Smith,0,142.0,0,0,3,0,3
Richard Socrier,1,20.0,0,0,0,1,1
Richard Sánchez,1,37.0,0,0,0,1,1
Richard Witschge,0,20.0,0,0,1,0,1
Richard Zambrano,2,110.0,0,0,0,2,2
Richardo Nabuth,0,18.0,0,0,1,0,1
Richardson Smith,0,208.0,1,1,2,2,4
Richarlison,3,743.0,0,1,7,4,11
Richie Laryea,1,53.0,0,0,1,0,1
Richmond Boakye,1,215.0,0,0,1,3,4
Richárd Guzmics,0,133.0,0,0,0,2,2
Ricki Herbert,0,130.0,0,0,2,0,2
Rickie Lambert,0,26.0,0,0,1,0,1
Ricky Charles,0,384.0,0,0,6,2,8
Ricky Phuka,0,44.0,0,0,0,1,1
Ricky Shakes,0,168.0,0,0,1,2,3
Ridle Baku,0,80.0,0,0,1,0,1
Rifaat Turk,0,137.0,0,0,3,0,3
Rifat Zhemaletdinov,0,55.0,0,0,0,1,1
Rigobert Song,0,72.0,0,0,2,1,3
Rigoberto Gómez,1,82.0,0,0,2,0,2
Rigoberto Rojas,0,28.0,0,0,1,0,1
Rihairo Meulens,0,9.0,0,0,0,1,1
Rija Rakotomandimby,0,127.0,0,0,1,1,2
Riki van Steeden,0,85.0,0,0,1,0,1
Riku Riski,0,131.0,0,0,0,2,2
Rildo da Costa Menezes,1,73.0,0,0,1,0,1
Riley McGree,0,76.0,0,0,1,0,1
Rinaldo Martino,4,232.0,0,0,5,0,5
Rinat Abdulin,0,27.0,0,0,1,1,2
Rino Moretta,1,80.0,0,0,1,0,1
Rinus Israël,0,208.0,0,1,2,1,3
Rio Ferdinand,1,141.0,0,0,2,1,3
Risdianto,1,44.0,0,0,0,1,1
Risto Božinov,0,67.0,0,0,2,0,2
Risto Radunović,0,90.0,0,0,0,1,1
Ritsu Dōan,4,251.0,0,1,2,2,4
Rivaldo,12,1043.0,0,3,17,4,21
Rivaldo Vítor Borba Ferreira,1,42.0,0,0,0,1,1
Rivellino,6,368.0,0,0,5,2,7
Riyad Mahrez,6,534.0,0,1,10,2,12
Riyadh Nouri,1,161.0,0,0,1,1,2
Rizvi Karim Rumi,2,80.0,0,0,1,1,2
Ro Hak-su,0,34.0,0,0,1,0,1
Roald Jensen,0,59.0,0,0,0,1,1
Rob Rensenbrink,6,565.0,0,5,6,5,11
Rob Witschge,1,109.0,0,0,3,0,3
Rob de Wit,0,141.0,0,0,1,1,2
Robbie Brady,1,259.0,0,1,1,3,4
Robbie Dunn,0,91.0,0,1,2,0,2
Robbie Earle,1,45.0,0,0,1,0,1
Robbie Fowler,0,88.0,0,0,1,0,1
Robbie Hooker,0,11.0,0,0,1,0,1
Robbie James,0,159.0,0,0,2,1,3
Robbie Keane,5,1935.0,0,10,28,16,44
Robbie Kruse,2,229.0,0,0,2,2,4
Robbie Rogers,0,60.0,0,0,1,0,1
Robbie Savage,0,30.0,0,0,0,2,2
Robbie Slater,0,15.0,0,0,1,0,1
Robby Darwis,1,77.0,1,0,1,0,1
Robby Langers,0,365.0,0,0,5,1,6
Robert Arboleda,0,7.0,0,0,1,0,1
Robert Arzumanyan,0,172.0,0,0,3,1,4
Robert Ballaman,0,254.0,0,0,8,0,8
Robert Berić,0,63.0,0,0,1,0,1
Robert Cavallo,1,21.0,1,0,1,0,1
Robert Clarke,1,25.0,0,0,1,0,1
Robert Dienst,0,106.0,0,0,1,1,2
Robert Earnshaw,0,272.0,0,0,4,1,5
Robert Edmond,0,28.0,0,0,1,0,1
Robert Gadocha,0,209.0,0,0,7,0,7
Robert Herbin,0,175.0,0,0,2,1,3
Robert Hosp,0,10.0,0,0,1,0,1
Robert Huth,0,79.0,0,0,1,0,1
Robert Ironside,0,64.0,0,0,1,0,1
Robert Jama Mba,0,42.0,0,0,2,0,2
Robert Jarni,1,129.0,0,0,0,2,2
Robert Jashari,0,49.0,0,0,0,1,1
Robert Kaumé,1,72.0,0,0,1,0,1
Robert Kizito,0,3.0,0,0,0,1,1
Robert Koren,1,216.0,0,0,3,1,4
Robert Lewandowski,9,2838.0,0,11,29,27,56
Robert Lüthi,0,75.0,0,0,0,1,1
Robert Morales,0,10.0,0,0,1,0,1
Robert Nauseb,1,33.0,0,0,0,1,1
Robert Ng'ambi,0,214.0,0,0,3,0,3
Robert Pires,2,266.0,0,1,5,1,6
Robert Prosinečki,3,526.0,0,1,5,5,10
Robert Prytz,0,274.0,0,2,3,3,6
Robert Sara,0,59.0,0,0,0,1,1
Robert Seni,2,389.0,0,0,4,2,6
Robert Skov,0,163.0,0,0,3,1,4
Robert Snodgrass,0,297.0,0,1,1,5,6
Robert St. Fort,0,110.0,0,2,2,0,2
Robert Suzette,0,69.0,0,0,0,1,1
Robert Tasso,3,216.0,0,0,2,1,3
Robertas Fridrikas,0,133.0,0,0,1,1,2
Robertas Poškus,0,37.0,0,0,1,0,1
Roberto Acuña,1,147.0,0,1,1,2,3
Roberto Alvarado,1,40.0,0,0,1,0,1
Roberto Ayala,2,228.0,3,0,2,4,6
Roberto Baggio,7,1018.0,0,4,9,8,17
Roberto Batata,0,139.0,0,0,3,0,3
Roberto Bettega,1,662.0,0,0,6,7,13
Roberto Boninsegna,2,147.0,0,0,2,4,6
Roberto Brown,0,315.0,0,1,5,2,7
Roberto Cabañas,3,256.0,0,0,6,0,6
Roberto Carlos,1,147.0,0,0,2,1,3
Roberto Castillo,1,11.0,0,0,1,0,1
Roberto Challe,1,118.0,0,0,0,2,2
Roberto Chen,0,90.0,0,0,0,1,1
Roberto Cherro,3,94.0,0,0,4,0,4
Roberto Colautti,0,231.0,0,0,3,3,6
Roberto Di Matteo,0,24.0,0,0,1,0,1
Roberto Dinamite,4,380.0,0,2,8,3,11
Roberto Donadoni,0,24.0,0,0,4,0,4
Roberto Drago,5,292.0,0,0,0,5,5
Roberto Emílio da Cunha,3,137.0,0,0,3,0,3
Roberto Fernández,0,90.0,0,0,1,0,1
Roberto Fernández Bonillo,0,30.0,0,0,0,1,1
Roberto Figueroa,3,155.0,0,0,0,3,3
Roberto Firmino,2,527.0,0,0,9,0,9
Roberto Gayón,1,75.0,0,0,0,1,1
Roberto Guadalupe Martínez,0,14.0,0,0,1,0,1
Roberto Gámez,2,131.0,0,0,1,1,2
Roberto Holsen,4,210.0,0,0,3,1,4
Roberto Jonas,1,42.0,0,0,1,0,1
Roberto Juan Martínez,0,119.0,0,0,1,1,2
Roberto Kettlun,3,210.0,0,0,3,0,3
Roberto Linares,0,133.0,0,0,3,1,4
Roberto Luco,1,39.0,0,0,1,0,1
Roberto López Ufarte,0,65.0,0,1,1,0,1
Roberto Mancini,0,258.0,0,0,2,2,4
Roberto Mosquera,0,71.0,0,0,1,0,1
Roberto Nurse,0,55.0,0,0,0,1,1
Roberto Orlando Affonso Júnior,0,83.0,0,0,1,0,1
Roberto Osvaldo Díaz,0,71.0,0,0,1,0,1
Roberto Palacios,4,837.0,0,0,8,6,14
Roberto Perfumo,1,35.0,1,0,0,1,1
Roberto Porta,6,582.0,0,0,5,7,12
Roberto Rivellino,0,85.0,0,0,1,0,1
Roberto Soldado,1,118.0,0,0,1,1,2
Roberto Troncoso,0,55.0,1,0,1,0,1
Roberto Zárate,3,203.0,0,0,5,0,5
Roberts Savaļnieks,0,35.0,0,0,0,1,1
Roberts Uldriķis,0,113.0,0,0,0,2,2
Robin Betancourth,1,147.0,0,0,1,1,2
Robin Gosens,0,60.0,0,0,1,0,1
Robin Lod,0,90.0,0,0,0,2,2
Robin Ngalande,0,47.0,0,0,1,0,1
Robin Quaison,0,469.0,0,0,4,4,8
Robin Singh,0,10.0,0,0,1,0,1
Robin van Persie,8,1915.0,1,4,23,13,36
Robinho,12,764.0,0,2,10,8,18
Robiul Hasan,0,72.0,0,0,0,1,1
Roby Young,1,70.0,0,0,0,1,1
Rocky Putiray,0,126.0,0,0,3,0,3
Rocky Siberie,1,256.0,0,0,3,4,7
Roda Antar,2,612.0,0,0,8,4,12
Roderick Briffa,0,38.0,0,0,0,1,1
Roderick Reid,2,110.0,0,0,2,1,3
Rodger Gray,0,74.0,0,0,0,1,1
Rodion Cămătaru,0,359.0,0,0,3,5,8
Rodney Jack,0,244.0,0,0,8,2,10
Rodney Wallace,1,79.0,0,0,1,0,1
Rodolfo Bodipo,0,83.0,0,1,0,1,1
Rodolfo Carvajal,0,70.0,0,0,1,0,1
Rodolfo Dubó,0,34.0,0,0,2,0,2
Rodolfo Herrera González,0,144.0,0,0,3,0,3
Rodolfo Micheli,7,355.0,0,1,7,1,8
Rodolfo Pizarro,1,4.0,0,0,1,0,1
Rodolfo Zelaya,8,660.0,0,3,12,3,15
Rodolph Austin,1,172.0,0,1,3,0,3
Rodrigo,2,185.0,0,0,4,1,5
Rodrigo Barrera,0,23.0,0,0,1,0,1
Rodrigo Bentancur,0,1.0,0,0,1,0,1
Rodrigo Cordero,0,90.0,0,0,1,0,1
Rodrigo De Paul,1,84.0,0,0,2,0,2
Rodrigo Lemos,1,61.0,0,1,1,0,1
Rodrigo Meléndez,0,21.0,0,0,0,1,1
Rodrigo Millar,1,100.0,0,0,2,0,2
Rodrigo Palacio,0,137.0,0,0,2,0,2
Rodrigo Ramallo,0,85.0,0,0,3,0,3
Rodrigo Tello,0,29.0,0,0,0,1,1
Rodrygo,0,88.0,0,0,1,0,1
Rogelio Delgado,0,46.0,0,0,1,0,1
Rogelio Farias,1,58.0,0,0,1,0,1
Rogelio Funes Mori,3,186.0,0,0,2,2,4
Roger Beck,0,20.0,0,0,0,1,1
Roger Claessen,0,185.0,0,0,1,2,3
Roger Espinoza,1,25.0,0,0,1,0,1
Roger Guerreiro,0,30.0,0,0,0,1,1
Roger Hunt,0,228.0,0,0,3,1,4
Roger Ljung,1,93.0,0,0,1,1,2
Roger Lukaku,1,162.0,0,1,2,1,3
Roger Mandin,1,90.0,0,0,1,0,1
Roger Marche,0,85.0,1,0,1,0,1
Roger Martínez,1,140.0,0,0,0,2,2
Roger Milla,11,996.0,0,1,15,5,20
Roger Nilsen,0,113.0,0,0,2,0,2
Roger Piantoni,3,486.0,0,0,6,2,8
Roger Proverbs,0,63.0,0,0,0,1,1
Roger Rojas,0,88.0,0,0,1,0,1
Roger Suárez,0,162.0,0,0,3,0,3
Roger Van Gool,0,56.0,0,0,2,0,2
Roger Vonlanthen,0,92.0,0,0,1,1,2
Roguy Méyé,1,226.0,0,0,2,2,4
Roh Sang-Rae,0,18.0,0,0,0,1,1
Rohan Ince,1,60.0,0,0,1,0,1
Rohan Lennon,0,68.0,0,0,0,1,1
Rohann Simons,0,83.0,0,0,1,0,1
Roihau Degage,1,86.0,0,0,1,0,1
Rok Kronaveter,0,74.0,0,0,1,0,1
Rokonuzzaman Kanchan,1,85.0,0,0,0,1,1
Roland Alberg,1,74.0,0,0,0,1,1
Roland Citherlet,0,28.0,0,0,1,0,1
Roland Ducke,0,26.0,0,0,0,1,1
Roland Grip,0,49.0,0,0,0,1,1
Roland Hattenberger,1,82.0,0,0,1,1,2
Roland Juhász,0,184.0,0,0,2,1,3
Roland Kirchler,0,53.0,0,0,1,0,1
Roland Kollmann,0,115.0,0,0,2,0,2
Roland Linz,0,231.0,0,0,1,2,3
Roland Sallai,0,101.0,0,1,1,2,3
Roland Sandberg,2,371.0,0,0,4,4,8
Roland Ugrai,0,89.0,0,0,0,1,1
Roland de Marigny,1,90.0,0,0,0,1,1
Rolandas Baravykas,0,55.0,0,0,1,0,1
Rolando Blackburn,2,232.0,0,0,4,4,8
Rolando Fonseca,5,828.0,0,1,9,7,16
Rolando Vargas,0,55.0,0,0,0,1,1
Rolf Blättler,0,207.0,0,0,6,0,6
Rolf Feltscher,0,54.0,1,0,1,0,1
Rolf Wüthrich,0,74.0,0,0,1,1,2
Rolf-Christel Guié-Mien,0,67.0,0,0,0,1,1
Roly Paniagua,0,85.0,0,0,1,0,1
Romain Michaux,0,73.0,0,0,1,0,1
Romain Saïss,2,94.0,0,0,1,1,2
Romain Schreiner,0,55.0,0,0,1,0,1
Romaine Sawyers,0,138.0,0,0,2,0,2
Roman Bezjak,0,190.0,0,0,3,0,3
Roman Bezus,0,218.0,0,0,1,2,3
Roman Eremenko,0,156.0,0,1,0,2,2
Roman Hubník,0,69.0,0,0,1,0,1
Roman Kosecki,0,292.0,0,0,3,1,4
Roman Lentner,0,52.0,0,0,1,0,1
Roman Ogaza,0,185.0,0,1,3,0,3
Roman Pavlyuchenko,4,872.0,0,5,13,3,16
Roman Shirokov,1,252.0,0,2,3,2,5
Roman Szewczyk,0,32.0,0,0,1,0,1
Roman Týce,0,40.0,0,0,0,1,1
Roman Uzdenov,0,44.0,0,0,1,0,1
Roman Wallner,0,142.0,0,1,2,0,2
Roman Wójcicki,0,142.0,1,0,0,2,2
Roman Yaremchuk,1,320.0,0,0,5,5,10
Roman Zozulya,0,107.0,0,0,1,1,2
Romar Frank,1,76.0,0,0,0,1,1
Romaric,1,93.0,0,0,1,2,3
Romario Ibarra,0,83.0,0,0,1,1,2
Romario Williams,2,108.0,0,0,1,1,2
Romell Quioto,3,458.0,0,0,6,4,10
Romelu Lukaku,9,1936.0,0,3,23,13,36
Romeo Benetti,2,208.0,0,0,1,2,3
Romeo Castelen,0,3.0,0,0,1,0,1
Romeo Kambou,0,117.0,0,0,2,0,2
Romeu Evangelista,0,2.0,0,0,0,1,1
Romeu Pellicciari,3,156.0,0,0,3,0,3
Romik Khachatryan,0,73.0,0,0,1,0,1
Romulo Gómez,1,100.0,2,0,1,2,3
Román Torres,2,341.0,1,0,6,0,6
Romário,17,1850.0,0,4,23,10,33
Ron Davies,1,213.0,0,1,2,2,4
Ron Flowers,2,217.0,0,3,2,2,4
Ronald Cerritos,2,344.0,0,0,4,2,6
Ronald García Nacho,0,106.0,0,0,2,0,2
Ronald Hernández,1,90.0,0,0,1,0,1
Ronald Koeman,2,471.0,0,4,4,4,8
Ronald Kreer,0,115.0,0,0,2,0,2
Ronald Leaky,0,21.0,0,0,1,0,1
Ronald Raldes,1,89.0,1,0,1,1,2
Ronald Rivero,0,33.0,1,0,0,1,1
Ronald Spelbos,0,40.0,0,0,1,0,1
Ronald Vargas,0,121.0,0,0,1,1,2
Ronald Worm,0,32.0,0,0,2,0,2
Ronald de Boer,3,669.0,0,1,6,5,11
Ronaldinho,11,799.0,0,5,13,4,17
Ronaldo,28,1800.0,0,5,29,10,39
Ronaldo Rodrigues de Jesus,1,73.0,0,0,1,0,1
Ronan Carolino Falcão,0,47.0,0,0,1,0,1
Ronen Harazi,1,474.0,0,0,7,3,10
Rong Zhixing,2,90.0,0,0,3,0,3
Roni Porokara,0,78.0,0,0,2,0,2
Ronnie Allen,0,68.0,0,0,0,1,1
Ronnie McKinnon,0,117.0,1,0,2,0,2
Ronnie Rees,0,93.0,0,0,2,0,2
Ronnie Whelan,1,144.0,0,0,2,1,3
Ronny Johnsen,0,106.0,0,0,1,1,2
Ronny Pattinasarany,0,4.0,0,0,0,1,1
Ronny Rosenthal,1,246.0,0,0,3,4,7
Ronny Wabia,2,165.0,0,0,3,1,4
Rony Martínez,1,4.0,0,0,0,1,1
Rony Morales,0,54.0,0,0,0,1,1
Roody Lormera,1,10.0,0,1,0,1,1
Roosevelt Desir,0,69.0,0,0,0,1,1
Roque Júnior,0,90.0,0,0,1,0,1
Roque Santa Cruz,5,1071.0,0,0,17,4,21
Rory Fallon,2,188.0,0,0,3,1,4
Rosdee Sulong,0,16.0,0,0,1,0,1
Rosdi Talib,1,48.0,0,0,1,1,2
Rosemond Pierre,1,84.0,0,0,0,1,1
Roshan Pereta,2,135.0,0,0,0,2,2
Ross Barkley,0,225.0,0,0,0,6,6
Ross McCormack,0,39.0,0,0,1,0,1
Rostislav Vojáček,0,34.0,0,0,1,0,1
Rotson Kilambe,1,136.0,0,0,1,2,3
Roudolphe Douala,0,20.0,0,0,1,0,1
Rouzbeh Cheshmi,1,90.0,0,0,0,1,1
Rowan Liburd,0,53.0,0,1,0,1,1
Roxey Fer,0,3.0,0,0,1,0,1
Roy Bentley,0,64.0,0,0,0,1,1
Roy Chipolina,1,84.0,1,0,1,1,2
Roy Contout,1,69.0,0,0,1,0,1
Roy Karang,0,89.0,0,0,1,0,1
Roy Kayara,4,161.0,0,0,4,2,6
Roy Keane,0,456.0,0,0,4,5,9
Roy Krishna,3,406.0,0,2,4,2,6
Roy Lassiter,0,184.0,0,0,1,2,3
Roy Makaay,1,114.0,0,0,1,1,2
Roy Miller,1,58.0,0,0,2,0,2
Roy Myers,3,154.0,0,0,1,2,3
Roy Myrie,0,264.0,0,0,1,3,4
Roy Sáenz,0,89.0,0,0,1,0,1
Roy Vanenburg,0,180.0,0,0,2,0,2
Roy Vernon,0,250.0,0,0,5,0,5
Roy Wegerle,0,226.0,0,0,1,2,3
Ruben Mendoza,0,73.0,0,0,1,1,2
Ruben Schaken,0,134.0,0,0,2,0,2
Ruben Vargas,0,107.0,0,0,1,1,2
Ruberth Morán,1,633.0,0,0,9,2,11
Rubilio Castillo,1,155.0,0,0,1,1,2
Rubin Okotie,0,97.0,0,0,2,0,2
Rubén Aveiro,2,161.0,0,0,0,2,2
Rubén Ayala,1,318.0,0,1,5,1,6
Rubén Baraja,0,135.0,0,0,2,1,3
Rubén Cano,0,219.0,0,0,2,1,3
Rubén Darío Bustos,0,144.0,0,0,2,0,2
Rubén Darío Hernández,0,67.0,0,0,1,0,1
Rubén Espinoza,0,51.0,0,0,1,0,1
Rubén Fernández,3,206.0,0,0,0,4,4
Rubén Guevara,0,112.0,0,0,1,1,2
Rubén Héctor Sosa,0,391.0,0,0,5,2,7
Rubén Jiménez,0,140.0,0,0,2,2,4
Rubén Jiménez Rodríguez,0,29.0,0,0,1,1,2
Rubén Marcos,5,250.0,0,1,6,1,7
Rubén Paz,1,192.0,0,0,2,1,3
Rubén Sosa,4,499.0,0,0,5,6,11
Rubén Toribio Díaz,1,83.0,0,0,0,1,1
Rubén de la Red,1,61.0,0,0,0,1,1
Rubén Óscar Valdez,0,126.0,0,0,0,2,2
Rudel Calero,0,79.0,0,0,1,0,1
Rudi Elsener,0,75.0,0,0,1,0,1
Rudi Flögel,0,102.0,0,0,1,1,2
Rudi Istenič,0,15.0,1,0,1,0,1
Rudi Smidts,0,27.0,0,0,1,0,1
Rudi Vata,0,158.0,0,0,0,2,2
Rudi Völler,10,1060.0,0,0,17,9,26
Rudinilson Silva,1,12.0,1,0,0,1,1
Rudis Corrales,1,374.0,0,0,7,1,8
Rudolf Belin,0,2.0,0,0,1,0,1
Rudolf Bester,0,138.0,0,0,2,2,4
Rudolf Brunnenmeier,0,194.0,0,0,1,2,3
Rudolf Kučera,0,90.0,0,0,0,1,1
Rudolf Noack,1,62.0,0,0,0,1,1
Rudolf Pichler,0,65.0,0,0,0,1,1
Rudolf Viertl,0,62.0,0,0,1,0,1
Rudolph Smith,0,8.0,1,0,0,1,1
Rudy Barrientos,0,12.0,0,0,1,0,1
Rudy Bhebey,0,76.0,0,0,0,2,2
Rudy Cardozo,0,66.0,0,0,1,1,2
Rudy Gestede,0,57.0,0,0,1,1,2
Rudy Ramírez,1,98.0,0,0,0,2,2
Rufat Dadashov,0,58.0,0,0,1,0,1
Rufino Gama,0,72.0,0,0,0,1,1
Ruggiero Rizzitelli,0,83.0,0,0,1,0,1
Rui Barros,1,147.0,0,0,2,1,3
Rui Campos,1,20.0,0,0,1,0,1
Rui Costa,1,1002.0,0,4,8,9,17
Rui Jordão,0,479.0,0,1,7,4,11
Rui Jorge,1,45.0,0,0,0,1,1
Rui Rodrigues,0,89.0,0,0,2,1,3
Rui da Gracia,0,14.0,0,0,1,0,1
Rui Águas,2,468.0,0,0,3,6,9
Rumen Hristov,0,78.0,0,0,1,0,1
Rune Bratseth,0,119.0,0,0,2,0,2
Rune Börjesson,0,142.0,0,0,3,0,3
Rune Ottesen,0,34.0,0,0,1,0,1
Rupak Ray Sharma,0,35.0,1,0,0,1,1
Rupena Raumati,0,31.0,1,0,1,0,1
Rupert Ryan,2,99.0,0,0,2,0,2
Ruphin Menakely,0,58.0,0,0,1,0,1
Rusi Gochev,0,93.0,0,0,1,1,2
Ruslan Abishov,0,152.0,0,0,2,1,3
Ruslan Baltiyev,1,492.0,0,2,4,4,8
Ruslan Barburoş,0,72.0,0,0,0,1,1
Ruslan Koryan,0,95.0,0,0,1,1,2
Ruslan Malinovskyi,0,149.0,0,0,2,1,3
Ruslan Mingazow,0,45.0,0,0,1,0,1
Ruslan Qurbanov,0,45.0,0,0,0,1,1
Ruslan Rotan,1,367.0,0,0,3,2,5
Ruslan Valiullin,0,164.0,0,0,2,0,2
Rusli Ramang,0,207.0,0,0,2,2,4
Russel Mwafulirwa,2,142.0,0,0,3,1,4
Russell Latapy,3,641.0,0,0,9,3,12
Russell Teibert,0,64.0,0,1,0,1,1
Rustam Khojaev,3,135.0,0,0,3,0,3
Rustam Usmonov,1,87.0,0,0,1,0,1
Rutger Backe,0,24.0,0,0,1,0,1
Ruud Geels,0,634.0,0,2,6,4,10
Ruud Gullit,2,677.0,0,0,7,8,15
Ruud Krol,2,198.0,1,0,4,0,4
Ruud Schoonhoven,0,180.0,0,0,2,0,2
Ruud van Nistelrooy,7,1656.0,0,1,21,8,29
Ruy Ramos,1,31.0,0,0,0,1,1
Ryan Babel,0,148.0,0,0,0,3,3
Ryan Bertrand,0,86.0,0,0,0,1,1
Ryan Camilleri,0,52.0,1,0,0,1,1
Ryan Christie,0,64.0,0,0,0,2,2
Ryan Donk,0,38.0,0,1,1,0,1
Ryan Fraser,0,126.0,0,0,1,1,2
Ryan Giggs,0,498.0,0,0,7,4,11
Ryan Johnson,2,121.0,0,0,2,1,3
Ryan Malmberg,0,84.0,0,0,0,1,1
Ryan Mendes,0,90.0,0,0,1,0,1
Ryan Mmaee,0,114.0,0,1,4,0,4
Ryan Nelsen,2,331.0,0,0,5,0,5
Ryan Robbins,0,73.0,0,0,0,1,1
Ryan Simpson,0,90.0,0,0,1,0,1
Ryan Telfer,1,44.0,0,0,1,0,1
Ryan Thomas,0,151.0,0,0,3,0,3
Ryang Yong-gi,1,12.0,0,0,1,0,1
Ryoichi Maeda,3,282.0,0,0,4,3,7
Ryszard Grzegorczyk,0,134.0,0,0,1,1,2
Ryszard Tarasiewicz,0,342.0,0,0,3,2,5
Ryu Song-Gun,4,347.0,0,0,3,3,6
Ryuzo Morioka,1,90.0,1,0,1,0,1
Réginal Goreux,0,64.0,0,0,0,1,1
Régis Manon,0,33.0,0,0,1,0,1
Rémy Ebanega,0,57.0,0,0,1,0,1
Ríkharður Daðason,0,160.0,1,0,5,0,5
Ríkharður Jónsson,0,205.0,0,0,1,3,4
Róaldur Jakobsen,0,11.0,0,0,0,1,1
Róbert Boženík,0,139.0,0,0,1,3,4
Róbert Feczesin,0,34.0,0,0,1,0,1
Róbert Mak,0,235.0,0,0,3,3,6
Róbert Tomaschek,0,165.0,0,0,0,3,3
Róbert Vittek,4,750.0,0,1,6,8,14
Róger Flores,1,75.0,0,0,0,1,1
Róger Gómez,1,14.0,0,0,1,0,1
Rógvi Baldvinsson,0,213.0,1,0,2,2,4
Rógvi Jacobsen,0,548.0,0,0,3,5,8
Rómulo Otero,0,231.0,0,1,4,1,5
Rónald González Brenes,2,146.0,1,0,1,2,3
Rónald Gómez,5,773.0,0,0,8,6,14
Rónald Matarrita,0,174.0,0,0,1,1,2
Rôni,1,109.0,0,0,1,1,2
Rúben Bareño,0,31.0,0,0,0,1,1
Rúben Dias,0,35.0,1,0,1,0,1
Rúnar Kristinsson,0,46.0,0,0,1,0,1
Rúnar Már Sigurjónsson,0,90.0,0,1,0,1,1
Rúrik Gíslason,0,90.0,0,0,0,1,1
Rüdiger Abramczik,1,3.0,0,0,1,0,1
Rüdiger Schnuphase,0,116.0,0,2,3,1,4
Răzvan Cociş,0,59.0,0,0,0,1,1
Răzvan Marin,0,12.0,0,0,0,1,1
Rıdvan Dilmen,0,152.0,0,0,2,1,3
Rıza Çalımbay,0,13.0,0,1,1,0,1
Saad Abdul-Amir,0,145.0,0,1,0,2,2
Saad Al-Harthi,0,351.0,0,0,5,1,6
Saad Al-Houti,0,27.0,0,0,2,0,2
Saad Al-Mukhaini,0,52.0,0,0,1,0,1
Saad Al-Shammari,0,174.0,0,0,1,1,2
Saad Attiya,0,75.0,0,0,0,1,1
Saad Bakheet Mubarak,0,80.0,0,0,1,0,1
Saad Bguir,0,84.0,0,0,1,0,1
Saad Dahane,0,126.0,0,2,2,0,2
Saad Qais,6,408.0,0,0,3,3,6
Saad Uddin,0,42.0,0,0,0,1,1
Saado Al-Suwaiti,1,57.0,0,0,1,0,1
Saba Lobzhanidze,0,25.0,0,0,0,1,1
Sabah Abdul-Jalil,1,46.0,0,0,1,0,1
Sabah Bizi,0,87.0,0,0,1,0,1
Sabah Hatim,4,126.0,0,0,4,0,4
Sabah Jeayer,0,170.0,0,0,2,2,4
Sabbir,1,100.0,0,0,2,0,2
Sabelo Ndzinisa,0,61.0,0,0,0,1,1
Saber Ben Frej,0,20.0,0,0,1,0,1
Saber Khelifa,1,55.0,0,0,0,2,2
Sabri Sarıoğlu,0,39.0,0,0,0,1,1
Sacha Kljestan,0,122.0,0,0,1,1,2
Sacha Schneider,0,49.0,0,0,1,0,1
Sadio Diallo,2,120.0,0,1,2,2,4
Sadio Mané,10,955.0,0,4,7,9,16
Sadiq Saadoun,0,58.0,1,0,2,0,2
Saeed Al Kass,2,407.0,0,1,5,2,7
Saeed Al-Owairan,6,427.0,0,0,7,4,11
Saeed Murjan,0,96.0,0,0,0,2,2
Saeed Shaaban Al Busaidy,1,88.0,0,0,1,1,2
Saeid Daghighi,0,86.0,0,0,1,0,1
Saeid Ezatolahi,0,64.0,0,0,1,0,1
Safaa Hadi,1,90.0,0,0,1,0,1
Safar Iranpak,2,64.0,0,0,2,0,2
Safawi Rasid,1,259.0,0,1,4,1,5
Safee Sali,0,129.0,0,0,1,2,3
Safet Sušić,1,382.0,0,0,5,4,9
Saffet Akyüz,0,8.0,0,0,1,0,1
Saffet Sancaklı,0,37.0,0,0,2,0,2
Safuwan Baharudin,0,183.0,0,1,2,2,4
Safwan Habaib,2,52.0,0,0,2,0,2
Sahib Abbas,0,160.0,0,0,2,0,2
Saibi Eklou Dodji,0,79.0,0,0,1,0,1
Said Bayazid,0,522.0,0,0,11,0,11
Said Brahimi,0,49.0,0,0,1,0,1
Said Riyad,0,90.0,1,0,1,0,1
Said Rokbi,1,89.0,0,0,1,0,1
Saif Eldin Ali Idris Farah,1,76.0,0,0,0,1,1
Saif Mohammed Al Bishr,0,90.0,0,0,0,1,1
Saimon Msuva,1,158.0,0,0,0,5,5
Saio Ernest Mokili,1,42.0,0,0,1,0,1
Sairusi Nalaubu,2,100.0,0,0,0,2,2
Sakdarin,0,90.0,0,0,1,0,1
Salaah Al-Yahyaei,0,63.0,0,1,1,0,1
Saladin Said,1,290.0,0,0,2,3,5
Salah Al-Hasawi,2,287.0,0,0,3,2,5
Salah Assad,5,220.0,0,1,5,0,5
Salah Ibrahim,0,70.0,0,0,0,1,1
Salah Obeid,1,33.0,0,0,1,0,1
Salaheddine Bassir,3,352.0,0,0,1,6,7
Salam Kouko,0,65.0,0,0,1,0,1
Saleh Ahmed Farhan,1,57.0,0,0,0,1,1
Saleh Al-Mutlaq,1,20.0,0,0,0,1,1
Saleh Al-Shehri,2,515.0,0,1,4,5,9
Saleh Eid Al-Mehaizaa,0,18.0,0,0,0,1,1
Saleh Khalifa Al-Dosari,1,66.0,0,0,0,1,1
Saleh Obaid,0,58.0,0,0,1,0,1
Saleh Rabiah Ben,1,62.0,0,0,1,0,1
Saleh Selim,1,57.0,0,0,1,0,1
Salem Al-Ajalin,0,43.0,0,0,1,0,1
Salem Al-Dawsari,5,778.0,0,3,8,5,13
Salem Ould Ely,0,85.0,0,0,1,0,1
Salesh Kumar,0,7.0,0,0,1,0,1
Salif Coulibaly,0,31.0,1,0,1,0,1
Salif Diao,3,233.0,0,0,1,3,4
Salif Keita,1,86.0,0,0,0,1,1
Salif Kéïta,1,22.0,0,0,1,0,1
Salih Sadir,0,47.0,0,0,0,2,2
Salim Moin,0,76.0,0,0,2,0,2
Salim Tuama,0,81.0,0,0,0,1,1
Saliou Ciss,0,4.0,1,0,1,0,1
Salissou Ali,0,69.0,0,0,1,0,1
Salman Al-Faraj,1,241.0,0,2,4,2,6
Salman Al-Moasher,0,90.0,0,0,0,1,1
Salman Ghuloom,0,139.0,0,0,1,1,2
Salman Isa,1,201.0,0,0,3,1,4
Salomon Kalou,7,673.0,0,1,9,4,13
Salomon Olembé,1,221.0,0,0,2,2,4
Salomón Rondón,4,683.0,0,0,6,8,14
Salvador Cabañas,3,484.0,0,1,4,6,10
Salvador Kaçaj,0,41.0,0,0,1,0,1
Salvador Reyes Monteón,0,538.0,0,0,8,3,11
Salvador Soto,0,78.0,0,0,0,1,1
Salvador Villalba,1,89.0,0,0,0,1,1
Salvatore Bagni,0,4.0,0,0,1,0,1
Salvatore Schillaci,0,370.0,0,1,6,1,7
Sam Adekugbe,0,90.0,0,0,1,0,1
Sam El Nasa,0,185.0,1,0,3,1,4
Sam Garba,0,19.0,0,0,0,1,1
Sam Johnson,0,88.0,0,0,1,0,1
Sam Ojebode,2,174.0,0,2,2,1,3
Sam Tabu,0,57.0,0,0,1,0,1
Sam Vines,0,8.0,0,0,1,0,1
Sam Vokes,1,207.0,0,0,3,0,3
Samad Marfavi,0,81.0,0,0,1,0,1
Saman Ghoddos,1,78.0,0,0,1,0,1
Samat Smakov,0,164.0,0,2,1,1,2
Samba Sow,0,56.0,0,0,0,1,1
Sambou Yatabaré,1,89.0,0,0,1,1,2
Sambégou Bangoura,1,458.0,0,0,4,4,8
Sameh Maraaba,0,97.0,0,0,0,2,2
Sami Al-Hashash,0,89.0,0,0,1,0,1
Sami Al-Husaini,1,45.0,0,0,0,1,1
Sami Al-Jaber,7,956.0,0,3,15,6,21
Sami Al-Najei,0,53.0,0,0,2,0,2
Sami Hyypiä,0,218.0,0,0,3,1,4
Sami Khedira,2,207.0,0,0,3,3,6
Samir Aliyev,0,26.0,0,0,1,0,1
Samir Kamouna,2,271.0,0,1,3,2,5
Samir Mubarak,1,46.0,0,0,1,0,1
Samir Nasri,1,221.0,0,1,3,1,4
Samir Said,1,101.0,0,0,2,0,2
Samir Sultan Al Fahad,0,22.0,0,0,1,0,1
Sammy Ayoyi,0,48.0,0,0,0,1,1
Sammy Baird,1,58.0,0,0,0,1,1
Sammy Lee,0,87.0,0,0,0,2,2
Sammy McIlroy,0,109.0,0,0,3,0,3
Sammy Morgan,2,77.0,0,0,3,0,3
Sammy Onyango,0,88.0,0,0,0,1,1
Sammy Owino,0,137.0,0,1,2,0,2
Sammy Swan,0,76.0,0,0,0,1,1
Samson Siasia,2,224.0,0,0,2,4,6
Samuel Barlay,0,22.0,0,0,0,1,1
Samuel Caballero,2,519.0,0,0,3,5,8
Samuel Camille,0,23.0,1,0,1,0,1
Samuel Chukwueze,2,30.0,0,0,2,0,2
Samuel Eto'o,21,2205.0,0,7,30,10,40
Samuel Garcia,2,54.0,0,1,1,1,2
Samuel Holmén,0,64.0,0,0,1,0,1
Samuel Hyanine,1,78.0,0,0,1,0,1
Samuel Johnson,1,230.0,0,1,3,0,3
Samuel Kuffour,0,40.0,0,0,1,1,2
Samuel Musenze,1,71.0,0,0,0,1,1
Samuel Okwaraji,1,2.0,0,0,0,1,1
Samuel Opone,0,72.0,0,0,0,1,1
Samuel Smyth,0,164.0,0,0,2,1,3
Samuel Tray,0,70.0,0,0,1,0,1
Samuel Umtiti,1,63.0,0,0,2,0,2
Samuela Kautoga,1,51.0,0,0,1,0,1
Sanad Al Warfali,0,139.0,0,1,2,0,2
Sanda Seydou,0,36.0,0,0,1,0,1
Sander Berge,0,34.0,0,0,1,0,1
Sander Puri,0,83.0,0,0,1,0,1
Sandesh Jhingan,0,26.0,0,0,1,0,1
Sandi Lovrić,0,60.0,0,1,2,0,2
Sandile Hlatjwako,0,121.0,0,0,2,1,3
Sandro Mazzola,1,491.0,0,0,10,4,14
Sandro Wagner,0,205.0,0,0,4,1,5
Sandro Wieser,0,20.0,0,0,1,0,1
Sandy Kaposa,0,58.0,0,0,1,0,1
Sanel Jahić,0,75.0,0,0,0,1,1
Saneliso Dlamini,0,74.0,0,0,0,1,1
Sanharib Malki,2,280.0,0,0,1,3,4
Sanjar Kodirkulov,0,3.0,0,0,1,0,1
Santana Vander Kross,0,43.0,0,0,0,1,1
Santi Cazorla,0,250.0,0,0,4,0,4
Santiago Acasiete,0,110.0,0,0,2,0,2
Santiago Ostolaza,3,141.0,0,0,3,0,3
Santiago Salfate,1,84.0,0,1,0,1,1
Santiago Veiga,1,50.0,0,0,0,1,1
Santillana,1,589.0,0,0,8,5,13
Santino Quaranta,0,74.0,0,0,1,0,1
Santos Cabrera,1,58.0,0,0,0,1,1
Santos Iriarte,0,129.0,0,0,2,0,2
Sanzhar Tursunov,0,107.0,0,0,2,1,3
Saoud Al Gassem Mohammed Bo Saeed,0,54.0,0,0,1,0,1
Saphir Sliti Taïder,0,110.0,0,0,1,1,2
Sarayoot Chaikamdee,0,402.0,0,0,4,5,9
Sardar Azmoun,7,1052.0,0,0,16,11,27
Sardor Rashidov,2,369.0,0,0,3,4,7
Sargis Hovsepyan,0,89.0,0,1,1,1,2
Sarkis Oganessian,0,10.0,1,0,1,0,1
Sarman Panggabean,2,38.0,0,0,1,1,2
Sath Rosib,1,64.0,0,0,0,1,1
Saturnino Arrúa,0,217.0,0,0,4,0,4
Saud Jassem,0,180.0,0,0,2,0,2
Saud Khariri,0,29.0,0,0,1,0,1
Saula Waqa,0,45.0,0,0,1,0,1
Sauli Pietiläinen,0,10.0,0,0,0,1,1
Saulius Mikoliūnas,0,291.0,0,0,3,1,4
Savo Milošević,12,1255.0,0,0,11,15,26
Saydrel Lewis,0,84.0,0,0,2,0,2
Sayed Abdel Razek,1,139.0,0,0,2,0,2
Sayed Ali Bechir,1,216.0,0,0,1,2,3
Sayed Ali Eftekhari,0,16.0,0,0,1,0,1
Sayed Dhiya Saeed,1,363.0,0,0,4,2,6
Sayed Jaafar Ahmed,1,82.0,0,0,0,1,1
Sayed Mahfoodh,0,27.0,0,0,0,1,1
Sayed Mahmood Jalal,0,27.0,0,0,0,1,1
Sayed Mohamed Adnan,1,195.0,0,0,1,2,3
Saïd Benrahma,1,40.0,0,0,0,1,1
Saïd Chiba,2,75.0,0,0,2,0,2
Saïd Makasi,1,303.0,0,1,3,2,5
Saïdou Panandétiguiri,0,15.0,1,0,2,0,2
Saúl Coco,0,94.0,0,0,1,1,2
Saúl Martínez,2,193.0,0,0,0,3,3
Saúl Ñíguez,0,47.0,0,0,0,1,1
Saša Ilić,2,176.0,0,0,2,1,3
Saša Kalajdžić,1,293.0,0,0,1,3,4
Saša Ognenovski,1,35.0,0,0,0,1,1
Saša Ćirić,0,296.0,0,1,1,4,5
Sašo Miloševski,0,6.0,0,0,1,0,1
Sašo Udovič,0,267.0,0,0,4,1,5
Schubert Gambetta,2,97.0,0,0,1,2,3
Scott Arfield,2,112.0,0,0,1,1,2
Scott Booth,0,152.0,0,0,4,1,5
Scott Brown,0,56.0,0,0,1,0,1
Scott Chipperfield,3,470.0,0,0,8,2,10
Scott McTominay,0,90.0,0,0,1,0,1
Scott Sealy,0,85.0,0,0,1,0,1
Scott Wiseman,1,44.0,1,0,0,1,1
Sea Cheng Eang,1,80.0,0,0,1,0,1
Sead Kolašinac,1,3.0,1,0,1,0,1
Sean St Ledger,1,122.0,0,0,2,1,3
Seb Larsson,1,90.0,0,0,1,0,1
Sebastian Andersson,0,29.0,0,0,1,0,1
Sebastian Broderick Imasuen,0,62.0,0,0,1,0,1
Sebastian Deisler,0,67.0,0,0,2,0,2
Sebastian Giovinco,1,86.0,0,0,1,0,1
Sebastian Larsson,0,341.0,0,4,2,4,6
Sebastian Lletget,0,95.0,0,0,1,1,2
Sebastian Mila,0,161.0,0,0,1,1,2
Sebastian Prödl,0,67.0,0,0,1,1,2
Sebastian Rudy,0,2.0,0,0,0,1,1
Sebastian Szymański,0,3.0,0,0,1,0,1
Sebastien Lakou,1,47.0,0,0,1,0,1
Sebastián Abreu,2,577.0,0,0,7,3,10
Sebastián Coates,0,12.0,0,0,1,0,1
Sebastián Córdova,0,18.0,0,0,1,0,1
Sebastián Eguren,0,192.0,0,0,2,1,3
Sebastián González,1,161.0,0,0,0,2,2
Sebastián Pérez Cardona,0,48.0,0,0,1,0,1
Sebastián Rambert,1,31.0,0,0,0,1,1
Sebastián Rozental,1,63.0,0,0,0,1,1
Sebastián Soria,2,751.0,0,2,8,6,14
Sebastián Tagliabúe,0,86.0,0,0,1,0,1
Sebastião Gilberto,0,153.0,0,1,2,1,3
Sebastjan Cimirotič,1,258.0,0,0,2,2,4
Sedat Özden,0,123.0,0,0,1,3,4
Sedonoude Abouta,1,70.0,0,0,0,1,1
Sefedin Braho,0,2.0,0,0,1,0,1
Segin Wayewol,3,270.0,0,0,1,2,3
Segun Odegbami,2,508.0,0,0,8,2,10
Segundo Castillo,0,130.0,0,0,2,1,3
Segundo Luna,3,144.0,0,0,3,0,3
Segundo Villadóniga,1,1.0,0,0,0,1,1
Seif Teiri,1,72.0,0,0,1,0,1
Seifeddine Jaziri,1,152.0,0,0,2,0,2
Seiichiro Maki,0,161.0,0,0,1,2,3
Seimata Chilia,2,157.0,0,0,0,3,3
Seiminlen Doungel,1,90.0,0,0,0,1,1
Sejad Salihović,0,46.0,0,1,1,1,2
Sekou Cissé,0,191.0,0,0,3,0,3
Seksan Piturat,3,368.0,0,0,5,4,9
Sele Leboela,0,44.0,0,0,0,1,1
Selemani Ndikumana,0,169.0,0,1,2,0,2
Selim Amallah,1,124.0,0,0,3,0,3
Selim Benachour,1,116.0,0,0,2,0,2
Sellam Riahi,0,40.0,0,0,0,1,1
Sello Muso,1,90.0,0,0,1,0,1
Selvyn Ponciano,0,53.0,0,0,0,1,1
Selwyn Murren,0,66.0,1,0,1,0,1
Selçuk Yula,0,162.0,0,1,3,0,3
Selçuk İnan,0,333.0,0,1,3,2,5
Semi Nuoranen,0,27.0,0,0,1,0,1
Semih Şentürk,2,432.0,0,0,2,4,6
Senad Lulić,1,176.0,0,0,1,2,3
Senad Tiganj,0,82.0,0,0,1,0,1
Sendley Sidney Bito,0,40.0,0,0,0,2,2
Sengphet Thongphachan,0,53.0,0,0,1,0,1
Senijad Ibričić,0,100.0,0,0,1,2,3
Seninho,0,11.0,0,0,1,0,1
Sentayehu Getachew,0,64.0,0,0,1,0,1
Sentu Johnson,0,79.0,0,0,0,1,1
Seo Jung-won,2,283.0,0,0,0,4,4
Seol Ki-hyeon,1,246.0,0,0,4,0,4
Seppo Pyykkö,0,53.0,0,0,1,0,1
Sercan Yıldırım,0,37.0,0,0,1,0,1
Serdar Annaorazow,0,12.0,1,0,1,0,1
Serdar Aziz,0,83.0,0,0,1,0,1
Serdar Dursun,0,157.0,0,0,1,1,2
Serdaraly Ataýew,0,70.0,0,0,0,1,1
Serey Dié,2,125.0,0,0,1,1,2
Serge Chiesa,0,78.0,0,0,1,0,1
Serge Gakpé,1,45.0,0,0,1,1,2
Serge Gnabry,1,585.0,0,0,9,8,17
Serge Maguy,1,73.0,0,0,1,0,1
Serge Trinchero,0,40.0,0,1,1,0,1
Sergei Aleinikov,2,176.0,0,0,2,2,4
Sergei Bragin,0,57.0,0,0,0,1,1
Sergei Gurenko,0,116.0,0,0,2,1,3
Sergei Hohlov-Simson,0,165.0,1,0,2,1,3
Sergei Ignashevich,0,299.0,1,1,1,6,7
Sergei Ivanov,1,47.0,0,0,0,1,1
Sergei Khizhnichenko,0,184.0,0,0,3,2,5
Sergei Kiriakov,0,327.0,0,0,1,6,7
Sergei Kornilenko,0,573.0,0,2,5,5,10
Sergei Mošnikov,0,88.0,0,0,1,0,1
Sergei Omelyanchuk,0,45.0,0,0,1,0,1
Sergei Ostapenko,0,275.0,1,0,4,2,6
Sergei Pavlovich Baltacha,1,70.0,0,0,2,0,2
Sergei Petrov,0,19.0,0,0,0,1,1
Sergei Semak,0,173.0,0,0,2,1,3
Sergei Terehhov,0,264.0,0,0,2,2,4
Sergei Yuran,0,285.0,0,0,4,1,5
Sergei Zenjov,1,440.0,0,0,5,3,8
Sergej Barbarez,0,501.0,0,1,4,7,11
Sergej Milinković-Savić,1,249.0,0,0,0,4,4
Sergen Yalçın,0,287.0,0,0,3,1,4
Sergey Andreyev,2,274.0,0,0,4,1,5
Sergey Chikishev,0,161.0,0,0,1,2,3
Sergey Gotsmanov,0,68.0,0,0,0,1,1
Sergey Gridin,0,125.0,0,0,2,0,2
Sergey Grishin,0,55.0,0,0,1,0,1
Sergey Krivets,0,77.0,0,0,1,0,1
Sergey Kutsov,2,131.0,0,0,1,2,3
Sergey Lebedev,1,164.0,0,1,3,0,3
Sergey Lushan,1,29.0,0,0,0,1,1
Sergey Rodionov,1,120.0,0,0,2,0,2
Serghei Alexeev,0,247.0,0,0,2,1,3
Serghei Belous,0,8.0,0,0,1,0,1
Serghei Cleșcenco,0,189.0,0,1,2,3,5
Serghei Covalciuc,0,175.0,0,0,2,0,2
Serghei Dadu,0,126.0,0,1,2,1,3
Serghei Pogreban,0,10.0,0,0,0,1,1
Serghei Rogaciov,0,142.0,0,1,5,0,5
Serghei Secu,0,28.0,0,0,1,0,1
Serghei Stroenco,0,16.0,1,0,1,0,1
Sergi Moreno,0,53.0,0,0,0,1,1
Sergi Roberto,0,55.0,0,0,1,0,1
Serginho,0,43.0,0,1,0,1,1
Serginho Chulapa,2,136.0,0,0,1,1,2
Sergio Agüero,8,1025.0,0,1,15,5,20
Sergio Ahumada,1,243.0,0,0,4,0,4
Sergio Angulo,0,66.0,0,0,1,0,1
Sergio Barila,0,25.0,0,1,1,0,1
Sergio Berti,1,83.0,0,0,1,0,1
Sergio Busquets,0,64.0,0,0,2,0,2
Sergio Cervato,0,3.0,0,0,1,0,1
Sergio Espinoza,1,62.0,0,0,1,0,1
Sergio Herrera,1,156.0,0,1,2,0,2
Sergio Peña,1,120.0,0,0,2,1,3
Sergio Ramos,0,499.0,0,4,7,6,13
Sergio Salgado,1,83.0,0,0,0,1,1
Sergio Santana,2,287.0,0,0,2,2,4
Sergio Zanatta,0,10.0,0,0,1,0,1
Sergiu Epureanu,0,3.0,0,0,1,0,1
Sergiño Dest,0,25.0,0,0,1,0,1
Serguei Prado,0,87.0,0,0,1,0,1
Serhat Akın,0,185.0,0,0,3,0,3
Serhii Rebrov,2,511.0,0,3,4,5,9
Serhiy Fedorov,0,90.0,0,0,1,0,1
Serhiy Konovalov,0,29.0,0,0,1,0,1
Serhiy Malyi,0,44.0,1,0,0,1,1
Serhiy Nazarenko,0,234.0,0,0,3,2,5
Serhiy Popov,0,56.0,0,0,3,0,3
Serhiy Serebrennikov,0,2.0,0,0,0,1,1
Serhiy Skachenko,0,55.0,0,0,2,0,2
Serhiy Sydorchuk,0,192.0,0,0,1,2,3
Serikzhan Muzhikov,0,59.0,0,0,0,1,1
Servaas Wilkes,0,26.0,0,0,1,0,1
Server Djeparov,3,731.0,0,2,8,6,14
Servet Çetin,0,106.0,0,0,1,1,2
Servílio de Jesús,1,37.0,0,0,0,1,1
Seth Amphadu,1,32.0,0,0,1,0,1
Seveci Rokotakala,3,240.0,0,0,3,1,4
Severino Da Silva,4,200.0,0,0,4,0,4
Severino Varela,9,539.0,0,1,5,10,15
Severo Orgaz,2,168.0,0,0,2,0,2
Seweryn Gancarczyk,0,3.0,1,0,0,1,1
Seyd Bechir,0,72.0,0,0,2,0,2
Seydou Doumbia,1,232.0,0,0,1,2,3
Seydou Keita,4,722.0,0,0,8,5,13
Seydou Traoré,0,77.0,0,0,1,0,1
Seydouba Bangoura,1,145.0,0,0,1,1,2
Seydouba Soumah,0,80.0,0,1,1,1,2
Seydouba Sylla,1,31.0,0,0,1,0,1
Seyoum Tesfaye,0,127.0,0,0,2,0,2
Shabani Nonda,1,437.0,0,1,9,2,11
Shabib Al-Khaldi,0,73.0,0,0,1,0,1
Shadrack Nsajigwa,0,12.0,0,0,0,1,1
Shaharuddin Abdullah,1,70.0,0,0,0,1,1
Shahdon Winchester,0,66.0,0,0,0,1,1
Shahin Bayani,1,88.0,1,0,1,0,1
Shahrel Fikri,0,115.0,0,0,4,0,4
Shahrokh Bayani,2,183.0,0,2,1,2,3
Shahrom Samiev,1,174.0,0,0,2,0,2
Shailemdra Lal,5,159.0,0,0,5,0,5
Shailend Lal,1,28.0,0,0,0,1,1
Shait Ahmed Jehad,2,180.0,0,0,0,2,2
Shaker Mahmoud,1,49.0,0,0,1,0,1
Shakir Hamzah,0,3.0,0,0,1,0,1
Shalom Luani,2,98.0,0,0,2,0,2
Shamar Nicholson,2,201.0,0,0,2,3,5
Shamveel Qasim,0,14.0,0,0,1,0,1
Shandel Samuel,0,278.0,0,0,3,2,5
Shane Duffy,0,249.0,0,0,2,3,5
Shane Long,1,319.0,0,0,3,2,5
Shane Malcolm,0,51.0,0,0,1,0,1
Shane Marshall,0,89.0,0,0,1,0,1
Shane Rennie,0,96.0,0,1,2,1,3
Shane Smeltz,3,613.0,0,1,5,9,14
Shannon Burgess,0,208.0,0,2,4,0,4
Shanon Carmelia,0,111.0,0,0,2,0,2
Shao Jiayi,1,238.0,0,0,6,1,7
Shaq Moore,0,1.0,0,0,1,0,1
Shaquille Pinas,0,96.0,0,0,2,0,2
Sharaf Mahfood,1,52.0,0,0,1,0,1
Sharif Mukhammad,0,63.0,1,0,1,0,1
Shaun Bartlett,7,555.0,0,1,14,1,15
Shaun Easthope,0,43.0,0,1,1,0,1
Shaun Francis,1,6.0,0,0,1,0,1
Shaun Goater,0,564.0,0,1,3,7,10
Shaun Maloney,1,304.0,0,2,3,4,7
Shaun Murphy,3,144.0,0,0,2,1,3
Shaun Wright-Phillips,0,91.0,0,0,3,0,3
Shavkat Salomov,0,68.0,0,0,1,0,1
Shawky Gharieb,0,73.0,0,0,1,0,1
Shawn Beveney,0,26.0,0,0,1,0,1
Shawn Martin,0,25.0,0,0,2,1,3
Shay Holtzman,1,90.0,0,0,1,0,1
Shaye Al Nafeesah,0,90.0,0,0,1,0,1
Shaye Al-Nafisah,1,10.0,0,0,1,0,1
Shayne Lavery,0,67.0,0,0,0,1,1
Shefki Kuqi,0,362.0,0,0,3,2,5
Sheikh Mohammad Aslam,0,70.0,0,0,1,0,1
Sheldon Bateau,3,79.0,0,0,4,0,4
Sheldon Emmanuel,0,79.0,0,1,2,0,2
Shen Si,1,7.0,0,1,1,0,1
Shen Xiangfu,3,329.0,0,0,4,0,4
Sheraldo Becker,0,39.0,0,0,2,0,2
Sheridan Grosvenor,0,90.0,0,0,0,1,1
Sheriddin Boboev,1,78.0,0,0,1,0,1
Sherif Touré Coubageat,0,63.0,0,0,1,0,1
Sheriff Suma,0,169.0,0,0,3,0,3
Shewangizaw Agonafer,0,19.0,0,0,1,0,1
Shi Jiayi,2,213.0,0,0,1,3,4
Shibuzor Ehilegbu,1,31.0,0,0,0,1,1
Shigeyoshi Mochizuki,1,30.0,0,0,1,0,1
Shikabala,0,61.0,0,0,0,1,1
Shimelis Bekele,0,217.0,0,0,3,0,3
Shimon Gershon,1,98.0,0,2,2,0,2
Shin Hong-Ki,1,63.0,0,0,1,0,1
Shin Tae-Yong,1,35.0,0,0,1,0,1
Shingayi Kaondera,0,178.0,0,0,2,2,4
Shinji Kagawa,5,719.0,0,1,8,7,15
Shinji Okazaki,12,1213.0,0,0,8,14,22
Shinji Ono,1,207.0,0,0,1,2,3
Shiva N'Zigou,1,23.0,0,0,1,1,2
Shkodran Mustafi,1,66.0,0,0,2,0,2
Shkëlqim Muça,0,27.0,0,0,1,0,1
Shkëlzen Gashi,0,81.0,0,0,1,0,1
Shlomo Levi,2,207.0,0,0,5,0,5
Shlomo Nahari,0,34.0,0,0,1,0,1
Shmuel Rosenthal,1,70.0,0,0,1,0,1
Sho Inagaki,0,158.0,0,0,2,0,2
Sho Sasaki,0,72.0,0,0,1,0,1
Shojae Khalilzadeh,1,22.0,0,0,0,1,1
Shoji Jo,1,119.0,0,0,2,0,2
Shomari Kapombe,0,61.0,0,0,1,0,1
Shon Weissman,0,117.0,0,0,2,0,2
Shota Arveladze,0,747.0,0,0,8,11,19
Shoya Nakajima,1,31.0,0,0,0,2,2
Shukhrat Dzhaborov,0,148.0,0,0,3,0,3
Shukhrat Jabbarov,1,77.0,0,0,1,0,1
Shukhrat Maksudov,0,124.0,0,0,2,0,2
Shunsuke Nakamura,7,491.0,0,1,5,8,13
Shurland David,1,75.0,1,0,1,0,1
Shusaku Hirasawa,1,28.0,0,0,0,1,1
Siaka Tiéné,1,133.0,0,0,2,0,2
Siboniso Mamba,0,56.0,0,0,0,1,1
Sibusiso Vilakazi,0,45.0,0,0,1,0,1
Sibusiso Zuma,1,198.0,0,0,3,2,5
Sid Ahmed Zerrouki,0,78.0,0,0,0,1,1
Siddiq Manzul,1,143.0,0,1,1,1,2
Sidi Napon,0,56.0,0,0,1,0,1
Sidi Yaya Keita,0,127.0,0,0,2,0,2
Sidique Mansaray,0,104.0,0,0,2,0,2
Sidney Govou,0,303.0,0,0,4,2,6
Sidumo Shongwe,0,126.0,0,0,1,1,2
Siegfried Haltman,0,32.0,0,0,2,1,3
Siegfried Stritzl,0,89.0,0,0,0,1,1
Sieng Chanthea,0,81.0,0,0,1,0,1
Sigamary Diarra,1,90.0,0,0,1,0,1
Sigfrido Mercado,0,100.0,0,0,2,1,3
Sigfried Held,1,57.0,0,0,2,0,2
Sigifredo Cuchuca,0,18.0,0,0,0,1,1
Sigurd Rushfeldt,0,107.0,0,0,1,1,2
Sigurður Grétarsson,0,10.0,0,0,1,0,1
Sigurður Jónsson,0,194.0,0,0,1,2,3
Siim Luts,1,10.0,0,0,0,1,1
Silao Malo,1,158.0,0,0,2,0,2
Silvan Widmer,0,11.0,0,0,0,1,1
Silvestre Igoa,1,152.0,0,0,1,1,2
Silvestre Varela,2,270.0,0,0,2,2,4
Silvio Garay,1,90.0,0,0,0,1,1
Silvio Lagreca,1,39.0,0,1,0,1,1
Silvio Marić,0,39.0,0,0,1,0,1
Silvio Marzolini,1,50.0,0,0,1,0,1
Silvio Parodi,4,313.0,0,0,2,4,6
Silvio Piola,3,315.0,0,0,1,4,5
Silvio Rojas,0,89.0,0,0,1,1,2
Silvio Spann,1,8.0,0,0,0,1,1
Silviu Bindea,1,35.0,0,0,0,1,1
Silvère Ganvoula,0,45.0,0,1,1,0,1
Simen Brenne,1,31.0,0,0,0,1,1
Simeon Jackson,0,170.0,0,0,0,4,4
Simo Emmanuel Mvé,0,79.0,0,0,1,0,1
Simo Syrjävaara,0,25.0,0,0,1,0,1
Simon Church,0,67.0,0,0,1,0,1
Simon Colosimo,0,132.0,0,0,2,0,2
Simon Davies,0,204.0,0,0,3,3,6
Simon Dawkins,0,89.0,0,0,0,1,1
Simon Elliott,2,146.0,0,0,3,0,3
Simon Kaushi,2,98.0,0,0,0,3,3
Simon Kjær,0,233.0,1,1,2,3,5
Simon Lauru,3,173.0,0,0,1,2,3
Simon Masaba,0,30.0,0,1,1,0,1
Simon Rolfes,0,64.0,0,0,0,1,1
Simon Tahamata,0,57.0,0,0,0,1,1
Simon Uutoni,1,130.0,0,0,1,1,2
Simone Bacciocchi,0,61.0,1,0,1,0,1
Simone Perrotta,1,119.0,0,0,1,1,2
Simone Zaza,0,16.0,0,0,0,1,1
Simão,0,245.0,0,0,5,0,5
Simão Sabrosa,2,643.0,0,1,11,1,12
Sin Yong-nam,0,52.0,0,0,0,1,1
Singgih Pitono,0,85.0,0,0,0,1,1
Singo McDonald,0,2.0,0,0,0,1,1
Sinha,2,211.0,0,0,3,2,5
Siniša Gogić,0,104.0,0,1,4,0,4
Siniša Mihajlović,4,340.0,1,0,4,2,6
Sione Uhatahi,0,47.0,0,0,1,0,1
Siphiwe Tshabalala,1,105.0,0,0,1,2,3
Sirous Dinmohammadi,0,84.0,0,0,0,1,1
Sirous Ghayeghran,1,108.0,0,0,0,2,2
Sisir Ghosh,0,34.0,0,0,0,1,1
Siyabonga Nkosi,1,45.0,0,0,0,1,1
Siyabonga Nomvethe,6,430.0,0,0,5,3,8
Siyabonga Sangweni,0,116.0,0,0,2,0,2
Siza Dlamini,0,198.0,0,0,2,1,3
Sjaak Roggeveen,0,90.0,0,0,1,0,1
Sjaak Swart,0,132.0,0,0,2,0,2
Skander Souayah,1,43.0,0,1,1,1,2
Slava Metreveli,3,267.0,0,0,4,3,7
Slaven Bilić,1,51.0,0,0,2,1,3
Slaven Zambata,0,314.0,0,0,3,4,7
Slaviša Jokanović,1,113.0,0,0,1,3,4
Slimane Raho,0,60.0,1,0,1,0,1
Sloan Privat,1,71.0,0,0,1,0,1
Slobodan Komljenović,3,127.0,0,0,1,2,3
Smail Prevljak,0,91.0,0,0,0,2,2
Smith Samuel,0,82.0,0,0,1,0,1
So Kyong-jin,0,45.0,0,0,0,1,1
Soeuy Visal,1,77.0,1,0,1,1,2
Sofiane Bendebka,1,73.0,0,0,0,1,1
Sofiane Boufal,3,253.0,0,2,2,2,4
Sofiane Daoud,0,48.0,0,0,1,0,1
Sofiane Feghouli,5,323.0,0,2,4,5,9
Sofiane Hanni,1,90.0,0,0,1,0,1
Sohrab Bakhtiarizadeh,1,187.0,0,0,3,0,3
Sok Sun Hean,1,56.0,0,0,1,0,1
Sokol Cikalleshi,0,286.0,0,1,2,3,5
Sokol Kushta,0,278.0,0,2,6,3,9
Sokratis Papastathopoulos,1,204.0,0,0,0,3,3
Sol Campbell,1,24.0,0,0,1,0,1
Solome Pita,0,22.0,0,0,1,0,1
Solomon Sheferahu,0,42.0,0,0,2,0,2
Somen Tchoyi,0,65.0,0,0,0,1,1
Sompit Suwannapluoh,1,49.0,0,0,0,1,1
Sompong Soleb,0,35.0,0,0,1,0,1
Son Heung-min,8,1491.0,0,3,16,6,22
Song Chong-gug,0,128.0,0,0,1,1,2
Songserm Maperm,1,110.0,0,0,1,1,2
Sonni Nattestad,0,38.0,0,0,0,2,2
Soony Saad,2,177.0,0,0,1,3,4
Sor Rotana,1,32.0,1,0,0,1,1
Soriba Soumah,3,194.0,0,4,1,3,4
Sorin Avram,0,71.0,0,0,0,1,1
Sory Kaba,1,34.0,0,0,1,0,1
Sos Suhana,0,65.0,0,0,0,1,1
Sotirios Kyrgiakos,0,43.0,0,0,1,2,3
Sotiris Kaiafas,0,105.0,0,1,2,0,2
Sotiris Ninis,0,115.0,0,0,1,1,2
Soufiane Alloudi,3,34.0,0,0,0,3,3
Soukaphone Vongchiengkham,0,5.0,0,0,0,1,1
Souleyman Sané,0,218.0,0,0,4,1,5
Souleymane Camara,2,148.0,0,0,1,1,2
Souleymane Diamouténé,0,48.0,0,1,1,0,1
Souleymane Oularé,3,266.0,0,0,2,4,6
Souleymane Youla,1,268.0,0,0,2,3,5
Souliya Syphasay,0,46.0,0,0,1,0,1
Soumaila Traoré,1,64.0,0,0,0,1,1
Soumaila Yattaga,0,32.0,0,0,0,1,1
Soumaïla Coulibaly,1,289.0,0,0,3,3,6
Sousa Miyamou,0,89.0,0,0,1,0,1
Spas Delev,0,25.0,0,0,2,0,2
Spiro Debarski,0,77.0,0,0,1,0,1
Srdjan Luchin,0,77.0,0,0,0,1,1
Srečko Katanec,0,252.0,0,0,3,2,5
Srgjan Zaharievski,0,141.0,0,0,1,1,2
Stalin Rivas,1,72.0,0,0,0,1,1
Stan Mortensen,1,146.0,0,0,2,2,4
Stan Pearson,0,101.0,0,0,2,0,2
Stan Vanden Eynde,1,30.0,0,0,0,1,1
Stanislaus Kobierski,1,25.0,0,0,0,1,1
Stanislav Andreev,1,50.0,0,0,0,1,1
Stanislav Angelov,0,31.0,0,0,1,0,1
Stanislav Griga,0,93.0,0,0,2,0,2
Stanislav Karasi,2,229.0,0,0,0,4,4
Stanislav Lobotka,0,11.0,0,0,0,2,2
Stanislav Manolev,0,136.0,0,0,3,1,4
Stanislav Varga,0,58.0,0,0,1,0,1
Stanislav Šesták,0,479.0,0,0,5,4,9
Stanislaw Drahun,0,276.0,0,0,2,3,5
Stanisław Terlecki,0,213.0,0,0,1,3,4
Stanley Humbert Krenten,0,115.0,0,0,2,0,2
Stanley Mubiru,2,141.0,0,0,0,3,3
Stanley Ndunduma,0,90.0,0,0,1,0,1
Stanley Simson,0,52.0,0,0,0,1,1
Stanley Waita,1,69.0,0,0,1,1,2
Stanton Lewis,0,60.0,0,0,1,0,1
Stasys Baranauskas,0,63.0,0,0,1,0,1
Stathis Chaitas,0,39.0,0,0,0,1,1
Stavros Georgiou,0,71.0,0,0,1,0,1
Stavros Sarafis,0,4.0,0,0,1,0,1
Stavros Stylianou,0,74.0,0,1,1,0,1
Steeve Yago,0,24.0,0,0,0,1,1
Steeven Langil,1,66.0,0,0,1,0,1
Steeven Saba,1,22.0,0,0,0,1,1
Steevy Chong Hue,3,86.0,0,0,2,1,3
Stefan Bozhkov,0,55.0,0,1,1,0,1
Stefan Effenberg,1,47.0,0,0,0,1,1
Stefan Johansen,0,45.0,0,0,0,1,1
Stefan Kuntz,0,97.0,0,0,0,2,2
Stefan Lainer,1,66.0,0,0,2,0,2
Stefan Landberg,0,89.0,0,0,1,0,1
Stefan Maierhofer,0,1.0,0,0,1,0,1
Stefan Majewski,1,92.0,0,0,2,0,2
Stefan Mugoša,0,260.0,0,0,2,2,4
Stefan Pettersson,0,76.0,0,0,1,0,1
Stefan Posch,0,21.0,0,0,0,1,1
Stefan Reshko,0,22.0,1,0,1,0,1
Stefan Ristovski,0,66.0,0,0,1,0,1
Stefan Rusnák,0,5.0,0,0,0,1,1
Stefan Savić,0,87.0,0,0,1,1,2
Stefan Sultana,0,50.0,0,0,2,0,2
Stefan Velichkov,0,72.0,0,0,1,0,1
Stefan de Vrij,1,119.0,0,0,0,2,2
Stefan Šćepović,0,74.0,0,0,1,0,1
Stefanis Michael,0,85.0,0,0,1,1,2
Stefano Bensi,0,197.0,0,0,1,2,3
Stefano Cincotta,0,50.0,0,0,0,2,2
Stefano Eranio,0,170.0,0,0,2,0,2
Stefano Fanelli,0,82.0,0,0,1,0,1
Stefano Fiore,0,66.0,0,0,0,1,1
Stefano Sensi,0,65.0,0,0,1,1,2
Stefanos Borbokis,0,146.0,0,0,3,0,3
Stefanos Lysandrou,0,42.0,0,0,0,1,1
Steffen Iversen,1,669.0,0,3,7,10,17
Stefán Teitur Þórðarson,0,19.0,0,0,1,0,1
Stein Thunberg,0,65.0,0,0,1,0,1
Steinar Dagur Adolfsson,0,67.0,0,0,0,1,1
Stelios Giannakopoulos,0,211.0,0,0,0,4,4
Stelios Manolas,0,68.0,0,0,1,0,1
Stelios Okkarides,0,80.0,0,0,0,1,1
Sten-Ove Ramberg,0,35.0,0,0,1,0,1
Stephan El Shaarawy,0,125.0,0,0,0,2,2
Stephan Lichtsteiner,0,343.0,0,0,6,0,6
Stephan Rabemananjara,0,18.0,0,0,1,0,1
Stephan Schröck,1,264.0,0,0,2,2,4
Stephen Appiah,1,290.0,0,1,6,0,6
Stephen Astwood,0,140.0,0,0,2,0,2
Stephen Elliott,0,6.0,0,0,0,1,1
Stephen Eustáquio,3,100.0,0,0,1,2,3
Stephen Ireland,0,144.0,0,0,1,3,4
Stephen Keshi,3,383.0,0,1,2,6,8
Stephen Malcolm,0,84.0,0,0,1,0,1
Stephen McManus,0,167.0,0,0,2,0,2
Stephen O'Donnell,0,59.0,1,0,0,1,1
Stephen Ward,0,32.0,0,0,1,0,1
Stephen Wellman,0,74.0,0,0,1,0,1
Stern John,3,1339.0,0,0,15,8,23
Stevan Jovetić,0,1075.0,0,3,11,6,17
Steve Archibald,1,147.0,0,0,2,0,2
Steve Borg,0,77.0,0,1,1,0,1
Steve Coppell,0,22.0,0,0,1,0,1
Steve Corica,1,93.0,0,0,2,0,2
Steve Fatupua-Lecaill,2,167.0,0,0,1,1,2
Steve Finnan,0,90.0,0,0,1,0,1
Steve Hodge,0,19.0,0,0,0,1,1
Steve Horvat,1,15.0,0,0,1,0,1
Steve Lomas,0,25.0,0,0,1,0,1
Steve Marlet,0,108.0,0,0,2,1,3
Steve McManaman,1,92.0,0,0,2,1,3
Steve Morison,0,28.0,0,0,1,0,1
Steve Morrow,0,62.0,1,0,0,1,1
Steve Mounié,0,173.0,0,0,1,2,3
Steve Penney,0,23.0,0,0,1,0,1
Steve Purdy,0,13.0,0,0,1,0,1
Steve Ralston,0,163.0,0,0,3,0,3
Steve Staunton,0,150.0,0,0,1,3,4
Steve Sumner,2,884.0,0,1,14,3,17
Steve Wooddin,2,238.0,0,0,5,4,9
Steven Berghuis,0,74.0,0,0,1,1,2
Steven Bergwijn,0,84.0,0,0,1,0,1
Steven Bryce,3,253.0,0,0,2,2,4
Steven Davis,0,557.0,0,3,8,2,10
Steven Defour,0,109.0,0,0,1,1,2
Steven Dias,0,90.0,0,0,1,0,1
Steven Fletcher,3,594.0,0,0,5,4,9
Steven Gerrard,6,796.0,0,0,10,6,16
Steven Naismith,1,431.0,0,0,5,2,7
Steven Pienaar,0,85.0,0,0,2,0,2
Steven Séance,0,81.0,0,0,1,0,1
Steven Tan,1,35.0,0,1,0,1,1
Steven Thompson,0,31.0,0,0,0,1,1
Steven Zuber,1,256.0,0,0,3,3,6
Stevenson Morancie,0,60.0,0,0,0,1,1
Stevie Chalmers,0,38.0,0,0,1,0,1
Stig Fredriksson,0,69.0,0,0,0,1,1
Stig Holmqvist,0,8.0,1,0,1,0,1
Stig Sundqvist,3,72.0,0,0,1,2,3
Stig Tøfting,1,156.0,0,1,0,2,2
Stiliyan Petrov,0,177.0,1,0,1,4,5
Stjepan Bobek,1,167.0,0,1,1,3,4
Stjepan Lončar,0,90.0,1,0,1,0,1
Stock Dandize,0,71.0,0,0,1,0,1
Stokely Mason,0,54.0,0,0,1,0,1
Stophira Sunzu,1,15.0,0,0,1,0,1
Stopira,0,80.0,0,0,1,1,2
Stoyan Kitov,0,69.0,0,0,1,0,1
Stoycho Mladenov,0,247.0,0,0,2,2,4
Strahinja Pavlović,1,45.0,0,0,0,1,1
Stratos Apostolakis,0,321.0,1,2,3,2,5
Stuart Armstrong,0,112.0,0,0,1,1,2
Stuart Dallas,0,90.0,0,0,0,1,1
Stuart Elliott,0,237.0,0,0,2,1,3
Stuart Findlay,0,67.0,0,0,1,0,1
Stuart Holden,0,179.0,0,0,3,0,3
Stuart McCall,1,11.0,0,0,0,1,1
Stuart Oosthuizen,0,90.0,0,0,1,0,1
Stuart Pearce,0,113.0,0,0,2,0,2
Stuart Pearson,0,14.0,0,0,0,1,1
Ståle Solbakken,0,130.0,0,0,4,1,5
Stéphane Abaul,1,70.0,0,0,0,1,1
Stéphane Auvray,1,57.0,0,0,1,0,1
Stéphane Bahoken,2,181.0,0,0,2,1,3
Stéphane Bruey,0,71.0,0,0,0,1,1
Stéphane Chapuisat,2,920.0,0,0,10,7,17
Stéphane Demol,1,102.0,0,0,0,1,1
Stéphane Grichting,0,84.0,0,0,1,0,1
Stéphane Lambese,1,56.0,0,0,1,0,1
Stéphane Mbia,2,147.0,0,0,0,3,3
Stéphane N'Guéma,0,226.0,0,0,4,0,4
Stéphane Sessègnon,0,181.0,0,1,2,2,4
Su Maozhen,1,117.0,0,0,2,1,3
Suan Lam Mang,1,64.0,0,0,3,0,3
Suat Mamat,4,106.0,0,0,1,3,4
Subait Khater,0,124.0,0,0,2,1,3
Subash Madushan,0,34.0,0,0,0,1,1
Subhi Al-Gnimaz,2,149.0,0,0,1,2,3
Sudirman,2,137.0,0,1,3,0,3
Sujal Shrestha,0,90.0,0,0,1,0,1
Suk Bahadur,1,85.0,0,0,1,0,1
Suk Hyun-jun,0,100.0,0,0,1,1,2
Sukhrob Hamidov,4,255.0,0,1,4,1,5
Sukumar Samajpati,1,60.0,0,0,0,1,1
Suleiman Faris,0,38.0,0,0,0,1,1
Sulejman Demollari,0,86.0,0,0,0,1,1
Sulley Muntari,2,582.0,0,1,8,4,12
Sultan Bakhit Al-Kuwari,0,60.0,0,0,1,0,1
Sun Fucheng,0,47.0,0,0,1,0,1
Sun Jihai,0,62.0,0,0,1,0,1
Sun Ke,3,111.0,0,0,3,0,3
Sun Xiang,0,12.0,0,0,0,1,1
Sunday Ineh,0,55.0,0,0,0,1,1
Sunday Mba,2,118.0,0,0,1,1,2
Sunday Oliseh,1,91.0,0,0,1,1,2
Sunday Oyarekhua,0,28.0,0,0,0,1,1
Sundayin Moriri,0,135.0,0,0,1,1,2
Sune Andersson,1,117.0,0,2,1,2,3
Sung Nak-woon,2,134.0,0,0,1,2,3
Sunil Chhetri,6,628.0,0,2,5,8,13
Supachai Jaided,1,31.0,0,0,1,0,1
Supachok Sarachat,0,126.0,0,0,0,2,2
Supakit Meelarpkit,1,140.0,1,0,1,1,2
Suphanat Mueanta,0,54.0,0,0,0,1,1
Surachai Jirasirichote,0,83.0,0,0,1,0,1
Suree Sukha,0,39.0,0,0,0,1,1
Suriamurthy Rajagopal,0,70.0,0,0,1,0,1
Surprise Moriri,0,33.0,0,0,1,0,1
Sutche Wambo,0,85.0,0,0,1,0,1
Sutee Suksomkit,1,128.0,0,1,3,1,4
Svein Mathisen,0,79.0,0,0,0,1,1
Sven Andersson,0,79.0,0,0,1,0,1
Sven Jacobsson,1,19.0,1,0,1,0,1
Sven Jonasson,3,153.0,0,1,1,3,4
Sven Otto Birkeland,0,46.0,0,0,1,0,1
Sverre Brandhaug,0,64.0,0,0,0,1,1
Svetoslav Todorov,0,161.0,0,1,2,0,2
Syafiq Ahmad,0,66.0,0,0,1,1,2
Syam Ben Youssef,0,51.0,0,0,1,0,1
Syarhey Herasimets,0,310.0,0,1,2,3,5
Syarhey Kislyak,0,86.0,0,0,0,1,1
Syd Bartlett,0,36.0,0,0,1,0,1
Sydney Urikhob,0,169.0,0,0,1,1,2
Sylvain Booene,1,42.0,0,0,0,1,1
Sylvain Graglia,0,144.0,0,0,0,2,2
Sylvain Wiltord,3,735.0,0,0,11,4,15
Sylvio Pirillo,6,289.0,0,0,6,0,6
Sylwester Czereszewski,0,63.0,0,0,0,2,2
Syriakata Hassan,1,82.0,0,0,0,1,1
Szabolcs Huszti,0,188.0,0,2,1,2,3
Szilárd Devecseri,0,65.0,1,0,1,0,1
Szilárd Németh,0,499.0,0,0,10,3,13
Sándor Kiss,0,57.0,0,0,1,0,1
Sándor Kocsis,11,603.0,0,0,5,6,11
Sándor Müller,0,65.0,0,1,0,1,1
Sándor Pintér,0,52.0,0,0,2,0,2
Sándor Schwartz,0,38.0,0,0,1,0,1
Sándor Torghelle,0,238.0,0,0,3,3,6
Sándor Zombori,1,63.0,0,0,1,1,2
Sándor Zámbó,0,83.0,0,0,2,0,2
Sávio Bortolini Pimentel,2,94.0,0,0,1,1,2
Séamus Coleman,0,56.0,0,0,1,0,1
Sébastien Fournier,0,107.0,0,0,1,1,2
Sébastien Haller,1,74.0,0,1,3,0,3
Sébastien Siani,1,61.0,0,0,1,0,1
Sébastien Thill,0,168.0,0,0,1,1,2
Sébastien Vorbe,1,61.0,0,0,1,0,1
Sékou Bamba,0,169.0,0,0,2,0,2
Sékou Dramé,0,16.0,0,0,1,0,1
Sérgio Conceição,4,450.0,0,0,6,3,9
Séïdath Tchomogo,0,85.0,0,0,0,3,3
Símun Samuelsen,0,90.0,0,0,0,1,1
Sócrates,4,408.0,0,3,5,5,10
Sølvi Vatnhamar,0,62.0,0,0,0,1,1
Søren Busk,0,76.0,0,0,1,0,1
Søren Frederiksen,0,58.0,0,0,1,0,1
Søren Larsen,0,434.0,0,0,7,3,10
Søren Lerby,2,348.0,0,1,5,3,8
Súni Olsen,0,73.0,1,0,3,0,3
Süleýman Muhadow,0,67.0,0,0,1,0,1
Sławomir Peszko,0,26.0,0,0,0,1,1
T. Tapunuu,1,10.0,0,0,1,0,1
Taavi Rähn,0,33.0,1,0,1,0,1
Tab Ramos,0,151.0,0,0,2,0,2
Tabania Ametepé,0,55.0,0,0,0,1,1
Tadanari Lee,1,109.0,0,0,0,1,1
Tadas Kijanskas,0,110.0,1,0,1,1,2
Tadeusz Kraus,0,217.0,0,0,2,2,4
Tadjou Salou,0,163.0,0,1,2,0,2
Tafari Smith,0,48.0,1,0,1,0,1
Taha Basry,3,159.0,0,0,4,0,4
Taha Yassine Khenissi,2,109.0,0,0,0,2,2
Tahar Chaïbi,1,102.0,0,0,3,0,3
Tahar Chérif El-Ouazzani,0,81.0,0,0,1,0,1
Tahar El Khalej,0,42.0,0,0,1,0,1
Taher Abouzeid,2,361.0,0,0,4,3,7
Tahir Agha,1,12.0,0,0,0,1,1
Taisir Al-Jassim,3,427.0,0,0,6,2,8
Taiwo Awoniyi,1,45.0,0,0,1,0,1
Tajon Buchanan,1,231.0,0,0,3,1,4
Tak Yong-Bin,0,4.0,0,0,0,1,1
Takashi Fukunishi,1,252.0,0,0,1,4,5
Takashi Inui,2,86.0,0,0,1,1,2
Takashi Mizunuma,0,175.0,0,0,3,0,3
Takashi Usami,1,88.0,0,0,0,1,1
Takayuki Suzuki,1,297.0,0,0,5,2,7
Takehiro Tomiyasu,1,20.0,0,0,1,0,1
Takhirdjon Mouminov,0,108.0,0,0,2,1,3
Takis Antoniou,0,13.0,0,0,1,0,1
Takis Mavris,0,47.0,0,0,1,0,1
Takis Nikoloudis,0,65.0,0,0,3,0,3
Takuma Asano,1,448.0,0,0,3,3,6
Takumi Horiike,1,54.0,0,0,1,1,2
Takumi Minamino,1,425.0,0,1,7,4,11
Takuya Takagi,9,861.0,0,0,8,8,16
Tal Banin,0,203.0,0,3,4,1,5
Tal Ben Haim,0,266.0,0,1,2,4,6
Tala Luvu,1,62.0,1,0,0,1,1
Talal Al-Bloushi,0,86.0,0,0,1,0,1
Talal Al-Meshal,3,836.0,0,0,13,4,17
Talal El Karkouri,1,252.0,0,0,3,1,4
Talal Yousef,2,304.0,0,0,3,3,6
Tam Siu Wai,0,13.0,0,0,0,1,1
Tama Fasavalu,0,83.0,0,0,2,0,2
Tamarley Thomas,0,263.0,0,0,4,2,6
Tamer Abdel Hamid,1,58.0,0,0,0,1,1
Tamer Haj Mohamad,0,13.0,0,0,0,1,1
Tamer Seyam,3,264.0,0,2,3,2,5
Tamirlan Kozubaev,0,83.0,0,0,1,0,1
Tamkin Khalilzade,0,72.0,0,0,1,0,1
Tammy Abraham,0,221.0,0,0,1,2,3
Tamás Hajnal,0,74.0,0,0,2,1,3
Tamás Kádár,0,6.0,0,0,1,0,1
Tamás Preszeller,0,88.0,0,0,1,0,1
Tamás Priskin,0,166.0,0,0,3,1,4
Tan Chun Lok,0,16.0,0,0,0,1,1
Tan Long,1,79.0,0,0,1,0,1
Tana Chanabut,0,139.0,0,0,1,1,2
Tanaboon Kesarat,0,84.0,1,0,0,1,1
Tanat Nusserbayev,0,19.0,0,0,0,1,1
Tang Hung Cheong,0,65.0,0,0,1,0,1
Tang Yaodong,1,116.0,0,0,1,1,2
Tang Yee Kit,0,10.0,0,0,1,0,1
Tanju Çolak,0,188.0,0,0,2,2,4
Taoufik Herichi,0,121.0,0,0,0,3,3
Tapiwa Gadibolae,0,14.0,0,0,1,0,1
Taqi Mubarak,0,127.0,0,0,3,1,4
Tarak Dhiab,0,100.0,0,0,1,1,2
Tarcisio Burgnich,1,98.0,0,0,0,1,1
Tarcisio Rodríguez Viquez,0,55.0,0,0,1,0,1
Tarek El Ali,0,64.0,0,0,1,0,1
Tarek El-Said,0,350.0,0,0,5,0,5
Tarek Jabban,0,115.0,0,0,3,0,3
Tarek Lazizi,0,84.0,0,0,0,1,1
Tarek Mostafa,1,13.0,0,0,0,1,1
Tareq Ahmed,0,90.0,0,0,1,0,1
Tareq Khattab,1,43.0,0,0,1,0,1
Tarik El Taib,0,108.0,0,0,2,0,2
Tarik Elyounoussi,0,193.0,0,1,3,1,4
Tarik Sektioui,1,48.0,0,1,0,2,2
Tarik Tissoudali,0,121.0,0,0,1,1,2
Tariku Ingdawerk,0,60.0,0,0,2,1,3
Tariq Abdullah Kassim,0,75.0,0,0,0,1,1
Tarlan Ahmadov,0,33.0,1,0,0,1,1
Tarmo Kink,0,143.0,0,0,1,2,3
Tasos Mitropoulos,0,224.0,0,0,3,2,5
Tatsuhiko Kubo,0,102.0,0,0,2,0,2
Tatsuya Tanaka,0,19.0,0,0,0,1,1
Tauhiti Keck,0,90.0,0,0,1,0,1
Tay Peng Kee,1,53.0,0,0,1,0,1
Taye Taiwo,1,85.0,0,0,1,0,1
Tayfun Korkut,0,2.0,0,0,1,0,1
Tayfur Havutçu,0,408.0,0,2,1,5,6
Taylor Saghabi,1,189.0,0,0,1,3,4
Taylor Twellman,0,130.0,0,0,2,0,2
Taysir Amer,1,166.0,0,0,1,1,2
Tchiressoua Guel,4,121.0,0,1,4,1,5
Teafore Bennett,1,80.0,0,0,1,0,1
Teaonui Tehau,5,403.0,0,0,4,3,7
Teboho Masia,0,65.0,0,0,1,0,1
Teboho Mokoena,1,134.0,0,0,1,2,3
Ted MacDougall,0,61.0,0,0,1,0,1
Ted Robledo,0,16.0,0,0,1,0,1
Teddy Sheringham,0,328.0,0,0,4,2,6
Tedj Bensaoula,4,402.0,0,0,7,2,9
Teemu Pukki,1,1153.0,0,4,11,9,20
Teemu Tainio,0,181.0,0,0,1,3,4
Teerasil Dangda,1,336.0,0,1,7,4,11
Teeratep Winothai,0,122.0,0,1,2,1,3
Teet Allas,0,22.0,0,0,1,0,1
Teitur Gestsson,0,34.0,1,0,0,1,1
Teitur Thordarson,0,33.0,0,0,1,0,1
Teitur Þórðarson,0,80.0,0,0,0,1,1
Tejinder Kumar,0,68.0,0,0,0,1,1
Tekalinge Kassahun,0,40.0,0,0,1,0,1
Tekeste Gebremedhin,0,30.0,0,0,0,1,1
Telinho,0,10.0,0,0,0,1,1
Telmo Zarra,4,342.0,0,0,4,3,7
Telésforo Báez,0,44.0,0,0,0,1,1
Temirlan Yerlanov,0,34.0,0,0,1,0,1
Temur Ketsbaia,0,343.0,0,0,5,4,9
Tenant Chilumba,1,87.0,0,0,1,0,1
Tendai Ndoro,1,58.0,0,0,1,0,1
Tenema Ndiaye,0,68.0,0,0,0,1,1
Tengiz Sulakvelidze,0,44.0,0,0,0,1,1
Teodor Țarălungă,0,72.0,0,0,0,1,1
Teodoro Fernández,7,550.0,0,1,9,6,15
Teppo Heikkinen,0,54.0,0,0,1,0,1
Terence Groothusen,1,45.0,0,0,0,1,1
Terence Scerri,0,71.0,0,0,1,0,1
Terence Vancooten,2,48.0,1,0,1,1,2
Terio Vakatawa,0,90.0,0,0,0,1,1
Terrence Tisdell,0,18.0,0,1,1,0,1
Terry Butcher,0,80.0,0,0,0,1,1
Terry Conroy,0,110.0,0,0,2,0,2
Terry Harkin,0,123.0,0,0,0,2,2
Terry Hennessey,0,65.0,1,0,1,0,1
Terry McDermott,0,170.0,0,0,2,1,3
Terry Medwin,1,95.0,0,0,0,2,2
Terry Neill,0,62.0,0,0,1,0,1
Terry Yorath,0,75.0,0,0,1,0,1
Teruki Miyamoto,1,38.0,0,0,0,2,2
Tes Sean,1,59.0,0,0,1,0,1
Tesfalem Tekle,0,35.0,0,0,1,0,1
Tesfaye Tafese,0,47.0,0,0,1,0,1
Tesho Akindele,0,4.0,0,0,1,0,1
Teshome Getu,0,81.0,0,1,1,0,1
Tesourinha,1,380.0,0,1,7,1,8
Tetahio Auraa,1,65.0,0,0,1,0,1
Teteh Bangura,0,25.0,0,0,0,1,1
Tetsuji Hashiratani,0,38.0,0,0,2,0,2
Teu Fakava,1,86.0,0,0,0,1,1
Teuvo Moilanen,0,90.0,1,0,0,1,1
Teva Zaveroni,2,92.0,0,0,1,1,2
Tevaughn Harriette,0,106.0,0,0,2,0,2
Tevin Slater,0,318.0,0,0,2,3,5
Tevita Waranaivalu,1,12.0,0,0,1,0,1
Teófilo Aguilar,0,62.0,0,0,0,1,1
Teófilo Cubillas,12,861.0,0,2,6,9,15
Teófilo Gutiérrez,1,534.0,0,0,8,1,9
Tha'er Bawab,0,176.0,0,0,0,2,2
Thabo Matlaba,0,33.0,0,0,1,0,1
Thabo Mngomeni,1,48.0,0,0,1,0,1
Thadée Cisowski,0,390.0,0,0,7,2,9
Thamsanqa Gabuza,0,20.0,0,0,0,1,1
Thamsanqa Mkhize,0,38.0,1,0,0,1,1
Thanasis Bembis,0,52.0,0,0,1,0,1
Thanis Areesngarkul,1,132.0,0,0,1,1,2
Thapelo Tale,0,16.0,0,0,0,1,1
Thasmbiayah Pathmanathan,0,87.0,0,0,0,1,1
Thawatchai Damrong-Ongtrakul,1,84.0,0,0,1,0,1
Theerathon Bunmathan,0,215.0,0,2,1,2,3
Themba Zwane,0,34.0,0,0,1,0,1
Thembinkosi Fanteni,0,62.0,0,0,1,0,1
Thembinkosi Lorch,0,85.0,0,0,0,1,1
Themistoklis Nikolaidis,0,69.0,0,0,0,1,1
Themistoklis Tzimopoulos,1,16.0,0,0,1,0,1
Theo Corbeanu,2,170.0,0,0,2,0,2
Theo Laseroms,0,64.0,0,0,0,1,1
Theo Pahlplatz,0,185.0,0,0,3,0,3
Theo Walcott,1,422.0,0,0,1,6,7
Theo de Jong,1,158.0,0,0,1,1,2
Theodor Gebre Selassie,0,96.0,0,0,1,2,3
Theodor Wagner,0,327.0,0,0,3,3,6
Theodore Filomina,0,124.0,0,0,2,0,2
Theodore Whitmore,2,339.0,0,0,5,4,9
Theodoros Zagorakis,0,128.0,2,0,2,1,3
Theofanis Gekas,1,952.0,0,1,12,7,19
Therdsak Chaiman,2,206.0,0,0,3,0,3
Theódór Elmar Bjarnason,0,42.0,0,0,1,0,1
Thiago Alcântara,0,27.0,0,0,1,0,1
Thiago Cionek,1,37.0,1,0,0,1,1
Thiago Motta,0,73.0,0,0,0,1,1
Thiago Silva,2,83.0,0,0,2,1,3
Thierno Youm,0,67.0,0,0,0,1,1
Thierry Bin,0,29.0,0,0,0,1,1
Thierry Fondelot,1,86.0,0,0,0,1,1
Thierry Henry,9,1605.0,0,2,21,13,34
Thierry Issiémou,0,73.0,0,0,2,0,2
Thierry Tinmar,1,59.0,0,1,0,1,1
Thievy Bifouma,2,314.0,0,0,3,3,6
Thitipan Puangchan,0,41.0,0,0,0,1,1
Thomas Beck,0,368.0,0,0,5,0,5
Thomas Berthold,0,8.0,0,0,0,1,1
Thomas Bickel,0,125.0,0,0,3,1,4
Thomas Buffel,0,181.0,0,0,3,0,3
Thomas Christiansen,0,86.0,0,0,1,0,1
Thomas Delaney,1,334.0,0,0,2,5,7
Thomas Doll,0,187.0,0,0,1,2,3
Thomas Dooley,0,127.0,0,0,2,0,2
Thomas Elliot,0,72.0,0,0,1,0,1
Thomas Flögel,0,95.0,0,0,1,1,2
Thomas Foket,0,76.0,0,0,0,1,1
Thomas Fontaine,0,45.0,0,0,0,1,1
Thomas Gravesen,0,169.0,0,0,2,2,4
Thomas Helmer,0,82.0,0,0,2,0,2
Thomas Helveg,1,76.0,0,0,0,1,1
Thomas Hitzlsperger,0,338.0,0,0,2,3,5
Thomas Häßler,1,411.0,0,0,4,4,8
Thomas Kahlenberg,0,251.0,0,0,3,1,4
Thomas Larsson,0,38.0,0,0,0,1,1
Thomas Lemar,0,161.0,0,0,2,0,2
Thomas Linke,1,73.0,0,0,1,0,1
Thomas Mavros,0,337.0,0,2,6,1,7
Thomas Meunier,1,249.0,0,0,5,3,8
Thomas Müller,9,1547.0,0,2,20,14,34
Thomas Nordahl,0,108.0,0,0,2,1,3
Thomas Parits,0,279.0,0,0,5,0,5
Thomas Partey,1,359.0,0,0,2,5,7
Thomas Sjöberg,1,379.0,0,0,2,5,7
Thomas Sowunmi,0,55.0,0,0,1,0,1
Thomas Strunz,0,44.0,0,0,0,1,1
Thomas Sunesson,0,150.0,0,0,2,1,3
Thomas Ulimwengu,0,103.0,0,0,3,0,3
Thomas Vermaelen,0,24.0,0,0,0,1,1
Thomas Vulivuli,1,24.0,0,0,1,0,1
Thomaz Soares da Silva,0,136.0,0,0,2,0,2
Thompson Oliha,0,20.0,0,0,1,0,1
Thompson Usiyan,2,175.0,0,0,5,0,5
Thorgan Hazard,1,270.0,0,0,4,2,6
Thorstein Helstad,0,229.0,0,0,2,2,4
Thrizen Leader,0,117.0,1,0,1,1,2
Thulani Hlatshwayo,1,67.0,1,0,1,0,1
Thuso Phala,1,51.0,0,0,0,1,1
Thuwein Ali,0,242.0,0,0,2,1,3
Thuwein Waziri,2,145.0,0,0,0,2,2
Théo Hernandez,1,5.0,0,0,1,0,1
Théo Malget,0,71.0,0,0,0,2,2
Théodore Nzue Nguema,0,246.0,0,0,4,1,5
Théophile Abega,3,220.0,0,0,4,0,4
Théophile Speicher,0,47.0,0,0,1,0,1
Tia Koffi,0,27.0,0,0,1,0,1
Tiago Mendes,2,154.0,0,0,2,1,3
Tiberio Godoy,3,95.0,0,0,0,3,3
Tiberiu Ghioane,0,81.0,0,0,0,1,1
Tibor Jančula,1,309.0,0,0,4,2,6
Tibor Nyilasi,2,778.0,0,0,17,3,20
Tibor Vigh,0,92.0,0,0,2,0,2
Tibor Wollek,0,78.0,0,0,1,0,1
Tibou Bangoura,0,61.0,0,0,1,0,1
Tico-Tico,1,211.0,0,0,4,1,5
Tigran Barseghyan,0,325.0,0,1,3,2,5
Tigran Yesayan,0,220.0,0,0,2,1,3
Tihomir Ognjanov,1,84.0,0,0,0,1,1
Tijan Jaiteh,0,106.0,0,1,1,1,2
Tijani Babangida,1,162.0,0,0,5,0,5
Tijani Belaid,0,38.0,0,0,1,0,1
Tim Bredbury,0,54.0,0,0,1,1,2
Tim Cahill,9,1865.0,0,0,26,10,36
Tim Matavž,0,347.0,0,0,6,2,8
Tim Payne,0,91.0,0,0,0,2,2
Tim Stevens,0,80.0,0,0,1,0,1
Timmy Simons,0,203.0,0,6,4,2,6
Timo Rahja,0,19.0,0,0,2,0,2
Timo Werner,4,739.0,0,0,7,6,13
Timofei Kalachev,0,528.0,0,0,6,4,10
Timote Maamaaloa,1,26.0,0,0,1,0,1
Timote Moleni,0,87.0,0,0,2,0,2
Timothy Batabaire,0,19.0,0,0,1,0,1
Timothy Castagne,0,104.0,0,0,2,0,2
Timothy Mwitwa,0,68.0,0,0,1,0,1
Timothy Weah,1,47.0,0,0,1,1,2
Timur Kapadze,1,245.0,0,0,4,2,6
Tinashe Nengomasha,0,79.0,0,0,0,1,1
Tinol Christie,1,1.0,0,0,1,0,1
Tishan Hanley,0,68.0,0,0,1,0,1
Tita,0,252.0,0,0,5,0,5
Titi Camara,2,615.0,0,0,5,6,11
Tito Montaño,0,45.0,0,0,0,1,1
Titus Buberník,0,168.0,0,0,5,0,5
Titus Elva,0,209.0,0,0,2,1,3
Titus Mulama,1,103.0,0,0,2,0,2
Titus Ozon,0,78.0,0,0,0,1,1
Tivadar Monostori,0,21.0,0,0,1,0,1
Tjay De Barr,0,71.0,0,1,0,1,1
Tobias Hysén,0,164.0,0,0,2,1,3
Toby Alderweireld,1,145.0,0,0,2,2,4
Todi Jónsson,0,367.0,0,0,3,4,7
Todor Diev,0,240.0,0,0,5,0,5
Todor Kolev,1,89.0,0,0,1,0,1
Todor Nedelev,0,198.0,0,1,3,0,3
Todor Veselinović,3,222.0,0,0,0,4,4
Togbe Dovi-Akon,0,87.0,0,0,1,0,1
Tokelo Rantie,0,58.0,0,0,1,2,3
Tokhirjon Muminov,1,13.0,0,0,1,0,1
Tokia Russell,0,34.0,0,0,1,0,1
Tol Kimchi,0,93.0,0,0,0,2,2
Tolga Seyhan,0,12.0,0,0,0,1,1
Tolutau Vane,0,29.0,0,0,1,0,1
Tom Boyd,1,99.0,1,0,2,0,2
Tom Finney,2,152.0,0,1,2,0,2
Tom Florie,1,45.0,0,0,0,1,1
Tom Høgli,0,152.0,0,0,1,1,2
Tom Lawrence,0,49.0,0,0,0,1,1
Tom Lund,0,365.0,0,0,6,2,8
Tom McColl,3,194.0,0,0,1,3,4
Tom McCulloch,0,86.0,0,0,0,1,1
Tom Rodríguez,0,16.0,0,0,1,0,1
Tom Rogic,2,463.0,0,0,9,0,9
Tom Sundby,0,164.0,0,0,1,2,3
Tom Søndergaard,0,92.0,0,0,1,1,2
Tom Turesson,1,231.0,0,0,3,1,4
Tomas Brolin,4,590.0,0,3,10,2,12
Tomas Danilevičius,0,418.0,0,2,6,3,9
Tomas Jun,0,6.0,0,0,0,1,1
Tomas Ramelis,0,107.0,0,0,0,2,2
Tomas Ražanauskas,0,332.0,0,2,2,3,5
Tomas Žiukas,0,51.0,0,0,1,0,1
Tomasz Frankowski,0,376.0,0,0,3,4,7
Tomasz Hajto,0,15.0,0,0,1,0,1
Tomasz Iwan,0,178.0,0,0,1,2,3
Tomasz Kędziora,0,50.0,0,0,1,0,1
Tomasz Kłos,0,96.0,0,0,0,2,2
Tomasz Radzinski,1,215.0,0,0,3,1,4
Tomasz Wałdoch,0,33.0,0,0,1,0,1
Tomasz Wieszczycki,0,58.0,0,0,1,0,1
Tome Faisi,0,77.0,1,0,0,1,1
Tome Pačovski,0,8.0,1,0,0,1,1
Tomer Hemed,0,569.0,0,2,6,7,13
Tomi Juric,1,373.0,0,0,6,1,7
Tomislav Kaloperović,0,42.0,0,1,1,0,1
Tomislav Knez,0,75.0,0,0,0,1,1
Tomislav Marić,0,70.0,0,0,1,0,1
Tommy Carroll,0,44.0,0,1,1,0,1
Tommy Casey,0,22.0,0,0,1,0,1
Tommy Coyne,0,6.0,0,0,2,0,2
Tommy Eglington,0,59.0,0,0,1,0,1
Tommy Finney,0,3.0,0,0,0,1,1
Tommy Gemmell,0,76.0,0,0,1,0,1
Tommy Lindholm,0,95.0,0,1,1,1,2
Tommy Oar,0,149.0,0,0,0,2,2
Tommy Ring,0,71.0,0,0,0,1,1
Tommy Semmy,2,112.0,0,0,2,1,3
Tommy Smith,1,101.0,0,0,1,1,2
Tommy Taylor,0,303.0,0,0,6,2,8
Tommy Troelsen,0,79.0,0,0,1,0,1
Tomokazu Myojin,2,123.0,0,0,1,1,2
Tomás Balcázar,1,280.0,0,0,4,2,6
Tomás Fernández,1,57.0,0,0,1,0,1
Tomáš Galásek,0,52.0,0,0,1,0,1
Tomáš Holeš,1,68.0,0,0,0,1,1
Tomáš Hübschman,0,3.0,0,0,0,1,1
Tomáš Kalas,0,84.0,1,0,1,0,1
Tomáš Necid,1,392.0,0,1,3,3,6
Tomáš Oravec,0,89.0,0,0,0,1,1
Tomáš Pekhart,0,142.0,0,0,1,1,2
Tomáš Pospíchal,1,246.0,0,0,4,0,4
Tomáš Rosický,2,848.0,0,1,8,7,15
Tomáš Sivok,0,105.0,0,0,1,1,2
Tomáš Skuhravý,6,681.0,0,1,9,4,13
Tomáš Souček,3,177.0,0,0,0,4,4
Tomáš Řepka,0,65.0,0,0,1,0,1
Toni Kroos,1,666.0,0,1,7,4,11
Toni Micevski,0,114.0,0,0,1,2,3
Toni Polster,1,1353.0,0,5,16,13,29
Toni Šunjić,0,33.0,0,0,0,1,1
Toninho Cerezo,1,70.0,0,0,1,0,1
Tonny van de Linden,0,22.0,0,0,0,2,2
Tony Adams,1,41.0,0,0,1,1,2
Tony Cascarino,0,836.0,0,0,8,5,13
Tony Dunne,0,85.0,2,0,1,1,2
Tony Galvin,0,44.0,0,0,0,1,1
Tony Grealish,0,245.0,0,0,5,1,6
Tony Henderson,0,17.0,0,0,1,0,1
Tony Laus,0,131.0,0,0,3,0,3
Tony Lochhead,0,69.0,0,0,1,0,1
Tony Mawejje,0,93.0,0,0,2,0,2
Tony Persson,0,89.0,0,0,0,1,1
Tony Popovic,1,307.0,0,0,6,0,6
Tony Senechal,3,73.0,0,0,0,3,3
Tony Tsabedze,0,83.0,0,0,0,1,1
Tony Vidmar,0,134.0,0,0,2,0,2
Tony Woodcock,1,485.0,0,0,3,8,11
Tony Yeboah,3,155.0,0,0,2,2,4
Toon Brusselers,0,80.0,0,0,1,0,1
Topu Barman,1,83.0,0,0,1,0,1
Tor Egil Johansen,0,229.0,0,0,1,2,3
Tor Fuglset,0,83.0,0,0,0,1,1
Torbjörn Jonsson,0,107.0,0,0,3,0,3
Torbjörn Nilsson,0,38.0,0,0,0,1,1
Tore André Dahlum,0,69.0,0,0,2,0,2
Tore André Flo,1,585.0,0,0,2,8,10
Tore Cervin,0,29.0,0,0,1,0,1
Tore Keller,1,80.0,0,0,0,1,1
Tore Reginiussen,0,4.0,0,0,1,0,1
Torea,1,90.0,0,0,0,1,1
Torkil Nielsen,1,61.0,0,0,1,0,1
Tornike Okriashvili,1,219.0,0,2,4,3,7
Torsten Bunke,0,43.0,0,0,1,0,1
Torsten Frings,1,173.0,0,1,3,0,3
Tosaint Ricketts,0,410.0,0,0,6,1,7
Toshio Iwatani,0,78.0,0,0,2,0,2
Toshiya Fujita,0,81.0,0,0,0,1,1
Tostão,3,472.0,0,0,8,5,13
Totchtawan Sripan,0,80.0,0,1,1,1,2
Toto Tamuz,1,106.0,0,0,1,1,2
Traianos Dellas,1,105.0,0,0,1,0,1
Tranquillo Barnetta,1,221.0,0,0,0,4,4
Travis Nicklaw,0,100.0,1,0,2,0,2
Trayon Bobb,0,69.0,0,0,0,2,2
Tremain Paul,0,33.0,0,0,0,2,2
Trent Sainsbury,1,89.0,0,0,2,1,3
Tressor Moreno,3,130.0,0,2,4,2,6
Tresór Toropité,1,53.0,0,0,1,0,1
Trevin Caesar,0,175.0,0,0,2,0,2
Trevor Anderson,2,161.0,0,0,3,0,3
Trevor Brooking,1,178.0,0,0,1,3,4
Trevor Francis,2,348.0,0,0,4,4,8
Trevor Hockey,0,85.0,0,0,1,0,1
Trevor Lennen,0,90.0,1,0,1,0,1
Trevor Peters,0,38.0,0,0,1,0,1
Trifon Ivanov,0,199.0,0,0,2,3,5
Troy Greenidge,0,90.0,0,0,0,1,1
Troy Halpin,0,80.0,0,0,1,0,1
Tryggvi Guðmundsson,0,336.0,0,0,4,2,6
Trésor Mputu,2,339.0,0,0,4,5,9
Trézéguet,1,141.0,0,0,2,0,2
Trải Văn Đào,1,20.0,0,0,0,1,1
Trần Minh Vương,0,90.0,0,0,0,1,1
Trần Phi Sơn,0,90.0,0,0,0,1,1
Trần Văn Nhung,1,68.0,0,1,0,1,1
Trần Văn Tổng,1,88.0,0,0,0,2,2
Tsepo Lekhoana,0,75.0,0,0,0,1,1
Tsepo Seturumane,0,119.0,0,0,2,1,3
Tshepiso Molwantwa,0,101.0,0,0,3,1,4
Tshepo Motlhabankwe,0,88.0,0,0,0,1,1
Tshering Dorji,0,250.0,0,1,2,2,4
Tshilumba Mukendi,0,53.0,0,0,0,1,1
Tsholola Tshinyama,0,59.0,0,0,1,0,1
Tsoanelo Koetle,0,77.0,0,0,0,1,1
Tsukasa Shiotani,1,58.0,0,0,1,0,1
Tsuneyasu Miyamoto,0,87.0,0,0,0,1,1
Tsuyoshi Kitazawa,0,57.0,0,0,1,0,1
Tsvetan Atanasov,0,29.0,0,0,1,0,1
Tsvetan Yonchev,0,66.0,0,0,1,0,1
Tueba Menayane,1,1.0,0,0,0,1,1
Tukamin Bahari,2,179.0,0,0,1,1,2
Tuncay,1,665.0,0,0,6,6,12
Tuncay Şanlı,2,121.0,0,0,1,2,3
Tuomo Hakala,0,82.0,0,0,0,1,1
Turbie Terblanche,0,85.0,0,0,1,0,1
Turlough O'Connor,0,86.0,0,1,0,1,1
Turo Flink,0,15.0,0,0,1,0,1
Tursunali Rustamov,1,112.0,0,0,0,2,2
Tutizama Tanito,0,33.0,0,0,1,0,1
Txiki Begiristain,1,317.0,0,1,4,1,5
Tyio Simon,0,81.0,0,0,1,0,1
Tyler Boyd,0,132.0,0,0,2,0,2
Tymerlan Huseynov,0,269.0,0,0,1,4,5
Tyrell Burgess,0,99.0,0,0,2,0,2
Tyrone Loran,1,42.0,0,0,1,0,1
Tyrone Marshall,0,56.0,0,0,2,0,2
Tyrone Mings,0,69.0,0,0,0,1,1
Tyrone White,0,55.0,0,0,1,0,1
Tyrone de la Bastide,0,78.0,1,0,1,0,1
Témime Lahzami,0,153.0,0,0,3,0,3
Túlio Costa,1,76.0,0,0,1,0,1
Túlio Maravilha,1,111.0,0,0,1,1,2
Tümer Metin,1,354.0,0,0,2,4,6
Ubaldo Cruche,0,35.0,0,0,0,1,1
Uche Okechukwu,1,18.0,0,0,1,0,1
Ul Radike Mateiwai,1,5.0,0,0,0,1,1
Uladzimir Makowski,0,113.0,0,0,2,0,2
Ulaiasi Mateiwai,1,31.0,0,0,1,0,1
Ulaisi Seruvatu,1,43.0,0,0,0,1,1
Ulan Konysbayev,0,55.0,0,0,0,1,1
Ulf Eriksson,0,90.0,0,0,0,1,1
Ulf Kirsten,3,879.0,0,0,9,7,16
Uli Hoeneß,0,133.0,0,1,2,1,3
Uli Stielike,0,66.0,0,0,1,0,1
Ulises Ramos,1,72.0,0,0,1,0,1
Ulises de la Cruz,0,130.0,0,0,1,3,4
Ulrich Kapolongo,0,76.0,0,0,0,1,1
Ulrich Lepaye,0,81.0,0,0,1,0,1
Ulrik Laursen,0,27.0,0,0,1,0,1
Ulrik le Fevre,0,35.0,0,0,1,0,1
Ulugbek Bakayev,3,494.0,0,1,5,3,8
Umar Sadiq,1,56.0,0,0,0,1,1
Umberto Barberis,0,172.0,0,0,2,2,4
Umut Bulut,0,231.0,0,0,5,1,6
Unaloto Feao,1,88.0,0,0,0,1,1
Uni Arge,0,354.0,0,0,5,1,6
Upendran Choy,0,90.0,0,0,1,0,1
Uri Malmilian,0,219.0,0,0,2,1,3
Uriel Antuna,4,172.0,0,0,4,1,5
Urmas Kirs,0,134.0,1,0,2,0,2
Uston Nawawi,0,220.0,0,0,4,0,4
Uwa Elderson Echiéjilé,2,105.0,0,0,0,2,2
Uwe Bein,1,88.0,0,0,1,1,2
Uwe Rahn,0,102.0,0,0,3,0,3
Uwe Reinders,1,83.0,0,0,1,0,1
Uwe Seeler,8,850.0,0,0,8,6,14
Uwe Zötzsche,0,4.0,0,1,1,0,1
Uğur Boral,1,22.0,0,0,0,1,1
V. P. Sathyan,1,172.0,0,1,0,2,2
V. Sundramoorthy,3,274.0,0,0,1,3,4
Vaclavs Borduško,0,41.0,0,0,0,2,2
Vadim Boret,0,16.0,0,0,1,0,1
Vadim Evseev,0,21.0,0,0,0,1,1
Vadim Rață,0,9.0,0,0,0,1,1
Vadim Vasilyev,0,29.0,0,1,1,1,2
Vaggelis Panakis,0,29.0,0,0,1,0,1
Vagif Javadov,0,328.0,0,0,3,2,5
Vagiz Khidiyatullin,0,54.0,0,0,1,0,1
Vahagn Minasyan,0,85.0,0,0,0,1,1
Vahid Amiri,0,61.0,0,0,1,0,1
Vahid Halilhodžić,0,113.0,0,0,4,0,4
Vahid Hashemian,0,186.0,0,0,2,2,4
Vahidin Musemić,0,344.0,0,0,5,1,6
Vaidotas Šlekys,0,118.0,0,0,2,0,2
Valasine Dalaphone,0,55.0,0,0,1,0,1
Valdas Ivanauskas,0,293.0,0,0,5,1,6
Valdes Pasolini,0,30.0,0,1,1,0,1
Valdet Rama,0,49.0,0,0,1,1,2
Valdir Pereira,0,11.0,0,0,1,0,1
Valdomiro Vaz Franco,1,79.0,0,0,0,1,1
Valentin Belkevich,0,97.0,0,0,2,1,3
Valentin Bubukin,2,98.0,0,0,2,0,2
Valentin Ivanov,3,177.0,0,0,0,3,3
Valentin Kozmich Ivanov,8,588.0,0,0,6,5,11
Valentin Mihăilă,0,50.0,0,0,1,0,1
Valentin Stocker,0,270.0,0,0,3,1,4
Valentino Lazaro,0,80.0,0,0,1,1,2
Valentinos Sielis,0,87.0,0,0,1,0,1
Valentín Mendoza,0,70.0,1,0,0,1,1
Valeri Aleksanyan,0,43.0,1,0,1,0,1
Valeri Berezovsky,0,12.0,0,0,1,0,1
Valeri Bojinov,0,58.0,0,0,1,0,1
Valeri Broshin,0,20.0,0,0,0,1,1
Valeri Domovchiyski,0,90.0,0,0,1,0,1
Valeri Gulyan,0,53.0,0,0,1,0,1
Valeri Qazaishvili,0,245.0,0,0,4,1,5
Valeri Yablochkin,0,49.0,0,0,1,0,1
Valerian Gvilia,0,38.0,0,0,1,1,2
Valeriano López,2,137.0,0,0,0,2,2
Valerică Găman,0,90.0,0,0,1,0,1
Valerio Nasema,2,118.0,0,0,1,1,2
Valerio Nawatu,0,2.0,0,0,1,0,1
Valeriu Andronic,0,90.0,0,0,1,0,1
Valeriu Călinoiu,0,52.0,0,0,0,1,1
Valeriu Pogorelov,0,76.0,0,0,1,0,1
Valeriy Porkujan,4,247.0,0,0,0,4,4
Valery Karpin,1,571.0,0,2,5,5,10
Valery Kechinov,0,73.0,0,0,2,0,2
Valery Kichin,0,77.0,1,0,2,0,2
Valery Maslov,0,14.0,0,0,0,1,1
Valery Ondo,0,82.0,0,0,1,0,1
Valery Voronin,3,186.0,0,0,3,1,4
Valon Behrami,0,86.0,0,0,1,0,1
Valon Berisha,0,110.0,0,1,0,3,3
Valter Birsa,1,297.0,0,2,4,2,6
Valyantsin Byalkevich,0,147.0,0,0,0,3,3
Valērijs Šabala,0,385.0,0,1,4,3,7
Vampeta,0,95.0,0,0,2,0,2
Van-Dave Harmon,1,45.0,0,0,1,0,1
Vangelis Pavlidis,0,108.0,0,0,2,0,2
Vaniel Sirin,0,46.0,0,0,0,1,1
Vanče Šikov,0,146.0,0,0,0,2,2
Vančo Micevski,0,90.0,0,0,0,1,1
Vančo Trajanov,0,36.0,0,0,0,2,2
Varazdat Haroyan,0,161.0,0,0,2,0,2
Vasil Bozhikov,0,95.0,0,0,1,1,2
Vasil Mitkov,0,44.0,0,0,1,0,1
Vasili Baranov,0,30.0,0,0,1,0,1
Vasili Berezutski,1,164.0,0,0,3,1,4
Vasili Kulkov,0,265.0,0,0,1,4,5
Vasilis Botinos,0,162.0,0,0,2,1,3
Vasilis Dimitriadis,0,30.0,0,1,1,0,1
Vasilis Torosidis,2,419.0,1,0,5,4,9
Vassilios Tsiartas,0,272.0,0,1,3,2,5
Vassilis Karapialis,0,40.0,0,0,1,0,1
Vassos Melanarkitis,0,18.0,0,0,1,0,1
Vasyl Rats,2,178.0,0,0,0,3,3
Vato Arveladze,0,76.0,0,1,1,0,1
Vaughan Coveny,10,877.0,0,1,21,2,23
Vavá,5,379.0,0,0,5,4,9
Veaceslav Sofroni,0,90.0,0,0,0,1,1
Vedad Ibišević,1,927.0,0,0,9,9,18
Vedat Muriqi,0,327.0,0,2,4,3,7
Vedran Ćorluka,0,153.0,1,0,1,2,3
Vegard Forren,0,57.0,0,0,0,1,1
Veigar Páll Gunnarsson,0,100.0,0,0,2,0,2
Veli Lampi,0,65.0,1,0,1,0,1
Velibor Vasović,0,112.0,0,0,2,0,2
Velizar Dimitrov,0,6.0,0,0,1,0,1
Veliče Šumulikoski,0,90.0,0,0,1,0,1
Venancio García,0,13.0,0,0,1,0,1
Venancio Ramos,0,150.0,0,0,2,0,2
Ventsislav Hristov,0,87.0,0,0,0,1,1
Veresa Toma,7,213.0,0,0,7,1,8
Verner Lička,0,67.0,0,0,1,0,1
Vernon De Marco,0,72.0,0,0,0,1,1
Vernon Sargeant,0,66.0,0,0,2,0,2
Viacheslav Knizaev,0,90.0,0,0,0,2,2
Viačeslavas Sukristovas,0,25.0,0,0,1,0,1
Vic Bozanic,2,180.0,0,0,2,0,2
Vicente Aguirre,3,221.0,0,0,3,0,3
Vicente Flores,0,88.0,0,0,1,0,1
Vicente Guillot,0,104.0,0,0,3,0,3
Vicente Matías Vuoso,0,149.0,0,0,0,3,3
Vicente Rodríguez,0,138.0,0,0,1,2,3
Vicente Sánchez,4,302.0,0,0,1,4,5
Vicente de la Mata,2,345.0,0,0,5,0,5
Vicente del Bosque,0,10.0,0,0,1,0,1
Victor Agali,0,184.0,0,0,4,0,4
Victor Covilhã,0,85.0,0,0,1,0,1
Victor Diagne,0,89.0,0,0,1,0,1
Victor Ikpeba,1,176.0,0,0,3,0,3
Victor Karpenko,0,112.0,0,0,1,2,3
Victor Lemberechts,0,40.0,0,0,0,1,1
Victor Lindelöf,0,81.0,0,0,1,1,2
Victor Manuel Azucar,0,144.0,0,0,2,0,2
Victor Mees,0,97.0,0,0,3,0,3
Victor Moreland,0,50.0,0,1,1,0,1
Victor Moses,3,461.0,0,5,6,2,8
Victor Núñez,0,165.0,0,0,1,1,2
Victor Obinna,2,417.0,0,1,7,0,7
Victor Osimhen,2,91.0,0,1,1,3,4
Victor Pițurcă,0,40.0,0,0,2,0,2
Victor Pálsson,0,77.0,0,0,0,1,1
Victor Wanyama,0,74.0,0,0,1,0,1
Victorien Adebayor,2,230.0,0,0,3,2,5
Vidadi Rzayev,0,28.0,0,0,1,0,1
Vidal Sanabria,1,81.0,0,0,1,0,1
Vidar Davidsen,0,88.0,0,0,1,0,1
Vidar Riseth,0,39.0,0,0,1,0,1
Viera Ellong,0,24.0,0,0,0,1,1
Vikash Dhorasoo,0,44.0,0,0,1,0,1
Viktor Claesson,1,342.0,0,0,5,1,6
Viktor Fayzulin,0,147.0,0,0,1,2,3
Viktor Kolotov,0,376.0,0,2,6,2,8
Viktor Onopko,0,332.0,0,0,3,3,6
Viktor Pasulko,1,73.0,0,0,0,1,1
Viktor Pečovský,0,77.0,0,0,0,1,1
Viktor Ponedelnik,6,542.0,0,0,6,4,10
Viktor Skrypnyk,0,24.0,0,0,0,1,1
Viktor Tsyhankov,0,93.0,0,0,2,1,3
Viktor Zubarev,0,294.0,0,0,1,3,4
Viliami Vaitaki,1,61.0,0,0,1,0,1
Viljormur Davidsen,0,40.0,0,1,0,1,1
Vilmos Kohut,1,13.0,0,0,1,0,1
Vilmos Sebők,0,304.0,0,3,6,0,6
Vilmos Vanczák,0,45.0,1,0,1,2,3
Vincent Aboubakar,5,982.0,0,5,13,4,17
Vincent Candela,0,54.0,0,0,1,0,1
Vincent Casimir,0,213.0,0,0,0,3,3
Vincent Guérin,0,95.0,0,0,2,0,2
Vincent Janssen,0,148.0,0,1,2,0,2
Vincent John,0,11.0,0,0,1,0,1
Vincent Kompany,0,162.0,0,0,2,1,3
Vincent Kwarula,0,58.0,0,0,1,0,1
Vincent Laban,0,148.0,0,0,1,2,3
Vincent Magro,0,79.0,0,0,1,0,1
Vincent Mutale,1,100.0,0,0,2,0,2
Vincent Simon,0,74.0,1,0,1,1,2
Vincenzo Iaquinta,2,162.0,0,1,4,0,4
Vinceroy Nelson,1,42.0,0,0,1,0,1
Vinícius Júnior,1,52.0,0,0,2,0,2
Viorel Frunză,0,272.0,0,0,3,3,6
Viorel Mateianu,0,106.0,0,1,2,0,2
Viorel Moldovan,3,674.0,0,0,7,9,16
Virgil van Dijk,0,95.0,0,0,2,0,2
Virgilio Ferreira,2,87.0,0,0,0,2,2
Virgilio Sille,1,77.0,0,0,0,2,2
Virginijus Baltušnikas,0,110.0,0,0,2,0,2
Virginio De Paoli,0,43.0,0,0,1,0,1
Visar Musliu,0,36.0,0,0,1,0,1
Visay Phaphouvanin,0,185.0,0,0,3,1,4
Vita Lutonadio,0,88.0,0,0,0,1,1
Vital Bulyga,0,214.0,0,0,3,1,4
Vitali Culibaba,0,77.0,1,0,0,1,1
Vitali Kutuzov,0,348.0,0,0,3,5,8
Vitali Rodionov,0,177.0,0,0,1,2,3
Vitali Sparyshev,0,55.0,0,0,1,0,1
Vitali Yevstigneyev,0,77.0,0,0,0,1,1
Vitalij Lux,3,197.0,0,0,4,1,5
Vitalis Takawira,0,293.0,0,2,3,2,5
Vitaliy Denisov,0,42.0,0,0,0,1,1
Vitaliy Khmelnytskyi,1,110.0,0,0,0,2,2
Vitaliy Kosovskyi,0,35.0,0,0,1,1,2
Vitaliy Mandzyuk,0,80.0,0,0,0,1,1
Vitaliy Shevchenko,0,133.0,0,0,1,1,2
Vitaly Daraselia,1,13.0,0,0,1,0,1
Vitaly Lisakovich,1,157.0,0,2,3,0,3
Vitolo,0,223.0,0,0,3,1,4
Vitoon Kijmongkolsak,0,90.0,0,0,1,0,1
Vitālijs Astafjevs,0,400.0,0,0,4,4,8
Viv Anderson,0,143.0,0,0,1,1,2
Vivian Wickham,2,64.0,0,0,0,2,2
Viðar Örn Kjartansson,0,80.0,0,0,0,1,1
Vladan Lukić,0,18.0,0,0,0,1,1
Vladas Douksas,3,137.0,0,0,0,3,3
Vladica Kovačević,0,15.0,0,0,1,0,1
Vladimir Ambros,0,89.0,0,0,1,0,1
Vladimir Barkaya,2,146.0,0,0,2,0,2
Vladimir Bayramov,1,67.0,0,0,2,0,2
Vladimir Beschastnykh,3,865.0,0,2,9,9,18
Vladimir Burduli,0,85.0,0,0,0,1,1
Vladimir Bystrov,0,84.0,0,0,0,2,2
Vladimir Chertkov,1,50.0,0,0,1,1,2
Vladimir Dvalishvili,0,79.0,0,0,0,2,2
Vladimir Edouard,0,137.0,0,0,1,2,3
Vladimir Farrell,1,48.0,0,0,1,0,1
Vladimir Fedotov,0,145.0,0,0,2,1,3
Vladimir Gaidamașciuc,0,22.0,0,0,0,1,1
Vladimir Gregorio,1,66.0,0,0,0,1,1
Vladimir Jugović,1,146.0,0,0,0,3,3
Vladimir Kokol,0,90.0,0,0,1,0,1
Vladimir Koman,0,322.0,0,0,3,2,5
Vladimir Korytko,0,150.0,0,0,2,0,2
Vladimir Kragić,0,121.0,0,0,1,1,2
Vladimir Loginov,0,120.0,0,0,1,2,3
Vladimir Maminov,0,165.0,0,2,2,1,3
Vladimir Muntyan,2,199.0,0,0,2,1,3
Vladimir Onishchenko,0,82.0,0,0,2,0,2
Vladimir Petrović,1,318.0,0,2,1,4,5
Vladimir Shishelov,1,128.0,0,0,2,0,2
Vladimir Soria,0,28.0,0,0,1,0,1
Vladimir Todorov,0,61.0,0,0,0,1,1
Vladimir Veremeyev,0,81.0,0,0,1,0,1
Vladimir Voskoboinikov,0,7.0,0,0,0,1,1
Vladimiro Schettina,0,22.0,0,0,0,1,1
Vladimirs Babičevs,0,67.0,0,0,0,2,2
Vladimirs Kamešs,0,69.0,0,0,1,1,2
Vladimirs Koļesņičenko,0,89.0,0,0,1,0,1
Vladimír Darida,0,289.0,0,2,1,4,5
Vladimír Hagara,0,166.0,0,0,2,1,3
Vladimír Hruška,0,21.0,0,0,1,0,1
Vladimír Janočko,0,120.0,0,0,1,1,2
Vladimír Labant,0,92.0,0,1,1,1,2
Vladimír Táborský,0,81.0,0,0,0,1,1
Vladimír Weiss,1,124.0,0,0,1,4,5
Vladimír Šmicer,9,1089.0,0,0,4,16,20
Vladis-Emmerson Illoy-Ayyet,0,43.0,0,0,1,0,1
Vladislao Cap,0,69.0,0,0,1,0,1
Vladislav Bogićević,1,48.0,0,0,1,1,2
Vladislav Lauda,0,62.0,0,0,0,1,1
Vladislav Radimov,0,8.0,0,0,1,0,1
Vladislavs Gutkovskis,0,160.0,0,1,2,1,3
Vladyslav Vashchuk,0,59.0,0,0,1,0,1
Vlastimil Bubník,0,202.0,0,0,2,2,4
Vlastimil Kopecký,1,25.0,0,0,0,1,1
Vlatko Grozdanoski,0,25.0,0,0,1,1,2
Vlatko Stojanovski,0,90.0,0,0,0,1,1
Vojin Lazarević,0,56.0,0,0,1,0,1
Vojislav Melić,1,82.0,0,0,0,1,1
Vojtech Masný,0,47.0,0,0,0,1,1
Vokhid Shodiev,1,71.0,0,0,1,0,1
Volkan Yayim,0,81.0,0,0,1,0,1
Volkan Şen,1,62.0,0,0,1,1,2
Volodymyr Bezsonov,1,137.0,0,0,2,0,2
Volodymyr Muntyan,0,43.0,0,0,1,0,1
Volodymyr Onyshchenko,2,142.0,0,0,2,0,2
Volodymyr Yezerskiy,0,20.0,0,0,0,1,1
Voulani Ely,0,44.0,0,0,0,1,1
Vratislav Greško,0,48.0,0,0,1,0,1
Vratislav Lokvenc,0,611.0,0,0,7,2,9
Vujadin Stanojković,1,5.0,0,0,0,1,1
Vurlon Mills,0,110.0,0,0,2,0,2
Vyacheslav Amin,0,47.0,0,0,0,1,1
Vyacheslav Hleb,0,90.0,0,0,0,1,1
Vyacheslav Lychkin,0,113.0,0,0,1,1,2
Vyacheslav Sukristov,0,64.0,0,0,0,1,1
Vykintas Slivka,0,87.0,0,0,1,1,2
Vytautas Andriuškevičius,0,28.0,0,0,1,0,1
Václav Daněk,0,200.0,0,0,5,0,5
Václav Hovorka,2,171.0,0,0,0,2,2
Václav Kadlec,0,163.0,0,0,1,2,3
Václav Mašek,1,67.0,0,0,2,0,2
Václav Němeček,0,241.0,0,1,3,2,5
Václav Pilař,2,301.0,0,0,3,2,5
Václav Svěrkoš,0,208.0,0,0,2,1,3
Vágner Love,1,104.0,0,0,1,1,2
Víctor Aguayo,4,138.0,0,0,1,3,4
Víctor Aristizábal,2,625.0,0,3,8,4,12
Víctor Artega,1,35.0,0,0,1,0,1
Víctor Ayala,1,71.0,0,0,0,1,1
Víctor Benítez,0,78.0,1,0,1,0,1
Víctor Bernárdez,0,62.0,0,0,0,1,1
Víctor Bielich,0,35.0,0,0,1,0,1
Víctor Bonilla,3,196.0,0,0,1,3,4
Víctor Celestino Algañaraz,1,57.0,0,0,1,0,1
Víctor Cuesta,1,32.0,0,0,1,0,1
Víctor Cáceres,0,55.0,0,0,0,1,1
Víctor Diogo,0,80.0,0,0,1,0,1
Víctor Espárrago,1,117.0,0,0,0,1,1
Víctor Guaglianone,1,17.0,0,0,0,1,1
Víctor Muñoz,0,60.0,0,0,0,1,1
Víctor Pacheco,0,48.0,0,0,2,0,2
Víctor Pedraza,3,197.0,0,0,0,3,3
Víctor Rangel,1,52.0,0,0,1,0,1
Víctor René Mendieta Ocampo,1,271.0,0,3,3,2,5
Víctor Rogelio Ramos,0,50.0,0,0,1,0,1
Víctor Ruiz,0,250.0,0,2,2,2,4
Víctor Turcios,0,6.0,0,0,1,0,1
Víctor Ugarte,5,475.0,0,3,7,2,9
Víctor Velásquez,0,61.0,0,0,2,0,2
Víctor Zegarra,0,37.0,0,0,1,0,1
Víctor Ábrego,0,84.0,0,0,1,0,1
Vítor Baptista,0,96.0,0,0,2,0,2
Vítor Baía,0,44.0,1,0,1,0,1
Vítor Paneira,0,163.0,0,1,3,0,3
Vítor Silva,0,10.0,0,0,1,0,1
Vüqar Nadirov,0,167.0,0,0,1,2,3
Vīts Rimkus,0,384.0,0,0,3,4,7
Vũ Văn Thanh,1,74.0,0,0,1,0,1
Wael Gomaa,0,23.0,1,0,1,0,1
Wael Nazha,1,125.0,0,0,1,1,2
Wagdan Mahmoud Shadli,1,170.0,0,0,1,2,3
Wagner Lopes,2,211.0,0,1,1,4,5
Wahbi Khazri,8,718.0,0,4,7,6,13
Wahyt Orazsähedow,0,96.0,0,0,1,1,2
Wail Al Habashi,1,81.0,0,0,1,0,1
Waisake Sabutu,2,178.0,0,0,2,1,3
Waldemar Sobota,0,34.0,0,0,0,1,1
Waldemar Victorino,0,246.0,0,2,2,2,4
Waldir Guerra,0,87.0,0,0,1,0,1
Waldir Sáenz,1,87.0,0,0,0,1,1
Waldo Ponce,0,36.0,0,0,1,1,2
Waleed Ali,0,132.0,0,0,1,1,2
Waleed Bakhit Maayof,0,47.0,0,0,1,0,1
Waleed Hamzah,0,213.0,0,0,1,3,4
Waleed Jassem,0,155.0,0,0,2,0,2
Waleed Salim Al-Lami,1,28.0,0,0,1,0,1
Walford Vaughns,0,88.0,0,0,1,0,1
Walid Abbas,2,248.0,3,0,1,2,3
Walid Abu Al-Sel,4,242.0,0,1,1,4,5
Walid Al-Nasser,1,124.0,0,0,1,1,2
Walid Badir,1,277.0,0,0,3,1,4
Walid Salah Abdel Latif,0,90.0,0,0,1,0,1
Walieldin Khedr,1,70.0,0,1,0,1,1
Walker Zimmerman,0,37.0,0,0,1,0,1
Walmer Martinez,1,175.0,0,0,1,1,2
Walt Schmotolocha,0,49.0,0,0,1,0,1
Walter Ayoví,0,130.0,0,0,3,0,3
Walter Bahr,1,16.0,0,0,1,0,1
Walter Bakouma,0,131.0,0,0,2,0,2
Walter Baseggio,0,64.0,0,0,1,0,1
Walter Boyd,1,377.0,0,0,3,3,6
Walter Casagrande,0,82.0,0,0,0,2,2
Walter Centeno,9,722.0,0,2,10,5,15
Walter Haummer,0,79.0,0,0,1,0,1
Walter Horak,0,40.0,0,0,0,1,1
Walter Julián Martínez,3,135.0,0,1,2,2,4
Walter Kelsch,0,70.0,0,0,1,0,1
Walter Koleznik,0,38.0,0,0,0,1,1
Walter Morel,3,202.0,0,0,0,3,3
Walter Pearson,0,85.0,0,0,1,0,1
Walter Samuel,0,199.0,1,0,3,0,3
Walter Schachner,3,669.0,0,0,11,7,18
Wamidh Munir,0,90.0,0,0,0,1,1
Wan Chi Keung,0,205.0,0,0,2,2,4
Wandel Gross,0,89.0,0,0,1,0,1
Wang Baoshan,0,74.0,0,0,1,1,2
Wang Dong,0,141.0,0,0,0,2,2
Wang Huiliang,0,60.0,0,0,1,0,1
Wang Jilian,1,58.0,0,0,1,0,1
Wang Lu,0,75.0,0,0,1,0,1
Wang Rui,0,37.0,0,0,0,1,1
Wang Yongpo,0,147.0,0,0,2,0,2
Ward Al Salama,1,23.0,0,0,1,0,1
Waren Waiwai,1,82.0,0,0,0,1,1
Warren Archibald,0,360.0,0,0,0,4,4
Warren Feeney,0,229.0,0,0,4,0,4
Warren Granados,1,64.0,0,0,1,0,1
Warren Spink,0,25.0,0,0,1,0,1
Warsama Hassan,1,90.0,0,0,1,0,1
Wartan Ghazarian,3,130.0,0,0,0,4,4
Waseem Al-Bzour,0,33.0,0,0,0,1,1
Washington,1,53.0,0,0,1,0,1
Washington Muñoz,0,258.0,0,0,2,3,5
Washington Oliveira,0,5.0,0,0,0,1,1
Washington Puente,2,174.0,0,0,0,4,4
Washington Villacreses,0,64.0,0,0,0,1,1
Wasieu Sounmonu,0,123.0,0,0,2,0,2
Waskito Kaihun,1,12.0,0,0,0,1,1
Wason Rentería,0,88.0,0,0,1,0,1
Wataru Endo,0,57.0,0,0,1,0,1
Wayne Dyer,1,83.0,0,0,1,0,1
Wayne Rooney,6,1770.0,0,6,18,19,37
Webster Chikabala,2,131.0,0,0,0,2,2
Weerarathne Kassun,1,83.0,0,0,0,1,1
Wellington Sánchez,1,94.0,0,0,0,2,2
Wen Chih-hao,1,167.0,0,0,1,1,2
Wensley Christoph,2,209.0,0,0,1,4,5
Werner Heine,0,12.0,0,0,0,1,1
Werner Krämer,0,77.0,0,0,0,2,2
Werner Otto,0,30.0,0,0,0,1,1
Werner Peter,0,6.0,0,0,1,0,1
Wes Hoolahan,1,104.0,0,0,2,0,2
Wes Morgan,0,52.0,1,0,0,1,1
Wesam Rizik,1,95.0,0,1,0,2,2
Wesley Charles,0,114.0,0,0,2,0,2
Wesley Marquette,0,52.0,0,0,1,1,2
Wesley Sneijder,9,1112.0,0,0,16,5,21
Wesley Sonck,1,721.0,0,1,11,4,15
Wesley Waiwai,0,68.0,0,0,0,1,1
Weston McKennie,0,127.0,0,0,4,0,4
Whayne Wilson,0,40.0,0,1,1,0,1
Widlin Calixte,0,19.0,0,2,2,0,2
Widodo Cahyono Putro,2,225.0,0,0,2,3,5
Wietse Veenstra,0,35.0,0,0,1,0,1
Wilberforce Mfum,5,450.0,0,0,4,2,6
Wilbur Cush,1,49.0,0,0,1,1,2
Wilde-Donald Guerrier,1,163.0,0,0,2,1,3
Wilf Mannion,1,51.0,0,0,0,1,1
Wilfred Bouma,1,46.0,0,0,1,1,2
Wilfred Moke,0,77.0,1,0,0,1,1
Wilfred de Lanoy,0,54.0,0,0,0,2,2
Wilfredo Alvarado,0,131.0,0,0,2,0,2
Wilfredo Camacho,0,272.0,0,0,4,1,5
Wilfredo Iraheta Sanabria,0,68.0,0,0,1,0,1
Wilfried Bony,7,604.0,0,1,6,4,10
Wilfried Kanon,1,68.0,0,0,0,1,1
Wilfried Puis,0,253.0,0,1,3,2,5
Wilfried Urbain Elvis Endzanga,0,147.0,0,0,2,0,2
Wilfried Van Moer,2,173.0,0,0,4,1,5
Wilfried Zaha,2,160.0,0,0,0,2,2
Wilhelm Hahnemann,1,8.0,0,0,1,0,1
Wilhelm Kreuz,0,237.0,0,0,4,1,5
Wilkins Lauru,2,128.0,0,0,0,2,2
Wilko Risser,0,83.0,0,0,3,0,3
Will Johnson,0,208.0,0,0,2,1,3
Willi Lippens,0,26.0,0,0,1,0,1
Willi Orbán,0,166.0,0,0,1,3,4
Willi Wigold,0,12.0,0,0,0,1,1
William Antonio Torres,1,36.0,0,0,0,1,1
William Campbell,0,76.0,0,0,1,0,1
William Carvalho,0,260.0,0,0,2,2,4
William Chiroque,1,41.0,0,0,1,0,1
William Gallas,0,155.0,0,0,2,0,2
William Jebor,0,146.0,0,1,1,3,4
William Kvist,0,45.0,0,0,0,1,1
William Martínez,0,88.0,0,0,1,0,1
William N'Gounou,1,9.0,0,0,1,0,1
William Ouma,0,377.0,0,0,4,2,6
William Quirós,0,228.0,0,0,3,0,3
William Ramallo,0,53.0,0,0,1,0,1
William Renderos Iraheta,0,132.0,0,0,3,0,3
William Sango,0,37.0,0,0,0,1,1
William Scheppel,0,16.0,1,0,1,0,1
William Sunsing,0,86.0,0,0,0,2,2
William Torres,0,160.0,0,0,2,0,2
William Troost-Ekong,3,226.0,1,1,3,1,4
William Waddell,0,36.0,0,1,0,2,2
Willian,0,231.0,0,0,3,2,5
Willie August Marango,1,6.0,0,0,0,1,1
Willie Henderson,0,70.0,0,0,1,0,1
Willie Irvine,0,134.0,0,0,0,2,2
Willie Klutse,1,145.0,0,0,2,0,2
Willie Morgan,0,83.0,0,0,0,1,1
Willie Ormond,0,89.0,0,0,1,0,1
Willie Phiri,0,87.0,0,0,2,0,2
Willie Rutherford,1,57.0,0,0,0,1,1
Willie Vassallo,0,66.0,0,0,1,0,1
Willington Ortiz,0,354.0,0,0,3,4,7
Willy Brokamp,0,282.0,0,0,5,0,5
Willy Jäggi,1,158.0,0,0,0,2,2
Willy Roy,0,139.0,0,0,1,2,3
Willy Stephanus,0,103.0,0,0,1,1,2
Willy Tröger,0,61.0,0,0,1,0,1
Willy van de Kerkhof,2,420.0,0,0,0,6,6
Willy van der Kuijlen,0,192.0,0,0,4,0,4
Wilmar Cabrera,0,78.0,0,0,2,0,2
Wilmer Cabrera,1,130.0,0,1,2,0,2
Wilmer López,1,113.0,0,1,1,1,2
Wilmer Velásquez,3,213.0,0,0,3,1,4
Wilson Chevalier,0,11.0,0,0,1,0,1
Wilson Gaspar,0,31.0,0,0,0,1,1
Wilson Nieves,0,88.0,0,0,0,1,1
Wilson Oruma,1,94.0,0,0,2,0,2
Wilson Palacios,0,165.0,0,0,2,1,3
Wilson Pérez,0,76.0,0,0,1,0,1
Wim Jansen,0,22.0,0,0,1,0,1
Wim Jonk,4,414.0,0,1,4,5,9
Wim Kieft,2,387.0,0,0,5,2,7
Wim Rijsbergen,0,17.0,0,0,1,0,1
Wim Suurbier,0,220.0,0,0,1,2,3
Wim van Hanegem,0,161.0,0,0,4,0,4
Windsor del Llano,0,84.0,1,0,0,1,1
Winston Anglin,0,65.0,0,0,0,1,1
Winston Kalengo,0,109.0,0,0,1,1,2
Winston Parks,1,86.0,0,0,1,0,1
Winston Reid,1,90.0,0,0,1,0,1
Winston Roberts,0,39.0,0,0,1,0,1
Winston Trott,0,34.0,0,0,0,1,1
Wisam El Abdy,0,78.0,0,0,0,1,1
Wisdom Mumba Chansa,0,4.0,0,0,1,0,1
Wissam Ben Yedder,0,120.0,0,0,1,1,2
Wissem Ben Yahia,0,21.0,0,1,1,0,1
Witson Nyirenda,0,10.0,0,0,1,0,1
Witthaya Laohakul,2,141.0,0,0,1,1,2
Wladimir Baýramow,2,170.0,0,0,4,0,4
Wojciech Kowalczyk,0,94.0,0,0,1,2,3
Wojciech Rudy,0,4.0,0,0,0,1,1
Wojciech Szczęsny,1,18.0,1,0,0,1,1
Wojciech Łobodziński,0,34.0,0,0,1,0,1
Wole Odegbami,0,5.0,0,0,1,0,1
Wolfgang Dremmler,0,119.0,0,0,1,1,2
Wolfgang Overath,1,276.0,0,0,8,0,8
Wolfgang Weber,0,89.0,0,0,0,1,1
Wolfram Löwe,0,322.0,0,0,3,4,7
Wong Chi Keung,1,66.0,0,0,1,0,1
Wong Chi-keung,1,64.0,0,0,0,1,1
Wong Chun Yue,0,51.0,0,0,1,0,1
Woo Sang-kwon,3,208.0,0,1,4,1,5
Worrawoot Srimaka,0,21.0,0,0,1,0,1
Wout Weghorst,2,231.0,0,0,3,0,3
Wouter Brokke,1,90.0,0,0,1,0,1
Wu Chengying,0,87.0,0,0,1,1,2
Wu Chun-ching,0,140.0,0,0,1,2,3
Wu Kwok Hung,0,62.0,0,0,1,0,1
Wu Lei,9,912.0,0,4,11,6,17
Wu Qunli,0,66.0,0,0,0,1,1
Wu Wei'an,1,13.0,0,0,0,1,1
Wu Xi,2,356.0,0,0,3,3,6
Wu Xinghan,1,65.0,0,0,1,0,1
Wun Chee Keung,1,137.0,0,0,1,2,3
Wyn Davies,0,122.0,0,0,2,1,3
Wynton Rufer,1,318.0,0,0,5,4,9
Wálter Flores,0,85.0,0,0,1,0,1
Wýaçeslaw Krendelew,0,12.0,0,0,1,0,1
Włodzimierz Ciołek,1,76.0,0,0,1,0,1
Włodzimierz Lubański,0,1043.0,0,0,17,4,21
Włodzimierz Mazur,0,146.0,0,1,1,1,2
Włodzimierz Smolarek,2,540.0,0,2,7,6,13
Xabi Alonso,4,342.0,0,3,4,3,7
Xavi,1,313.0,0,0,4,4,8
Xavier Arreaga,0,39.0,0,0,1,0,1
Xavier Camargo,0,137.0,0,0,2,0,2
Xavier Chen,0,75.0,0,1,1,0,1
Xavier García,0,90.0,0,0,0,1,1
Xavier Samin,1,59.0,1,0,0,1,1
Xherdan Shaqiri,9,1194.0,0,0,12,9,21
Xiao Zhi,1,141.0,0,0,0,2,2
Xie Hui,0,405.0,0,0,5,2,7
Xie Yuxin,3,101.0,0,0,2,2,4
Xu Deshuai,0,63.0,0,0,1,0,1
Xu Hong,0,136.0,0,0,2,0,2
Xu Xin,0,90.0,0,0,0,1,1
Xu Yonglai,4,359.0,0,0,4,0,4
Xu Yunlong,0,205.0,0,0,5,0,5
Yabe Siad Isman,0,84.0,0,0,0,1,1
Yacine Bammou,0,66.0,0,0,1,0,1
Yacine Bezzaz,0,68.0,0,0,1,0,1
Yacine Brahimi,1,117.0,0,0,1,2,3
Yacouba Ali,0,14.0,0,0,0,1,1
Yahia Kébé,0,54.0,0,0,1,1,2
Yahya Al Ghassani,0,70.0,0,0,1,0,1
Yahya Al-Shehri,0,186.0,0,0,4,1,5
Yahya Golmohammadi,1,201.0,1,0,2,1,3
Yahya Madon,0,39.0,0,0,1,0,1
Yaki Yen,0,3.0,0,0,0,1,1
Yakubu,3,602.0,0,4,4,7,11
Yakubu Mambo,0,100.0,0,0,2,0,2
Yamba Asha,0,72.0,0,0,0,1,1
Yan Vorogovskiy,0,10.0,0,0,1,0,1
Yang Chen,3,235.0,0,0,5,0,5
Yang Lin,0,58.0,0,0,1,0,1
Yang Seung-kook,1,25.0,0,0,1,0,1
Yang Xu,0,722.0,0,2,12,5,17
Yang Zhaohui,1,89.0,0,0,3,0,3
Yangel Herrera,0,84.0,0,0,0,1,1
Yanik Frick,0,151.0,0,0,2,0,2
Yaniv Katan,0,155.0,0,0,1,1,2
Yann M'Vila,0,18.0,0,0,0,1,1
Yann Sommer,1,90.0,1,0,0,1,1
Yannick Bolasie,1,128.0,0,0,0,3,3
Yannick Carrasco,1,414.0,0,0,3,3,6
Yannick Mukunzi,0,93.0,0,0,1,1,2
Yannick Stopyra,2,240.0,0,0,2,4,6
Yanti Barsales,0,59.0,0,0,0,1,1
Yao Junior Sènaya,0,161.0,0,0,2,0,2
Yao Lambert Amani,0,81.0,0,0,1,0,1
Yaqoob Juma Al-Mukhaini,0,579.0,0,0,11,0,11
Yari Verschaeren,0,84.0,0,1,1,0,1
Yaroslav Rakytskiy,0,170.0,0,0,1,1,2
Yaseen Al-Bakhit,0,58.0,0,0,0,1,1
Yaser Hamed,2,143.0,0,0,2,1,3
Yaser Kasim,1,77.0,0,0,0,1,1
Yaser Salem Ali,0,502.0,0,0,4,6,10
Yashir Pinto,0,71.0,0,0,2,0,2
Yasmani Duk,0,59.0,0,0,0,1,1
Yasser Al-Qahtani,6,670.0,0,3,8,6,14
Yasser Al-Shahrani,0,104.0,0,0,2,0,2
Yasser Ezzat,0,83.0,0,0,1,0,1
Yasser Radwan,3,180.0,0,0,1,2,3
Yassin Mikari,0,18.0,0,0,1,0,1
Yassine Chikhaoui,2,238.0,0,0,1,2,3
Yassine Meriah,1,51.0,1,1,2,0,2
Yasuhito Endō,2,187.0,0,2,2,4,6
Yasuto Honda,1,90.0,0,0,0,1,1
Yasuyuki Konno,0,88.0,0,0,0,2,2
Yasuyuki Kuwahara,0,50.0,0,0,0,1,1
Yatma Diop,2,92.0,0,0,0,2,2
Yatma Diouck,2,176.0,0,0,0,2,2
Yaw Preko,0,75.0,0,0,1,0,1
Yaya Dissa,0,80.0,0,0,1,0,1
Yaya Touré,6,609.0,0,1,5,8,13
Yazan Al-Arab,1,67.0,0,0,0,1,1
Yaúca,0,291.0,0,0,3,1,4
Ye Nyunt,1,42.0,0,0,1,0,1
Yeferson Soteldo,0,90.0,0,1,1,0,1
Yegor Titov,1,357.0,0,0,5,1,6
Yeh Ching-Tueng,1,66.0,0,0,1,0,1
Yehoshua Feigenbaum,0,158.0,0,0,2,0,2
Yehoshua Glazer,0,427.0,0,0,5,2,7
Yeltsin Tejeda,1,58.0,0,0,1,0,1
Yerry Mina,4,393.0,1,0,2,4,6
Yervand Krbachyan,0,3.0,1,0,1,0,1
Yevgeni Varlamov,0,67.0,0,0,0,1,1
Yevgeniy Lunev,1,73.0,0,0,0,1,1
Yevhen Khacheridi,0,169.0,0,0,3,0,3
Yevhen Konoplyanka,0,464.0,0,1,5,3,8
Yevhen Seleznyov,0,341.0,0,3,3,4,7
Yiannos Ioannou,0,256.0,0,0,2,2,4
Yiasoumis Yiasoumi,0,171.0,0,0,1,1,2
Yisa Sofoluwe,0,89.0,0,0,1,0,1
Yiu Cheuk Yin,1,90.0,0,0,1,0,1
Ylber Ramadani,0,90.0,0,0,1,0,1
Ylli Shehu,0,33.0,0,0,1,0,1
Yngve Brodd,1,320.0,0,0,1,4,5
Yoane Wissa,0,12.0,0,0,1,0,1
Yoann Gourcuff,0,307.0,0,0,2,2,4
Yoann Langlet,0,3.0,0,0,1,0,1
Yoel Bárcenas,1,135.0,0,0,2,0,2
Yogan Santos,0,67.0,1,0,1,0,1
Yohai Aharoni,0,76.0,0,0,1,0,1
Yohan Cabaye,0,56.0,0,0,0,1,1
Yohanan Sukenik,1,54.0,0,0,1,0,1
Yohance Marshall,1,90.0,0,0,1,0,1
Yong Jin-Li,1,61.0,0,0,0,1,1
Yony Flores,0,31.0,0,0,1,0,1
Yoo Pan-soon,0,26.0,0,0,0,1,1
Yoo Pan-sun,0,61.0,0,0,1,0,1
Yoo Sang-chul,1,347.0,0,0,4,2,6
Yoon Bit-garam,1,105.0,0,0,0,1,1
Yordan Letchkov,2,325.0,0,0,5,0,5
Yordan Minev,0,4.0,1,0,0,1,1
Yordan Yordanov,0,83.0,0,0,0,1,1
Yoshimar Yotún,3,223.0,0,0,4,1,5
Yoshinori Muto,1,43.0,0,0,1,0,1
Yoshito Ōkubo,0,76.0,0,0,2,0,2
Yossi Abukasis,0,151.0,0,0,2,0,2
Yossi Benayoun,1,712.0,0,2,13,4,17
Yosuke Ideguchi,0,82.0,0,0,1,0,1
Youcef Belaïli,3,102.0,0,0,1,2,3
Younes Al Shibani,0,78.0,0,0,2,0,2
Younis Mahmoud,13,1229.0,0,2,11,9,20
Younès Belhanda,1,129.0,0,0,1,1,2
Youri Djorkaeff,3,678.0,0,2,8,5,13
Youri Mulder,0,178.0,0,0,3,0,3
Youri Tielemans,0,59.0,0,0,2,0,2
Yousef Aboloya,0,90.0,0,0,1,0,1
Yousef Al-Naber,0,82.0,0,0,1,0,1
Yousef Al-Rawashdeh,1,64.0,0,0,1,1,2
Yousef Khalaf,0,50.0,0,0,1,0,1
Yousef Nasser,2,520.0,0,0,9,5,14
Yousef Sheikh Al-Eshreh,0,92.0,0,0,1,1,2
Yousif Al-Sobaei,0,60.0,0,0,0,1,1
Youssef Chippo,1,45.0,1,0,0,1,1
Youssef El-Arabi,1,301.0,0,0,3,2,5
Youssef En-Nesyri,7,362.0,0,0,5,2,7
Youssef Farhat,1,38.0,0,0,0,1,1
Youssef Fertout,1,261.0,0,0,3,2,5
Youssef Mohamad,0,27.0,0,0,1,0,1
Youssef Mokhtari,2,140.0,0,0,2,2,4
Youssef Msakni,7,542.0,0,1,2,8,10
Youssef Safri,1,248.0,0,3,3,3,6
Youssouf Abdi Ahmed,0,33.0,0,0,0,1,1
Youssouf Arouna,0,62.0,0,0,1,0,1
Youssouf Falikou Fofana,1,87.0,0,0,1,1,2
Youssouf Hadji,3,625.0,0,0,8,1,9
Youssouf M'Changama,0,81.0,0,0,0,1,1
Youssouf Oumarou,1,81.0,1,1,1,1,2
Youssuf Camara,0,52.0,0,0,0,1,1
Yousuf Al-Thunayan,5,430.0,0,1,7,1,8
Yousuf Jazea'a,1,78.0,0,0,1,0,1
Yousuf Saleh Al-Alawi,2,35.0,0,0,1,1,2
Yousuf Shaaban,0,3.0,0,0,0,1,1
Yozhef Sabo,0,198.0,0,2,1,3,4
Ysrael Zúñiga,2,156.0,0,0,1,1,2
Yssouf Koné,0,261.0,0,0,1,2,3
Yu Dabao,2,551.0,0,0,7,3,10
Yu Genwei,0,124.0,0,0,2,0,2
Yu Hai,2,275.0,0,0,2,3,5
Yu Hanchao,0,229.0,0,0,2,2,4
Yu Song-chol,0,90.0,0,0,0,1,1
Yuan Kuan Yick,1,75.0,0,0,1,0,1
Yuen Kuen-Chu,1,73.0,0,0,1,1,2
Yuji Nakazawa,4,527.0,0,0,5,4,9
Yuki Abe,1,53.0,0,0,1,0,1
Yun Jong-su,1,125.0,0,0,2,1,3
Yunis Aman Al-Naseeb,1,35.0,0,0,1,0,1
Yunus Alif,0,40.0,0,0,1,0,1
Yura Movsisyan,0,305.0,0,0,3,5,8
Yuri Borodolimov,1,72.0,0,0,0,1,1
Yuri Chesnokov,0,43.0,0,0,2,0,2
Yuri Gavrilov,2,226.0,0,0,3,2,5
Yuri Kovtun,0,112.0,1,0,2,0,2
Yuriy Dmytrulin,0,56.0,0,0,1,0,1
Yuriy Kalitvintsev,0,13.0,0,0,1,0,1
Yuriy Logvinenko,0,195.0,0,0,2,1,3
Yuriy Maksymov,0,142.0,0,0,1,1,2
Yuriy Nikiforov,0,159.0,0,0,3,1,4
Yuriy Pertsukh,0,6.0,0,0,1,0,1
Yuriy Voynov,1,81.0,0,0,1,1,2
Yury Gazinsky,0,12.0,0,0,1,0,1
Yury Kendysh,0,64.0,0,0,1,0,1
Yusef Ahmed,0,178.0,0,0,4,1,5
Yussuf Poulsen,1,469.0,0,0,7,2,9
Yusuf A'Amer Al Sadi,3,259.0,0,0,3,2,5
Yusuf Abdurisag,0,28.0,0,0,0,1,1
Yusuf Altıntaş,0,68.0,0,0,1,0,1
Yusuf Rabiev,0,102.0,0,0,2,0,2
Yusuf Yazıcı,0,119.0,0,0,1,1,2
Yutaka Akita,1,35.0,0,0,1,2,3
Yuto Nagatomo,0,33.0,0,0,1,0,1
Yuya Kubo,0,71.0,0,0,1,1,2
Yuya Osako,7,766.0,0,3,11,5,16
Yuzo Kurihara,0,154.0,0,0,1,1,2
Yvan Rajoarimanana,0,54.0,0,0,1,0,1
Yves Bissouma,1,73.0,0,0,0,1,1
Yves Diba Ilunga,0,66.0,0,0,1,0,1
Yves Herbet,0,8.0,0,0,0,1,1
Yves Vanderhaeghe,0,60.0,0,0,2,0,2
Yves Yuvuladio,1,28.0,0,0,1,0,1
Yvon Douis,1,82.0,0,0,2,0,2
Yvon Goujon,0,133.0,0,0,2,1,3
Yénier Márquez,2,332.0,0,0,4,1,5
Yıldıray Baştürk,0,26.0,0,0,2,0,2
Yūichi Komano,0,35.0,0,0,1,0,1
Zach Muscat,0,53.0,0,0,0,1,1
Zachary Brault-Guillard,1,49.0,0,0,0,1,1
Zafar Babajanow,1,59.0,0,0,1,0,1
Zah Rahan Krangar,0,89.0,0,0,0,1,1
Zahi Armeli,0,230.0,0,0,4,1,5
Zahir Rafiq,0,53.0,0,0,1,0,1
Zainal Abidin Hassan,1,240.0,0,0,4,1,5
Zaine Pierre,0,65.0,0,0,1,0,1
Zainudin Kassim,0,49.0,0,0,1,0,1
Zakaria Aboukhlal,2,178.0,0,0,1,1,2
Zakaria Sanogo,0,37.0,0,0,0,1,1
Zakariya Souleymane,0,70.0,1,0,1,0,1
Zaker Berdykulov,2,129.0,0,0,2,0,2
Zamel Al Kuwari,2,138.0,0,0,1,2,3
Zamel Essa Al-Kuwari,0,60.0,0,0,0,1,1
Zamirbek Jumagulov,1,8.0,0,0,1,0,1
Zanzan Atte-Oudeyi,0,78.0,0,0,0,1,1
Zaur Tagizade,0,166.0,0,0,3,0,3
Zaw Min Tun,1,97.0,1,0,1,1,2
Zaza Janashia,0,99.0,0,0,2,0,2
Zbigniew Boniek,6,599.0,0,0,9,5,14
Zdenko Morovic,1,39.0,1,0,1,0,1
Zdeněk Grygera,0,13.0,0,0,1,0,1
Zdeněk Nehoda,3,628.0,0,1,11,5,16
Zdeněk Ondrášek,0,85.0,0,0,1,0,1
Zdeněk Pospěch,0,53.0,0,0,0,1,1
Zdeněk Prokeš,0,37.0,0,0,1,0,1
Zdeněk Zikán,4,117.0,0,0,2,2,4
Zdravko Kuzmanović,0,310.0,0,0,2,2,4
Zdravko Lazarov,0,55.0,0,0,1,0,1
Zdravko Rajkov,1,73.0,0,0,0,1,1
Zeca,0,127.0,0,0,2,0,2
Zeddy Saileti,1,30.0,0,0,1,0,1
Zeiko Lewis,0,29.0,0,0,0,1,1
Zelfy Nazary,1,45.0,0,0,1,0,1
Zelimkhan Bakayev,0,84.0,0,1,1,0,1
Zenón González,3,188.0,0,0,3,0,3
Zerga Geremew,0,180.0,0,0,2,0,2
Zhambyl Kukeyev,0,68.0,0,0,0,1,1
Zhang Enhua,2,164.0,0,0,1,2,3
Zhang Honggen,0,1.0,0,0,1,0,1
Zhang Linpeng,2,200.0,1,0,2,1,3
Zhang Xiaowen,1,165.0,0,0,1,1,2
Zhang Xizhe,0,131.0,0,0,2,0,2
Zhang Yaokun,1,39.0,0,1,0,1,1
Zhang Yuning,2,212.0,0,0,3,0,3
Zhao Dayu,6,441.0,0,0,5,3,8
Zhao Faqing,0,89.0,0,0,1,0,1
Zheng Bin,1,35.0,0,0,0,1,1
Zheng Zheng,0,154.0,0,0,0,2,2
Zheng Zhi,1,394.0,1,4,5,1,6
Zhou Haibin,0,33.0,0,0,1,0,1
Zhu Chenjie,1,82.0,0,1,1,0,1
Zia Arabshahi,1,69.0,0,0,0,1,1
Ziad Jaziri,1,406.0,0,0,7,2,9
Ziad Tlemçani,2,100.0,0,0,2,1,3
Zico,9,790.0,0,5,15,3,18
Zico Tumba,1,26.0,0,0,1,0,1
Zidane Sam,1,20.0,0,0,1,0,1
Zinedine Zidane,9,973.0,0,4,9,8,17
Zinho,1,77.0,0,1,1,0,1
Zini,0,106.0,0,0,1,1,2
Zisis Vryzas,1,123.0,0,0,0,3,3
Zito,1,69.0,0,0,1,0,1
Ziyad Al-Kord,1,10.0,0,0,1,0,1
Zizi Roberts,0,75.0,0,0,2,0,2
Zizinho,12,785.0,0,1,16,1,17
Zlatan Bajramović,0,165.0,0,0,1,2,3
Zlatan Ibrahimović,5,2364.0,0,5,26,18,44
Zlatan Ljubijankić,1,217.0,0,0,3,0,3
Zlatan Muslimović,0,393.0,0,0,5,3,8
Zlatko Dedić,0,176.0,0,0,3,1,4
Zlatko Junuzović,0,350.0,0,0,3,2,5
Zlatko Kranjčar,0,119.0,0,0,3,0,3
Zlatko Vujović,0,997.0,0,0,11,7,18
Zlatko Yankov,0,81.0,0,0,2,0,2
Zlatko Zahovič,3,1168.0,0,5,14,10,24
Zlatko Čajkovski,0,41.0,0,0,0,1,1
Zoilo Saldombide,2,129.0,0,1,0,2,2
Zola Matumona,0,242.0,0,1,2,2,4
Zoltan Crişan,0,243.0,0,0,2,2,4
Zoltán Böőr,0,4.0,0,0,0,1,1
Zoltán Czibor,3,80.0,0,0,2,1,3
Zoltán Gera,1,1244.0,0,4,14,7,21
Zoltán Halmosi,0,30.0,0,0,1,0,1
Zoltán Kereki,0,151.0,0,0,1,1,2
Zoltán Kovács,0,22.0,0,0,1,0,1
Zoltán Lipták,0,40.0,0,0,0,1,1
Zoltán Péter,0,65.0,0,0,1,0,1
Zoltán Stieber,1,169.0,0,0,0,2,2
Zoltán Varga,0,83.0,0,0,1,0,1
Zoran Boškovski,0,51.0,0,0,0,1,1
Zoran Filipović,0,95.0,0,0,0,2,2
Zoran Janković,0,17.0,0,0,0,1,1
Zoran Mirković,1,2.0,0,0,1,0,1
Zoran Tošić,0,354.0,0,0,6,2,8
Zoran Vujović,0,37.0,0,0,1,0,1
Zoran Vulić,0,65.0,0,0,1,0,1
Zoubeir Baya,2,542.0,0,0,7,5,12
Zouheir Dhaouadi,1,40.0,0,0,0,1,1
Zsolt Kalmár,0,47.0,0,0,0,1,1
Zuhair Bakheet,1,477.0,0,0,4,3,7
Zulkarnaen Zainal,0,88.0,0,0,0,1,1
Zulkifli Hamzah,1,134.0,0,0,1,1,2
Zumratul Hossain Mithu,0,50.0,0,0,1,0,1
Zuo Shusheng,5,273.0,0,0,4,2,6
Zuriko Davitashvili,0,82.0,0,0,0,1,1
Zvenyika Makonese,0,30.0,1,0,0,1,1
Zvezdan Cvetković,0,14.0,0,0,1,0,1
Zvezdan Čebinac,0,87.0,0,0,2,0,2
Zvi Farkash,1,50.0,0,0,1,0,1
Zvi Rozen,2,157.0,0,0,2,0,2
Zvjezdan Misimović,0,838.0,0,4,11,8,19
Zvonimir Boban,1,501.0,0,0,9,0,9
Zvonimir Soldo,0,171.0,0,0,1,2,3
Zvonimir Vukić,1,172.0,0,0,1,4,5
Zvonko Ivezić,0,77.0,0,0,0,1,1
Zvonko Živković,0,17.0,0,0,1,0,1
Zyad Chaabo,0,216.0,0,0,4,1,5
Zygfryd Szołtysik,0,162.0,0,0,2,0,2
Zé Kalanga,0,162.0,0,0,2,0,2
Zé Roberto,3,402.0,0,0,4,2,6
Zé de Mello,0,45.0,0,0,0,1,1
Zéphirin Zoko,0,86.0,0,0,0,1,1
it:Lee Ki-Bum,0,79.0,0,0,3,0,3
Ádám Gyurcsó,0,83.0,0,0,1,1,2
Ádám Lang,0,43.0,0,0,1,0,1
Ádám Szalai,1,765.0,0,2,11,7,18
Ákos Buzsáky,0,42.0,0,0,1,1,2
Ákos Takács,0,64.0,0,0,1,0,1
Álex Aguinaga,4,807.0,0,1,8,7,15
Álex da Rosa,0,45.0,0,0,1,0,1
Álvaro Grant,0,54.0,0,0,0,1,1
Álvaro Morata,8,1127.0,0,1,13,8,21
Álvaro Murillo,0,180.0,0,0,2,1,3
Álvaro Negredo,0,366.0,0,0,4,3,7
Álvaro Pereira,3,222.0,1,0,4,1,5
Álvaro Peña,0,136.0,0,0,2,0,2
Álvaro Recoba,3,283.0,0,1,3,3,6
Álvaro Saborío,4,813.0,0,2,11,10,21
Ángel Berni,3,229.0,0,0,1,3,4
Ángel Cabrera,1,22.0,0,0,2,0,2
Ángel Correa,0,74.0,0,0,0,1,1
Ángel Di María,7,802.0,0,0,10,7,17
Ángel Fernández,1,256.0,0,0,3,1,4
Ángel Guirado,2,88.0,0,0,3,1,4
Ángel Jara Saguier,0,122.0,0,0,1,1,2
Ángel Labruna,5,553.0,0,0,10,0,10
Ángel Martínez,0,64.0,0,0,0,1,1
Ángel María Villar,0,34.0,0,0,0,2,2
Ángel Mena,1,242.0,0,0,3,2,5
Ángel Piedra,1,73.0,0,0,1,0,1
Ángel Reyna,1,86.0,0,0,0,1,1
Ángel Romano,5,524.0,0,0,6,6,12
Ángel Romero,2,420.0,0,2,6,1,7
Ángel Sepúlveda,1,80.0,0,0,0,2,2
Ángel Tejeda,0,18.0,0,1,0,1,1
Ángelo Padilla,0,45.0,0,0,1,0,1
Ármann Björnsson,0,6.0,0,0,1,0,1
Árni Sveinsson,0,75.0,0,0,1,0,1
Ásgeir Sigurvinsson,0,208.0,0,0,1,3,4
Änis Ben-Hatira,0,79.0,0,0,1,0,1
Åge Hareide,0,120.0,0,0,3,1,4
Çağlar Söyüncü,1,28.0,0,0,0,1,1
Éder,1,258.0,0,0,2,2,4
Éder Aleixo de Assis,2,297.0,0,0,3,1,4
Éder Militão,0,37.0,0,0,1,0,1
Édgar Barreto,1,29.0,0,0,0,1,1
Édgar Benítez,1,371.0,1,0,2,4,6
Édgar González,0,90.0,0,0,1,0,1
Édison Méndez,4,730.0,1,1,10,5,15
Édouard Kargu,0,73.0,0,0,0,1,1
Élmer Ponciano,0,2.0,0,0,1,0,1
Émerson Ferreira da Rosa,0,67.0,0,0,0,1,1
Émile Mpenza,0,304.0,0,0,9,0,9
Émile Veinante,0,1.0,0,0,1,0,1
Éric Assadourian,0,135.0,0,0,1,2,3
Éric Mouloungui,0,119.0,0,0,2,0,2
Éric Pécout,0,67.0,0,0,1,0,1
Étienne Capoue,0,49.0,0,0,1,0,1
Étienne N'tsunda,1,29.0,0,0,1,0,1
Éver Banega,1,103.0,0,0,1,1,2
Éverton Ribeiro,0,168.0,0,0,2,1,3
Ísak Bergmann Jóhannesson,0,77.0,0,0,1,0,1
Ítalo Díaz,0,12.0,1,0,0,1,1
Ítalo Estupiñán,0,35.0,0,0,1,0,1
Óli Johannesen,0,70.0,1,0,0,1,1
Óscar Aguilera,0,88.0,0,0,0,1,1
Óscar Cardozo,2,310.0,0,1,2,3,5
Óscar Carmelo Sánchez,0,71.0,0,0,0,1,1
Óscar Duarte,1,77.0,0,0,1,1,2
Óscar Gómez Sánchez,7,513.0,0,0,3,7,10
Óscar Míguez,11,767.0,0,2,4,11,15
Óscar Ramírez,0,93.0,0,0,1,1,2
Óscar Reyes,1,85.0,0,0,0,1,1
Óscar Rojas,0,48.0,0,0,1,0,1
Óscar Romero,0,6.0,0,0,1,0,1
Óscar Sonejee,0,110.0,1,0,1,1,2
Óscar Ulloa,0,399.0,0,0,2,4,6
Örjan Martinsson,0,50.0,0,0,0,2,2
Örjan Persson,0,111.0,0,0,2,1,3
Örn Óskarsson,0,90.0,0,0,0,1,1
Øssur Hansen,0,150.0,0,0,1,1,2
Øyvind Leonhardsen,0,250.0,0,0,3,3,6
Ümit Davala,1,181.0,0,0,2,2,4
Ümit Karan,0,63.0,0,0,0,1,1
Ünal Karaman,0,73.0,0,0,1,0,1
Þorsteinn Bjarnason,0,78.0,1,0,1,0,1
Þorvaldur Örlygsson,0,122.0,0,0,1,1,2
Þórður Guðjónsson,0,326.0,0,0,3,2,5
Þórður Jónsson,0,129.0,0,0,2,0,2
Þórður Þórðarson,0,110.0,0,0,0,2,2
Đinh Tiến Thành,0,109.0,1,0,0,2,2
Đorđe Vujadinović,1,89.0,0,0,0,2,2
Đovani Roso,0,71.0,0,0,0,1,1
Đỗ Duy Mạnh,0,26.0,0,0,0,1,1
Ģirts Karlsons,0,61.0,0,0,2,2,4
İbrahim Toraman,0,15.0,0,0,0,1,1
İlhan Mansız,1,265.0,0,0,2,4,6
İlkay Gündoğan,2,528.0,0,5,6,6,12
İlyas Tüfekçi,0,140.0,0,1,2,0,2
İrfan Kahveci,1,62.0,0,0,0,1,1
İsmail Arca,0,64.0,1,0,2,0,2
Ľubomír Meszároš,0,57.0,0,0,1,0,1
Ľubomír Michalík,0,42.0,0,0,0,1,1
Ľubomír Moravčík,0,262.0,0,0,3,3,6
Ľubomír Reiter,0,312.0,0,0,2,4,6
Ľuboš Hanzel,0,68.0,0,0,1,0,1
Ľudovít Lancz,0,39.0,0,0,1,0,1
Łukasz Garguła,0,89.0,0,0,1,0,1
Łukasz Piszczek,0,128.0,0,0,2,1,3
Łukasz Szukała,1,58.0,0,0,0,1,1
Łukasz Teodorczyk,0,60.0,0,0,1,0,1
Ştefan Sameş,0,130.0,0,0,2,0,2
Štěpán Vachoušek,0,78.0,0,0,0,1,1
Žarko Odžakov,0,166.0,0,0,3,0,3
Žarko Serafimovski,0,20.0,0,0,0,1,1
Žarko Tomašević,0,233.0,0,0,3,1,4
Željko Milinovič,1,47.0,0,0,0,2,2
Željko Čajkovski,3,369.0,0,0,2,4,6
Ștefan Dobay,3,292.0,0,0,1,4,5
Ștefan Iovan,0,162.0,0,0,2,1,3
