scorer,neutral,minute,own_goal,penalty,home_goal,away_goal,total_goals,nation
A'ala Hubail,5,717.0,0,1,10,3,13,Bahrain
A. Elangovan,0,42.0,0,0,1,0,1,Malaysia
Aage Rou Jensen,0,85.0,0,0,0,1,1,Republic of Ireland
Aaran Lines,1,170.0,0,0,3,0,3,New Zealand
Aaron Boupendza,1,16.0,0,0,0,1,1,Comoros
Aaron Hughes,0,5.0,0,0,1,0,1,Northern Ireland
Aaron Long,0,131.0,0,0,2,0,2,United States
Aaron Mooy,0,217.0,0,0,2,2,4,Australia
Aaron Njovu,1,108.0,0,0,1,1,2,Nigeria
Aaron Ramsey,2,813.0,0,5,7,10,17,Liechtenstein
Aaron Tumwa,0,90.0,0,0,1,0,1,Antigua and Barbuda
Aarón Padilla Gutiérrez,0,80.0,0,0,1,1,2,Jamaica
Aatef Jenyat,1,17.0,0,0,0,1,1,Afghanistan
Abay Bokoleyev,1,63.0,0,0,0,1,1,Myanmar
Abbas Ahmed Atwi,1,122.0,0,1,1,1,2,Lebanon
Abbas Chahrour,0,28.0,0,0,1,0,1,Lebanon
Abbas Hassan Hassun,2,147.0,0,0,0,2,2,Macau
Abbas Obeid,1,4.0,0,0,0,1,1,Japan
Abbas Souan,0,90.0,0,0,1,0,1,Israel
Abdah Alif,1,32.0,0,0,0,1,1,United Arab Emirates
Abdallah Azhar,1,160.0,0,1,2,1,3,Morocco
Abdallah Deeb,0,291.0,0,2,2,5,7,Jordan
Abdallah El Said,1,242.0,0,0,3,1,4,Egypt
Abdel Halim Ali,1,135.0,0,0,3,1,4,Egypt
Abdel Kafi El-Sheikh,0,38.0,0,0,1,0,1,Sudan
Abdel Rasoul Hesham,0,146.0,0,0,2,1,3,Malawi
Abdel Razak Al-Farjani,0,43.0,0,0,1,0,1,Libya
Abdel Razak Jaranah,0,58.0,0,0,1,0,1,Libya
Abdel Sattar Sabry,1,159.0,0,0,3,1,4,Egypt
Abdel-Hadi Al-Maharmeh,0,28.0,0,0,0,1,1,Laos
Abdel-Zaher El-Saqqa,0,84.0,1,0,1,1,2,Egypt
Abdelatif Bahdari,0,90.0,0,0,1,0,1,Palestine
Abdelaziz Barrada,0,3.0,0,0,1,0,1,Morocco
Abdelaziz Daidi,0,44.0,0,0,1,0,1,Morocco
Abdelaziz Ibrahim Adam,1,90.0,0,0,0,1,1,Nigeria
Abdelfattah El Khattari,0,48.0,0,0,2,0,2,Morocco
Abdelfettah Rhiati,1,83.0,0,0,1,1,2,Ivory Coast
Abdelghani Lakhal,0,35.0,0,0,1,0,1,Morocco
Abdelhafid Tasfaout,2,449.0,0,0,7,3,10,Algeria
Abdelhakim Serrar,0,20.0,1,0,0,1,1,Algeria
Abdelilah Hafidi,0,82.0,0,0,0,1,1,South Africa
Abdeljalil Hadda,2,397.0,0,0,5,1,6,Morocco
Abdelkabir Mezyane,0,72.0,0,0,1,0,1,Morocco
Abdelkader Ben Hassen,1,48.0,0,0,1,0,1,Tunisia
Abdelkader Ferhaoui,1,36.0,0,0,1,0,1,Algeria
Abdelkader Ghezzal,0,86.0,0,0,2,0,2,Algeria
Abdelkader Rakbaoui,0,72.0,0,0,2,0,2,Tunisia
Abdelkarim Hassan,1,164.0,0,0,1,2,3,Hong Kong
Abdelkrim Merry,2,168.0,0,1,1,2,3,Cameroon
Abdellah Tazi,1,19.0,0,0,1,0,1,Morocco
Abdelmajid Bouyboud,0,93.0,0,0,0,2,2,Tunisia
Abdelmajid Chetali,1,109.0,0,0,2,1,3,Tunisia
Abdelmajid Tlemçani,0,60.0,0,0,1,0,1,Tunisia
Abdelmalek Cherrad,1,125.0,0,0,2,2,4,Algeria
Abdelmoumene Djabou,2,158.0,0,0,0,2,2,South Korea
Abdelmutaleb Nasir,1,40.0,0,0,0,1,1,Ethiopia
Abdelrazak Belgharbi,1,36.0,1,0,0,1,1,Algeria
Abdelrazaq Al Hussain,4,251.0,0,0,1,3,4,Saudi Arabia
Abdelwahab Lahmar,0,84.0,0,0,1,0,1,Tunisia
Abdelâali Zahraoui,2,168.0,0,0,1,1,2,Morocco
Abderraouf Ben Aziza,2,266.0,0,0,3,1,4,Egypt
Abderrazak Hamdallah,0,39.0,0,1,1,0,1,Morocco
Abderrazak Khairi,2,45.0,0,0,0,2,2,Portugal
Abdesalam Kames,1,42.0,0,0,1,0,1,Libya
Abdeslam Laghrissi,0,62.0,0,0,1,0,1,Morocco
Abdeslam Ouaddou,2,165.0,0,0,1,1,2,Morocco
Abdessalam Benjelloun,0,40.0,0,0,1,1,2,Morocco
Abdesselam Adhouma,0,15.0,0,0,0,1,1,Ivory Coast
Abdesselem Cheman,1,87.0,0,0,1,0,1,Tunisia
Abdi Idleh Hamza,0,74.0,0,0,1,0,1,Djibouti
Abdiel Arroyo,3,326.0,0,0,3,2,5,Chile
Abdoh Otaif,0,78.0,0,1,2,1,3,Saudi Arabia
Abdolreza Barzegari,2,114.0,0,0,0,2,2,Bangladesh
Abdou Bin Amidou,0,39.0,0,0,0,1,1,DR Congo
Abdou Diallo,1,151.0,0,0,1,1,2,Senegal
Abdou Jammeh,0,93.0,0,0,2,0,2,Gambia
Abdou Karim Sèye,0,24.0,0,0,1,0,1,Senegal
Abdou Traoré,0,54.0,0,0,0,1,1,Rwanda
Abdou-Rahman Njie,0,64.0,0,0,1,0,1,Gambia
Abdoul Camara,2,107.0,0,1,1,2,3,Botswana
Abdoul Tapsoba,4,220.0,0,0,2,2,4,Burkina Faso
Abdoul-Aziz Nikiema,0,79.0,0,0,1,0,1,Burkina Faso
Abdoulai Demba,0,48.0,0,0,1,0,1,Mali
Abdoulay Diaby,1,37.0,0,0,1,0,1,Mali
Abdoulaye Ba,0,63.0,0,0,1,0,1,Senegal
Abdoulaye Cissé,0,79.0,0,0,2,0,2,Burkina Faso
Abdoulaye Emmerson,0,116.0,0,0,2,0,2,Guinea
Abdoulaye Faye,1,155.0,0,0,3,0,3,Senegal
Abdoulaye M'Baye,1,80.0,0,0,0,1,1,Zambia
Abdoulaye Makhtar Diop,0,32.0,0,0,1,0,1,Senegal
Abdoulaye Traoré,9,888.0,0,1,13,4,17,Ivory Coast
Abdukahhor Marifaliev,0,62.0,0,0,0,2,2,Cambodia
Abdul Aziz Al-Muqbali,1,382.0,0,0,6,1,7,Oman
Abdul Aziz Corr,0,18.0,0,1,1,0,1,Gambia
Abdul Farooq,0,80.0,0,0,0,1,1,Jordan
Abdul Hadi Yahya,0,70.0,0,0,0,1,1,Singapore
Abdul Hakim,0,80.0,0,0,1,0,1,India
Abdul Hamid Al Katbi,0,36.0,0,0,1,0,1,Syria
Abdul Jaloof,0,126.0,0,0,1,1,2,Qatar
Abdul Kader Kardaghli,0,4.0,0,0,1,0,1,Syria
Abdul Kader Keïta,4,457.0,0,0,8,0,8,Ivory Coast
Abdul Kader Rifai,0,10.0,0,0,1,0,1,Syria
Abdul Latif Helou,0,226.0,0,0,2,2,4,Saudi Arabia
Abdul Majeed Waris,0,141.0,0,0,3,0,3,Ghana
Abdul Mubin Mokhtar,0,132.0,0,0,3,0,3,Malaysia
Abdul Nzayinawo,0,64.0,0,0,1,0,1,Angola
Abdul Rahman Abdulla,0,65.0,0,0,1,0,1,Yemen
Abdul Razaq Ibrahim,0,52.0,0,0,2,1,3,United Arab Emirates
Abdul Rwatubyaye,0,21.0,0,0,1,0,1,Rwanda
Abdul Sesay,1,81.0,0,0,1,0,1,Sierra Leone
Abdul-Aziz Hassan,0,45.0,0,0,1,0,1,Qatar
Abdul-Hamid Bassiouny,0,127.0,0,0,3,0,3,Egypt
Abdul-Wahab Abu Al-Hail,4,243.0,0,3,5,2,7,Iraq
Abdulaziz Al Sulaiti,0,14.0,0,0,0,1,1,Indonesia
Abdulaziz Al-Anberi,2,646.0,0,0,9,4,13,Kuwait
Abdulaziz Al-Dosari,0,30.0,0,0,1,0,1,Saudi Arabia
Abdulaziz Al-Hajeri,0,5.0,0,0,0,1,1,Pakistan
Abdulaziz Hatem,5,256.0,0,0,3,4,7,South Korea
Abdulaziz Mohamed,1,241.0,0,0,2,1,3,United Arab Emirates
Abdulfattah Asiri,0,95.0,0,0,2,0,2,Saudi Arabia
Abdulfattah Shehab,0,64.0,0,0,1,1,2,Singapore
Abdulgadir Ilyas Bakur,0,37.0,0,0,0,1,1,Uzbekistan
Abdulghani Tatiche,0,12.0,0,0,0,1,1,Iran
Abdulla Al Marzooqi,0,8.0,0,0,1,0,1,Bahrain
Abdulla Baba Fatadi,0,71.0,0,0,1,1,2,Bahrain
Abdulla Nasur,1,25.0,0,0,0,2,2,Zambia
Abdullah Al-Buloushi,2,154.0,0,0,1,1,2,France
Abdullah Al-Dosari,1,155.0,0,0,1,1,2,Macau
Abdullah Al-Hamdan,0,61.0,0,0,1,0,1,Saudi Arabia
Abdullah Al-Waked,0,61.0,0,1,1,1,2,Bahrain
Abdullah Bin Shehan,2,209.0,0,0,1,4,5,Thailand
Abdullah Fawaz,2,281.0,0,1,3,2,5,Afghanistan
Abdullah Jumaan Al-Dosari,0,50.0,0,0,1,0,1,Saudi Arabia
Abdullah Mawei,0,59.0,0,0,1,0,1,Kuwait
Abdullah Omar,1,66.0,0,0,0,1,1,Yemen
Abdullah Wabran,2,83.0,0,0,3,0,3,Kuwait
Abdullah Yousuf Ma'yoof,0,16.0,0,0,0,1,1,Qatar
Abdulnaser Abbas,1,88.0,0,0,1,0,1,Yemen
Abdulnasser Al-Obaidly,1,93.0,0,0,0,2,2,Japan
Abdulrahim Jumaa,0,19.0,0,0,1,0,1,United Arab Emirates
Abdulrahman Al-Qahtani,1,45.0,0,0,1,0,1,Saudi Arabia
Abdulrahman Fawzi,3,109.0,0,0,2,1,3,Israel
Abdulrahman Ibrahim,0,148.0,0,0,2,0,2,United Arab Emirates
Abdulrahman Mohamed,0,78.0,0,0,1,0,1,United Arab Emirates
Abdulrazaq Ibrahim Balooshi,2,320.0,0,1,6,0,6,United Arab Emirates
Abdulsalaam Jumaa,0,49.0,0,0,0,1,1,Brunei
Abdulsalam Al Ghurbani,0,170.0,0,0,2,1,3,India
Abdulwahab Al-Malood,0,153.0,0,0,1,1,2,Philippines
Abdulwasea Al-Matari,1,37.0,0,0,1,1,2,Yemen
Abdy Bäşimow,0,44.0,0,0,1,0,1,Turkmenistan
Abe Lenstra,0,106.0,0,0,3,0,3,Netherlands
Abedi Pele,6,411.0,0,0,3,5,8,Zambia
Abedi Saïd,0,77.0,0,0,3,0,3,Rwanda
Abekah Ankrah,0,18.0,0,0,0,1,1,Nigeria
Abel Aguilar,3,261.0,0,0,3,2,5,Peru
Abel Balbo,4,249.0,0,0,2,3,5,Australia
Abel Hernández,5,246.0,0,1,6,0,6,Uruguay
Abel Lobatón,1,16.0,0,0,1,0,1,Peru
Abel Xavier,0,128.0,0,0,1,1,2,Slovakia
Abelardo Fernández,0,43.0,0,0,2,0,2,Spain
Abinesh Samy,2,145.0,0,0,2,0,2,Fiji
Ablie Jallow,2,100.0,0,0,1,1,2,Mauritania
Abner Trigueros,1,176.0,0,0,1,1,2,Guatemala
Abou Diaby,0,20.0,0,0,0,1,1,Finland
Abou Seydou,0,89.0,0,0,1,0,1,Niger
Aboubacar Titi Camara,1,44.0,0,0,0,1,1,Senegal
Aboubakar Kamara,0,22.0,0,0,1,0,1,Mauritania
Aboubakari Ouédraogo,1,74.0,0,0,0,1,1,Sierra Leone
Abraham Tedros,0,89.0,0,0,0,1,1,Rwanda
Abram Raselemane,1,35.0,0,0,0,1,1,Jamaica
Absalom Iimbondi,0,25.0,0,0,1,0,1,Namibia
Abu Kamara,0,23.0,1,0,0,1,1,Sierra Leone
Abu Kanu,0,104.0,0,0,2,0,2,Sierra Leone
Abu Obeida Adam,0,82.0,0,0,1,0,1,Sudan
Abuaagla Abdalla,0,53.0,1,0,1,0,1,Morocco
Abubakar Al-Mass,0,74.0,0,0,1,0,1,Yemen DPR
Abubaker Bani,0,161.0,0,0,2,0,2,Libya
Abubaker Ben Brahim,0,53.0,0,0,1,0,1,Libya
Abubaker Tabula,0,77.0,0,0,1,0,1,Uganda
Abubeker Nassir,0,86.0,0,0,0,1,1,Zimbabwe
Abukari Gariba,2,140.0,0,0,0,2,2,Benin
Abzal Beisebekov,0,62.0,1,0,0,1,1,Kazakhstan
Achille Emaná,2,239.0,0,0,2,3,5,Cameroon
Achraf Dari,1,9.0,0,0,0,1,1,Croatia
Achraf Hakimi,2,326.0,0,0,4,1,5,Morocco
Aco Stojkov,0,176.0,0,0,4,0,4,North Macedonia
Ad-Diba,4,271.0,0,0,5,1,6,Egypt
Adalbert Deşu,1,1.0,0,0,0,1,1,Peru
Adalberto Escobar,0,63.0,0,0,0,2,2,Bolivia
Adam Abdulativ,0,142.0,0,0,2,0,2,Maldives
Adam Buksa,0,375.0,0,0,2,3,5,Poland
Adam El-Abd,0,4.0,1,0,0,1,1,Egypt
Adam Gnezda Čerin,0,84.0,0,0,1,0,1,Slovenia
Adam Hložek,1,65.0,0,0,0,1,1,Belarus
Adam Johnson,0,152.0,0,0,1,1,2,England
Adam Lallana,0,140.0,0,0,1,1,2,Slovakia
Adam Ledwoń,0,32.0,0,0,1,0,1,Poland
Adam Marušić,0,47.0,0,0,0,2,2,Turkey
Adam Ndlovu,1,265.0,0,0,2,3,5,Zimbabwe
Adam Nemec,0,336.0,0,0,5,3,8,North Macedonia
Adam Newton,0,88.0,0,0,0,1,1,Barbados
Adam Ounas,3,166.0,0,0,1,2,3,Tanzania
Adam Taggart,0,44.0,0,0,0,3,3,Taiwan
Adama Coulibaly,0,32.0,0,0,1,0,1,Mali
Adama Diomande,0,77.0,0,0,1,0,1,Norway
Adama Guira,1,90.0,1,0,0,1,1,Burkina Faso
Adama Klofie Koné,1,2.0,0,0,1,0,1,Ivory Coast
Adama Traoré,5,173.0,0,0,5,0,5,Mali
Adane Girma,1,155.0,0,0,1,1,2,Ethiopia
Adel Abbas Hussain,1,60.0,0,1,1,0,1,Kuwait
Adel Abdelrahman,1,75.0,0,0,0,1,1,Ivory Coast
Adel Abdulrahman Marzouq,1,1.0,0,0,1,0,1,Bahrain
Adel Al-Salimi,0,208.0,0,1,3,2,5,Brunei
Adel Chedli,0,147.0,0,0,2,0,2,Tunisia
Adel Khamis,0,150.0,0,0,2,1,3,Qatar
Adel Khamis Al Noobi,0,30.0,0,0,1,0,1,Qatar
Adel Khudhair,1,63.0,0,0,1,0,1,Iraq
Adel Malulla,0,90.0,0,0,1,0,1,Qatar
Adel Mohamed Abdulla,0,75.0,0,0,0,2,2,Bahrain
Adel Mubarak Khamis,0,85.0,0,0,0,1,1,Iraq
Adel Sellimi,2,429.0,0,3,3,5,8,Tunisia
Adel Taarabt,0,178.0,0,0,0,2,2,Togo
Adelaido Camaití,2,46.0,0,0,0,2,2,Peru
Adelardo Rodríguez,1,35.0,0,0,0,1,1,Brazil
Adem Ljajić,0,233.0,0,0,2,1,3,Serbia
Ademir de Menezes,6,930.0,0,0,20,2,22,Bolivia
Ademola Adeshina,1,118.0,0,0,1,1,2,Ethiopia
Adhemar Canavesi,1,85.0,1,0,1,0,1,Argentina
Adi Hütter,0,176.0,0,0,2,0,2,Austria
Adi Said,0,36.0,0,0,0,1,1,Taiwan
Adil Khan,0,88.0,0,0,1,0,1,India
Adis Jahović,0,149.0,0,1,1,1,2,Serbia
Adisak Kraisorn,2,208.0,0,0,2,1,3,Thailand
Admir Mehmedi,2,320.0,0,0,4,2,6,Switzerland
Admiral Muskwe,0,86.0,0,0,1,0,1,Zimbabwe
Adnan Ahmed Al-Sabbou,0,88.0,0,0,0,1,1,Bahrain
Adnan Al Talyani,6,908.0,0,0,13,5,18,United Arab Emirates
Adnan Ali Deif,0,69.0,0,0,1,0,1,Bahrain
Adnan Dirjal,1,89.0,0,0,1,0,1,Iraq
Adnan Januzaj,1,51.0,0,0,0,1,1,England
Adnan Kovačević,0,88.0,1,0,1,0,1,Greece
Adnan Ćustović,0,90.0,0,0,1,0,1,Bosnia and Herzegovina
Ado Onaiwu,0,91.0,0,1,3,0,3,Japan
Adokiye Amiesimaka,1,120.0,0,0,1,1,2,Ivory Coast
Adolf Scherer,4,546.0,0,1,8,2,10,Czechoslovakia
Adolf Urban,0,38.0,0,0,0,1,1,Finland
Adolfino Cañete,2,122.0,0,0,2,0,2,Paraguay
Adolfo Aldana,0,90.0,0,0,1,0,1,Spain
Adolfo Bautista,4,155.0,0,0,4,2,6,Mexico
Adolfo Erico,1,38.0,0,1,1,0,1,Paraguay
Adolfo Magallanes,2,41.0,0,0,1,1,2,Peru
Adolfo Olivares,0,113.0,0,0,1,1,2,Chile
Adolfo Pedernera,1,98.0,0,0,3,0,3,Argentina
Adolfo Valencia,2,391.0,0,0,3,3,6,Colombia
Adolfo Zumelzú,2,163.0,0,0,4,0,4,Argentina
Adolpho Millón Junior,0,77.0,0,0,1,0,1,Brazil
Adoram Keisi,0,37.0,0,0,0,2,2,Cyprus
Adrian Aliaj,0,101.0,1,0,2,0,2,Republic of Ireland
Adrian Alston,0,250.0,0,0,4,0,4,Australia
Adrian Bumbescu,0,70.0,0,0,1,0,1,Romania
Adrian Clifton,2,149.0,0,0,2,0,2,Montserrat
Adrian Elrick,0,81.0,0,0,1,0,1,New Zealand
Adrian Ilie,1,258.0,0,0,6,3,9,Romania
Adrian Knup,2,750.0,0,1,6,9,15,Switzerland
Adrian Kunz,0,90.0,0,0,1,0,1,Switzerland
Adrian Madaschi,0,56.0,0,0,2,0,2,Australia
Adrian Mariappa,0,166.0,1,0,2,0,2,Jamaica
Adrian Mierzejewski,0,130.0,0,0,0,2,2,Montenegro
Adrian Mutu,1,1047.0,0,5,17,7,24,Romania
Adrian Popa,0,95.0,0,0,1,1,2,Romania
Adrian Popescu,0,31.0,0,0,0,1,1,Bulgaria
Adrian Rus,0,45.0,1,0,1,0,1,Spain
Adrian Serioux,0,4.0,0,0,1,0,1,Canada
Adriano,14,815.0,0,0,10,7,17,Brazil
Adriano Leite Ribeiro,0,293.0,0,0,5,1,6,Brazil
Adriano Samaniego,1,73.0,0,0,0,1,1,Mexico
Adrien Rabiot,1,102.0,0,0,2,0,2,France
Adrien Silva,1,104.0,0,1,1,0,1,Portugal
Adrián Escudero,1,78.0,0,0,0,1,1,Turkey
Adrián Ramos,1,105.0,0,0,1,1,2,Paraguay
Adrián Romero,0,49.0,0,0,1,0,1,Uruguay
Ady Schmit,0,285.0,0,0,3,2,5,Luxembourg
Ady Williams,0,59.0,0,0,0,1,1,Denmark
Adékambi Olufadé,2,160.0,0,0,2,2,4,Senegal
Afonso Guimarães da Silva,1,30.0,0,0,1,0,1,Brazil
Afran Ismayilov,0,132.0,0,1,3,0,3,Azerbaijan
Aftandil Hacıyev,0,16.0,1,0,1,0,1,Poland
Agent Sawu,0,306.0,0,0,4,3,7,Zimbabwe
Agim Ibraimi,0,103.0,0,2,2,1,3,North Macedonia
Agne Simonsson,0,419.0,0,0,7,1,8,Sweden
Agung Setyabudi,0,7.0,0,0,1,0,1,Indonesia
Agustin Kola,0,138.0,1,0,1,1,2,Austria
Agustín Delgado,7,1106.0,0,0,15,8,23,Ecuador
Agustín Garcia,1,80.0,0,0,1,0,1,Mexico
Agustín Gaínza,0,130.0,0,0,1,1,2,Portugal
Agustín Lizarbe,1,81.0,0,0,1,0,1,Peru
Agustín Zelada,1,49.0,0,0,0,1,1,Argentina
Agustín Álvarez,0,47.0,0,0,1,0,1,Uruguay
Ahmad Abu Nahyeh,3,141.0,0,0,3,0,3,Palestine
Ahmad Ajab,0,254.0,0,0,6,0,6,Kuwait
Ahmad Al Saleh,1,90.0,0,0,1,0,1,Syria
Ahmad Al-Bashir,1,44.0,0,0,0,1,1,Pakistan
Ahmad Che Zambil,0,2.0,0,0,1,0,1,Malaysia
Ahmad Elrich,0,250.0,0,0,2,1,3,Australia
Ahmad Ersan,0,103.0,0,0,2,0,2,Jordan
Ahmad Hayel,0,333.0,0,0,6,1,7,Jordan
Ahmad Ibrahim Khalaf,0,125.0,1,0,1,1,2,Thailand
Ahmad Kadhim,0,228.0,0,0,3,0,3,Iraq
Ahmad Kallasi,1,57.0,0,0,1,0,1,Syria
Ahmad Khalifa Hashim,0,154.0,0,0,1,1,2,United Arab Emirates
Ahmad Mnajed,2,135.0,0,0,2,0,2,Iraq
Ahmad Nourollahi,1,120.0,0,0,1,2,3,Iran
Ahmad Salah Alwan,0,57.0,0,0,0,1,1,Uzbekistan
Ahmed Aadil,1,4.0,0,0,0,1,1,Chad
Ahmed Abdel Baki,0,80.0,0,0,0,1,1,Tunisia
Ahmed Abdul Karim Al-Brid,2,111.0,0,0,0,2,2,Pakistan
Ahmed Abdul Maqsoud,0,90.0,0,0,0,1,1,Maldives
Ahmed Abou El Fotouh,0,39.0,0,0,0,1,1,Libya
Ahmed Abou Rehab,1,34.0,0,0,1,0,1,Egypt
Ahmed Abouali,1,58.0,0,0,1,0,1,Morocco
Ahmed Akaïchi,2,221.0,0,0,0,4,4,Cameroon
Ahmed Al Hashmi,0,87.0,0,0,1,0,1,United Arab Emirates
Ahmed Al Masli,0,186.0,0,0,4,1,5,Libya
Ahmed Al Nifawi,1,10.0,0,0,1,0,1,Saudi Arabia
Ahmed Al-Fraidi,0,153.0,0,0,1,1,2,United Arab Emirates
Ahmed Al-Mousa,2,93.0,0,0,2,0,2,Saudi Arabia
Ahmed Al-Sarori,1,173.0,0,0,1,1,2,Philippines
Ahmed Al-Tash,1,64.0,0,0,0,1,1,Guinea
Ahmed Awad,0,77.0,0,0,1,0,1,Palestine
Ahmed Bahja,1,89.0,0,1,1,3,4,Gabon
Ahmed Bareed,1,77.0,0,0,1,0,1,Yemen
Ahmed Belal,1,25.0,0,0,0,1,1,Algeria
Ahmed Ben Soed,0,90.0,0,0,0,1,1,Ethiopia
Ahmed Bushara Wahba,1,128.0,0,0,1,1,2,Sudan
Ahmed Chombi,1,114.0,0,0,0,2,2,Kuwait
Ahmed Daham,1,90.0,0,0,1,0,1,Iraq
Ahmed Daher,0,23.0,0,0,0,1,1,Malawi
Ahmed Eid Abdel Malek,0,216.0,0,0,2,1,3,Egypt
Ahmed El-Kass,2,223.0,0,0,3,2,5,Zimbabwe
Ahmed Elmohamady,1,77.0,0,0,3,0,3,Egypt
Ahmed Faras,6,534.0,0,0,10,2,12,Morocco
Ahmed Faris Al-Binali,0,3.0,1,0,1,0,1,Japan
Ahmed Fathy,1,59.0,1,0,1,1,2,Ivory Coast
Ahmed H. Saeed,0,14.0,0,0,1,0,1,United Arab Emirates
Ahmed Hadid Al-Mukhaini,0,39.0,0,0,1,0,1,Oman
Ahmed Hassan,7,1070.0,0,2,11,8,19,Egypt
Ahmed Hassan Mahgoub,0,76.0,0,0,2,0,2,Egypt
Ahmed Issa Al-Mohannadi,0,52.0,0,0,1,0,1,Qatar
Ahmed Jamil Madani,2,227.0,0,0,1,2,3,Yemen
Ahmed Keshkesh,1,82.0,0,0,1,0,1,Palestine
Ahmed Khalil,4,1226.0,0,5,17,6,23,United Arab Emirates
Ahmed Limane,0,34.0,0,0,1,0,1,Morocco
Ahmed Makrouh,1,86.0,0,0,0,1,1,Guinea
Ahmed Mogni,2,147.0,0,0,0,2,2,Ghana
Ahmed Mohammed Al-Mahri,0,40.0,0,0,1,0,1,United Arab Emirates
Ahmed Mubarak Al-Mahaijri,1,392.0,0,1,6,3,9,India
Ahmed Musa,6,405.0,0,1,4,3,7,Mali
Ahmed Nashid,0,11.0,0,0,0,1,1,Bhutan
Ahmed Niyaz,0,87.0,0,0,1,0,1,Maldives
Ahmed Osman,0,74.0,0,0,1,0,1,Libya
Ahmed Ouattara,2,230.0,0,0,2,1,3,Ivory Coast
Ahmed Radhi,10,845.0,0,0,13,5,18,Jordan
Ahmed Rahim,0,90.0,0,0,1,0,1,Brunei
Ahmed Saad Osman,3,354.0,0,0,5,1,6,Libya
Ahmed Salah Hosny,1,30.0,0,0,1,0,1,Egypt
Ahmed Samir,0,127.0,0,1,1,1,2,Jordan
Ahmed Sidibe,0,10.0,0,0,1,0,1,Mauritania
Ahmed Thoriq,0,181.0,0,0,3,0,3,Maldives
Ahmed Touba,0,118.0,0,0,1,0,1,Algeria
Ahmed Waseem Razeek,2,71.0,0,1,0,2,2,Lebanon
Ahmed Yasin Ghani,4,300.0,0,0,3,1,4,Iraq
Ahmed Zuway,1,22.0,0,0,1,1,2,Togo
Ahmet Ataýew,1,79.0,0,1,0,1,1,Japan
Ahn Jung-hwan,3,461.0,0,0,5,1,6,South Korea
Aias Aosman,1,83.0,0,1,0,2,2,Maldives
Aibek Bokoev,0,76.0,0,0,1,0,1,Kyrgyzstan
Aidas Preikšaitis,0,88.0,0,0,1,0,1,Lithuania
Aiden McGeady,0,136.0,0,0,1,3,4,Republic of Ireland
Aidil Zafuan,0,54.0,0,0,1,0,1,Malaysia
Ainārs Linards,0,114.0,0,0,2,1,3,Latvia
Ajdin Hrustic,1,220.0,0,0,0,3,3,Kuwait
Akaki Khubutia,0,28.0,1,0,1,0,1,Scotland
Akbar Eftekhari,0,111.0,0,0,2,0,2,Iran
Akbar Kargarjam,0,85.0,0,0,1,0,1,Iran
Akhlidin Israilov,1,42.0,0,0,0,1,1,China PR
Akhtam Khamrakulov,0,61.0,0,0,1,0,1,Tajikistan
Akhtam Nazarov,0,122.0,0,2,1,1,2,Kyrgyzstan
Akhyar Rashid,0,144.0,0,0,2,0,2,Malaysia
Aki Heiskanen,0,133.0,0,0,1,2,3,Finland
Aki Hyryläinen,0,139.0,0,0,0,2,2,Israel
Aki Lahtinen,0,40.0,1,0,1,0,1,Wales
Aki Riihilahti,0,246.0,0,0,3,2,5,Finland
Akie Noah,0,58.0,0,0,1,0,1,Sierra Leone
Akihiro Nishimura,0,116.0,0,0,2,0,2,Japan
Akinori Nishizawa,5,327.0,0,0,7,1,8,Japan
Akira Kaji,0,28.0,0,0,1,0,1,Japan
Akmal Kholmatov,0,50.0,0,0,1,1,2,Tajikistan
Akmal Rizal Ahmad Rakhli,2,208.0,0,1,2,2,4,Hong Kong
Akmal Shorakhmedov,0,43.0,1,0,1,0,1,South Korea
Akram Afif,4,509.0,0,2,7,3,10,Qatar
Akram Al-Selwi,0,73.0,0,0,1,0,1,Yemen
Akram Emmanuel,0,47.0,0,0,0,1,1,China PR
Akram Moghrabi,0,52.0,0,0,1,0,1,Lebanon
Akram Tawfik,0,59.0,0,0,0,1,1,Angola
Akram Zuway,0,88.0,0,0,0,1,1,Guinea
Akuetteh Armah,0,35.0,0,1,1,0,1,Ghana
Akwá,0,807.0,0,0,11,3,14,Angola
Al Hasan Al-Yami,0,59.0,0,0,1,0,1,Saudi Arabia
Al Zerhusen,0,84.0,0,0,1,0,1,United States
Ala Al-Sasi,1,69.0,0,0,1,0,1,Yemen
Ala'a Eldin Yousif,0,45.0,0,0,1,0,1,Sudan
Alaa Abbas,2,180.0,0,0,1,1,2,Yemen
Alaa Abdul-Zahra,1,186.0,0,0,2,1,3,Iraq
Alaa Al Dali,1,17.0,0,0,1,1,2,Lebanon
Alaa El-Hamouly,0,32.0,0,0,0,1,1,Italy
Alaa Kadhim,8,317.0,0,0,1,7,8,Yemen
Alaa Mayhoub,0,7.0,0,0,1,0,1,Egypt
Alagame Seck,0,109.0,0,0,2,0,2,Senegal
Alain Boghossian,0,81.0,0,0,0,1,1,Russia
Alain Cervantes,1,135.0,0,0,0,2,2,Costa Rica
Alain Couriol,1,72.0,0,0,0,1,1,Poland
Alain Geiger,0,162.0,1,0,1,1,2,Switzerland
Alain Giresse,3,280.0,0,0,4,1,5,France
Alain Masudi,1,35.0,0,0,1,0,1,DR Congo
Alain N'Kong,0,72.0,0,0,0,1,1,Ghana
Alain Nana,0,73.0,0,0,1,0,1,Burkina Faso
Alain Nurenberg,0,37.0,0,0,1,0,1,Luxembourg
Alain Rakotondramanana,0,23.0,0,0,0,1,1,Benin
Alain Roche,0,89.0,0,0,0,1,1,Israel
Alain Sutter,1,53.0,0,0,1,3,4,Luxembourg
Alain Traoré,5,549.0,0,0,6,2,8,Burkina Faso
Alaixys Romao,0,21.0,1,0,0,1,1,Togo
Alan Ball Jr.,0,90.0,0,1,0,1,1,Wales
Alan Browne,0,18.0,0,0,0,1,1,Serbia
Alan Carvalho,1,238.0,0,0,3,0,3,China PR
Alan Curtis,0,138.0,0,0,1,1,2,Germany
Alan Durban,0,67.0,0,0,1,1,2,Scotland
Alan Dzagoev,2,365.0,0,0,4,4,8,Republic of Ireland
Alan Edward Davidson,0,33.0,0,0,1,0,1,Australia
Alan Gilzean,0,183.0,0,0,2,3,5,Scotland
Alan Kernaghan,0,25.0,0,0,1,0,1,Republic of Ireland
Alan Marley,0,270.0,0,0,3,0,3,New Zealand
Alan McDonald,1,119.0,1,0,1,2,3,Spain
Alan McLoughlin,0,86.0,0,0,0,2,2,Northern Ireland
Alan Mullery,1,31.0,0,0,1,0,1,England
Alan Shearer,4,679.0,0,5,15,6,21,England
Alan Smith,0,21.0,0,0,1,0,1,England
Alan Vest,1,264.0,0,0,2,2,4,New Zealand
Alassane Ouédraogo,1,96.0,0,0,1,1,2,Burkina Faso
Alban Bushi,0,333.0,0,0,4,2,6,Norway
Albeiro Usuriaga,0,73.0,0,0,1,0,1,Colombia
Albert Bell,0,90.0,0,0,1,0,1,Samoa
Albert Brülls,1,141.0,0,0,2,2,4,Northern Ireland
Albert Bwalya,0,67.0,0,0,0,1,1,Tanzania
Albert Cluytens,0,13.0,0,0,0,1,1,Republic of Ireland
Albert Emon,0,62.0,0,0,1,0,1,France
Albert Gemmrich,0,79.0,0,0,0,1,1,Luxembourg
Albert Guðmundsson,0,176.0,0,2,2,1,3,Turkey
Albert Luque,0,128.0,0,0,2,0,2,Spain
Albert Meyong,2,310.0,0,0,4,0,4,Cameroon
Albert Mpinganjira,0,71.0,0,0,1,0,1,Malawi
Albert Nađ,0,77.0,0,0,0,2,2,Malta
Albert Niyonkuru,0,89.0,0,1,0,1,1,Algeria
Albert Onyeanwuna,1,89.0,0,0,0,1,1,Egypt
Albert Riera,0,179.0,0,0,0,2,2,Denmark
Albert Rusnák,0,107.0,0,0,1,2,3,Slovakia
Albert Sarkisyan,0,157.0,0,2,1,2,3,Armenia
Alberth Elis,0,255.0,0,0,2,4,6,El Salvador
Alberto Acosta,1,81.0,0,0,1,0,1,Argentina
Alberto Aquilani,0,127.0,0,0,2,1,3,Italy
Alberto Bica,0,4.0,0,0,1,0,1,Uruguay
Alberto Blanco,0,89.0,0,0,0,1,1,Saint Lucia
Alberto Carvalhal,0,172.0,0,0,1,1,2,Macau
Alberto Doesburg,0,80.0,0,0,1,0,1,Suriname
Alberto Fonseca,0,118.0,0,0,1,1,2,Austria
Alberto Fouilloux,0,164.0,0,0,3,0,3,Chile
Alberto Galateo,1,48.0,0,0,1,0,1,Argentina
Alberto Gallardo,5,347.0,0,0,1,6,7,Argentina
Alberto García Aspe,5,411.0,0,5,5,5,10,El Salvador
Alberto Gilardino,1,601.0,0,0,8,2,10,Italy
Alberto Gómez,0,37.0,0,0,1,0,1,Cuba
Alberto Górriz,1,38.0,0,0,0,1,1,Belgium
Alberto Jiménez,0,94.0,0,0,2,0,2,Dominican Republic
Alberto Marcovecchio,0,148.0,0,0,2,0,2,Argentina
Alberto Medina,1,19.0,0,0,1,0,1,Mexico
Alberto Montaño,0,51.0,0,0,1,0,1,Ecuador
Alberto Montellanos,0,48.0,0,0,2,0,2,Peru
Alberto Ohaco,2,191.0,0,2,4,0,4,Argentina
Alberto Orlando,0,171.0,0,0,4,0,4,Italy
Alberto Quintero,2,202.0,0,0,4,0,4,Panama
Alberto Rendo,0,89.0,0,0,1,0,1,Argentina
Alberto Santelli,0,74.0,0,0,0,1,1,Venezuela
Alberto Spencer,0,148.0,0,0,3,1,4,Ecuador
Alberto Tarantini,0,43.0,0,0,1,0,1,Argentina
Alberto Terry,1,308.0,0,1,7,1,8,Peru
Alberto Valencia,1,37.0,0,0,0,1,1,Argentina
Alberto Zozaya,0,313.0,0,0,5,0,5,Argentina
Albino Rodríguez,1,75.0,0,0,1,0,1,Paraguay
Alcides Ghiggia,3,234.0,0,0,0,4,4,Bolivia
Alcides Peña,0,9.0,0,0,1,0,1,Bolivia
Alcides Silveira,2,65.0,0,3,0,3,3,Ecuador
Alcides Sosa,0,53.0,0,0,0,1,1,Venezuela
Aldair,2,60.0,0,0,1,1,2,United States
Alderman Lesmond,0,7.0,0,0,1,0,1,United States Virgin Islands
Aldo Donelli,4,278.0,0,0,0,5,5,Mexico
Aldo Junior Simoncini,0,26.0,1,0,1,0,1,Sweden
Aldo Serena,0,155.0,0,0,1,2,3,Italy
Aldo de Nigris,4,312.0,0,0,2,3,5,Mexico
Alejandrino Genés,4,212.0,0,0,2,3,5,Bolivia
Alejandro Alpízar,0,133.0,0,0,1,1,2,Costa Rica
Alejandro Carrillo,1,83.0,0,0,0,1,1,Chile
Alejandro Chumacero,0,113.0,0,0,2,0,2,Bolivia
Alejandro Cichero,0,50.0,1,0,2,0,2,Bolivia
Alejandro Guerra,0,81.0,0,0,1,0,1,Venezuela
Alejandro Hisis,0,49.0,0,0,2,0,2,Chile
Alejandro Luces,0,63.0,0,0,1,0,1,Peru
Alejandro Madrigal,0,48.0,0,0,0,1,1,Barbados
Alejandro Moreno,0,56.0,0,0,1,0,1,Venezuela
Alejandro Romero Gamarra,1,180.0,0,0,3,0,3,Paraguay
Alejandro Scopelli,1,115.0,0,0,3,0,3,Argentina
Alejandro Villanueva,1,61.0,0,0,1,1,2,Peru
Alekos Alexandris,0,54.0,0,0,0,1,1,Slovenia
Alekos Alexiadis,0,125.0,0,0,2,0,2,Greece
Aleksandar Dragović,0,30.0,0,0,1,0,1,Austria
Aleksandar Kolarov,1,410.0,0,1,3,5,8,Serbia
Aleksandar Luković,0,90.0,1,0,0,1,1,Serbia
Aleksandar Mitrović,3,1383.0,0,0,18,10,28,Serbia
Aleksandar Petaković,2,89.0,0,0,1,2,3,Yugoslavia
Aleksandar Prijović,0,74.0,0,0,1,0,1,Serbia
Aleksandar Radosavljević,0,39.0,0,0,1,0,1,Slovenia
Aleksandar Tirnanić,1,21.0,0,0,0,1,1,Brazil
Aleksandar Tonev,0,202.0,0,0,4,0,4,Bulgaria
Aleksandar Trajkovski,0,602.0,0,1,7,4,11,North Macedonia
Aleksandar Trifunović,0,79.0,0,0,0,1,1,Romania
Aleksandar Tunchev,0,26.0,0,0,0,1,1,Luxembourg
Aleksandar Vasoski,0,70.0,0,0,0,1,1,Romania
Aleksandar Đurić,0,213.0,0,0,6,1,7,Singapore
Aleksandar Šofranac,0,66.0,1,0,1,0,1,England
Aleksander Knavs,0,110.0,0,0,1,2,3,Georgia
Aleksander Rodić,0,44.0,0,0,1,0,1,Slovenia
Aleksandr Amisulashvili,0,13.0,0,0,1,0,1,Georgia
Aleksandr Borodiuk,0,89.0,0,0,0,1,1,Hungary
Aleksandr Golovin,0,263.0,0,0,2,1,3,Russia
Aleksandr Gorshkov,0,118.0,0,0,2,0,2,Ukraine
Aleksandr Iashvili,0,499.0,0,1,7,5,12,Georgia
Aleksandr Ivanov,1,56.0,0,0,0,1,1,England
Aleksandr Kerzhakov,1,828.0,0,0,12,9,21,Russia
Aleksandr Khapsalis,0,28.0,0,0,0,1,1,Finland
Aleksandr Kokorin,1,200.0,0,2,4,4,8,Israel
Aleksandr Kuchma,0,150.0,1,0,2,0,2,Kazakhstan
Aleksandr Merzlikin,2,38.0,0,0,1,1,2,Kyrgyzstan
Aleksandr Mostovoi,1,287.0,0,1,5,2,7,Russia
Aleksandr Panov,0,115.0,0,0,0,2,2,France
Aleksandr Samedov,0,124.0,0,0,2,1,3,Russia
Aleksandr Shadrin,0,53.0,0,0,0,1,1,Japan
Aleksandr Shirko,0,88.0,0,0,0,1,1,Faroe Islands
Aleksandr Sobolev,0,90.0,0,0,0,1,1,Malta
Aleksandr Yerokhin,0,97.0,0,0,2,1,3,Cyprus
Aleksandre Chivadze,2,63.0,0,0,2,0,2,Russia
Aleksandre Karapetian,0,37.0,0,0,2,1,3,Armenia
Aleksandrs Cauņa,0,464.0,0,2,5,4,9,Luxembourg
Aleksandrs Jeļisejevs,0,89.0,0,0,0,2,2,Estonia
Aleksei Ionov,0,94.0,0,0,1,1,2,Russia
Aleksei Mamykin,1,56.0,0,0,1,1,2,Turkey
Aleksei Miranchuk,0,94.0,0,0,1,1,2,San Marino
Aleksei Sutormin,0,62.0,0,0,1,0,1,Russia
Aleksejs Višņakovs,0,273.0,0,0,3,2,5,Latvia
Aleksey Dionisiev,0,21.0,0,0,1,0,1,Uzbekistan
Aleksey Shchotkin,0,28.0,0,0,0,2,2,Cyprus
Alen Bokšić,2,366.0,0,0,4,4,8,Croatia
Alessandro Altobelli,6,609.0,0,2,9,5,14,Italy
Alessandro Costacurta,0,19.0,0,0,0,1,1,Slovenia
Alessandro Del Piero,2,1047.0,0,3,11,6,17,Italy
Alessandro Della Valle,0,112.0,2,0,2,1,3,San Marino
Alessandro Diamanti,1,73.0,0,0,0,1,1,Uruguay
Alessandro Florenzi,0,97.0,0,0,2,0,2,Italy
Alessandro Frigerio,0,76.0,0,0,0,1,1,Yugoslavia
Alessandro Schöpf,1,60.0,0,0,0,1,1,Iceland
Alessio Romagnoli,0,149.0,0,0,1,1,2,Liechtenstein
"Alex ""Didí"" Valverde",0,53.0,0,0,1,0,1,Colombia
Alex Brosque,0,204.0,0,0,3,0,3,Australia
Alex Bunbury,1,458.0,0,0,9,3,12,Canada
Alex Chola,0,32.0,0,0,2,0,2,Zambia
Alex Greive,2,53.0,0,0,2,0,2,New Zealand
Alex Iwobi,1,172.0,0,0,2,1,3,Zambia
Alex Král,0,71.0,0,0,1,0,1,Czech Republic
Alex Moucketou-Moussounda,0,84.0,0,0,1,0,1,Gabon
Alex Nyarko,1,8.0,0,0,1,0,1,Ghana
Alex Oxlade-Chamberlain,0,249.0,0,0,2,3,5,England
Alex Pineda Chacón,1,100.0,0,0,2,1,3,Canada
Alex Roldan,1,171.0,0,0,2,0,2,El Salvador
Alex Sandro,0,12.0,0,0,1,0,1,Brazil
Alex Scott,0,70.0,0,0,1,0,1,Scotland
Alex Tobin,0,59.0,1,0,1,0,1,Argentina
Alex Valderrama,0,75.0,0,0,1,1,2,Bolivia
Alex Young,0,20.0,0,0,0,2,2,Republic of Ireland
Alexander Cruzata,0,94.0,1,0,1,1,2,Cayman Islands
Alexander Djiku,1,77.0,0,0,1,0,1,Ghana
Alexander Frei,2,997.0,0,2,13,11,24,Switzerland
Alexander Gerndt,0,88.0,0,0,0,1,1,Moldova
Alexander Geynrikh,7,803.0,0,1,11,5,16,Uzbekistan
Alexander Hleb,0,48.0,0,0,0,1,1,Kazakhstan
Alexander Horváth,0,116.0,0,0,2,0,2,Czechoslovakia
Alexander Isak,0,280.0,0,0,4,3,7,Sweden
Alexander Kačaniklić,0,107.0,0,0,1,1,2,Faroe Islands
Alexander Khatskevich,0,81.0,0,0,3,0,3,Belarus
Alexander Kobakhidze,0,71.0,0,0,0,1,1,France
Alexander Larín,0,36.0,0,1,1,1,2,Curaçao
Alexander Linwood,0,78.0,0,0,1,0,1,Scotland
Alexander López,1,108.0,0,1,0,3,3,Trinidad and Tobago
Alexander Riley,0,8.0,1,0,1,0,1,Trinidad and Tobago
Alexander Ring,0,8.0,0,0,1,0,1,Finland
Alexander Rondón,0,197.0,0,0,3,0,3,Venezuela
Alexander Satariano,0,20.0,0,0,0,1,1,Slovakia
Alexander Saununu,0,2.0,0,0,0,1,1,Singapore
Alexander Søderlund,0,107.0,0,1,2,0,2,Norway
Alexander Sørloth,0,416.0,0,0,3,4,7,Romania
Alexander Tettey,0,122.0,0,0,1,2,3,Croatia
Alexander Viveros,0,27.0,0,0,1,0,1,Colombia
Alexander Ødegaard,0,89.0,0,0,1,0,1,Norway
Alexandr Korzanov,1,4.0,0,0,1,0,1,Kyrgyzstan
Alexandre Alphonse,1,64.0,0,0,1,0,1,Guadeloupe
Alexandre Boucicaut,1,71.0,0,0,1,0,1,Haiti
Alexandre Czerniatynski,1,183.0,0,0,2,1,3,Belgium
Alexandre Martínez Palau,0,90.0,0,0,1,0,1,Andorra
Alexandre Pato,2,89.0,0,0,2,0,2,Brazil
Alexandre Rey,0,144.0,0,0,3,1,4,Wales
Alexandros Garpozis,0,16.0,0,0,1,0,1,Cyprus
Alexandros Tziolis,0,26.0,0,0,0,1,1,Cyprus
Alexandru Antoniuc,0,117.0,0,0,0,2,2,Montenegro
Alexandru Badea,0,43.0,0,0,1,0,1,Romania
Alexandru Chipciu,0,184.0,0,0,0,3,3,Hungary
Alexandru Cicâldău,0,134.0,0,0,0,2,2,Armenia
Alexandru Curtianu,0,22.0,0,0,2,0,2,Moldova
Alexandru Dedov,0,63.0,0,1,2,0,2,Moldova
Alexandru Ene,0,175.0,0,0,2,1,3,Romania
Alexandru Epureanu,0,237.0,0,0,1,2,3,Moldova
Alexandru Gațcan,0,154.0,0,0,0,2,2,Italy
Alexandru Guzun,0,6.0,0,0,1,0,1,Moldova
Alexandru Maxim,0,326.0,0,1,2,2,4,Romania
Alexandru Mitriță,0,171.0,0,0,2,1,3,Faroe Islands
Alexandru Neagu,2,167.0,0,0,1,2,3,Czechoslovakia
Alexandru Suvorov,0,384.0,0,0,2,3,5,Moldova
Alexei Eremenko,0,482.0,0,0,6,4,10,Romania
Alexei Klishin,0,73.0,0,0,0,2,2,Iraq
Alexei Kosolapov,0,38.0,0,0,1,0,1,Russia
Alexei Rios,0,47.0,0,0,0,1,1,Netherlands
Alexi Lalas,2,97.0,0,0,2,1,3,United States
Alexis Alexandris,0,235.0,0,0,1,3,4,Faroe Islands
Alexis Mac Allister,1,46.0,0,0,0,1,1,Poland
Alexis Mendoza,0,66.0,0,0,1,0,1,Colombia
Alexis Saddler,0,141.0,0,1,3,0,3,Saint Kitts and Nevis
Alexis Saelemaekers,0,65.0,0,0,1,0,1,Belgium
Alexis Sánchez,8,1392.0,0,0,14,16,30,Peru
Alexis Tumahai,1,90.0,0,0,0,1,1,New Caledonia
Alexis Vega,1,207.0,0,0,2,1,3,Mexico
Alexsandro de Souza,8,521.0,0,1,8,1,9,Brazil
Alf Martinsen,1,127.0,0,0,1,1,2,Norway
Alf Ringstead,0,3.0,0,0,1,0,1,Republic of Ireland
Alfa Potowabawi,0,29.0,0,0,0,1,1,Angola
Alfaz Ahmed,3,191.0,0,0,0,3,3,Taiwan
Alfonso Cañón,0,72.0,0,0,0,1,1,Chile
Alfonso Domínguez,2,148.0,1,0,2,2,4,Peru
Alfonso Pérez,3,652.0,0,0,5,5,10,Spain
Alfonso Rodríguez Salas,0,21.0,0,0,0,1,1,Wales
Alfonso Yáñez,1,35.0,0,1,0,1,1,Argentina
Alfred Aston,0,3.0,0,0,0,1,1,Luxembourg
Alfred Bickel,1,64.0,0,0,0,1,1,Germany
Alfred Effiong,0,85.0,0,0,2,0,2,Malta
Alfred Heiß,0,30.0,0,0,0,1,1,Cyprus
Alfred Körner,1,131.0,0,0,1,2,3,Switzerland
Alfred Pfaff,1,25.0,0,0,1,0,1,Germany
Alfred Scheiwiler,0,29.0,0,0,1,0,1,Switzerland
Alfred Wabealo,2,134.0,0,0,0,2,2,New Zealand
Alfredo Carricaberry,2,94.0,0,0,2,1,3,Argentina
Alfredo Di Stéfano,6,624.0,0,0,8,5,13,Argentina
Alfredo Esteves,1,35.0,1,0,0,1,1,Timor-Leste
Alfredo France,1,33.0,0,0,0,1,1,Argentina
Alfredo Garasini,0,72.0,0,0,1,0,1,Argentina
Alfredo Hernández,0,140.0,0,0,0,3,3,United States
Alfredo Megido,0,67.0,0,0,1,0,1,Spain
Alfredo Mejía,1,90.0,0,0,0,1,1,Grenada
Alfredo Mendoza,2,320.0,0,0,3,4,7,Paraguay
Alfredo Mosquera,3,120.0,0,0,1,2,3,Chile
Alfredo Pacheco,1,179.0,0,1,1,3,4,Costa Rica
Alfredo Pérez,1,81.0,0,0,0,1,1,Uruguay
Alfredo Quaresma,0,48.0,0,0,1,0,1,Portugal
Alfredo Torres,0,149.0,0,0,2,0,2,Mexico
Alfredo del Águila,1,29.0,0,0,0,1,1,Czechoslovakia
Alfredo dos Santos,0,3.0,0,0,1,0,1,Brazil
Alfreð Finnbogason,1,270.0,0,1,4,2,6,Iceland
Alhaji Kamara,2,160.0,0,0,1,1,2,Sierra Leone
Alhassan Kamara,0,142.0,0,0,1,1,2,Tunisia
Alhassane Bangoura,0,88.0,0,0,1,0,1,Guinea
Alhassane Issoufou,0,153.0,0,0,2,0,2,Niger
Ali Abo Greisha,3,260.0,0,0,6,1,7,Egypt
Ali Aboud Awad,0,82.0,0,0,0,1,1,Brunei
Ali Adnan Kadhim,4,323.0,0,2,5,0,5,Iraq
Ali Afif,0,53.0,0,1,0,1,1,Japan
Ali Al Saadi,0,93.0,0,0,3,0,3,Lebanon
Ali Al-Beshari,0,247.0,0,0,4,0,4,Libya
Ali Al-Hadyah,0,120.0,0,0,2,0,2,Kuwait
Ali Al-Hassan,0,52.0,0,0,1,0,1,Saudi Arabia
Ali Al-Nono,0,428.0,0,0,4,3,7,Brunei
Ali Al-Wehaibi,0,110.0,0,0,1,1,2,India
Ali Asel,1,61.0,0,0,0,1,1,Kyrgyzstan
Ali Asghar Modir Roosta,0,404.0,0,0,6,1,7,Iran
Ali Ashfaq,1,860.0,0,2,10,4,14,Maldives
Ali Assadalla,1,164.0,0,0,3,1,4,Qatar
Ali Bala,1,75.0,0,0,0,1,1,Egypt
Ali Cheikh Dib,2,148.0,0,1,1,2,3,Syria
Ali Daei,23,2776.0,0,8,26,23,49,Iran
Ali Diab,1,30.0,1,0,1,0,1,Jordan
Ali Djabari,0,74.0,0,0,1,0,1,Iran
Ali Elkhattabi,1,40.0,0,0,1,0,1,Morocco
Ali Elmusrati,1,68.0,0,0,1,0,1,Libya
Ali Faez,1,24.0,1,0,0,1,1,Iraq
Ali Fasir,1,25.0,0,0,0,1,1,Philippines
Ali Fergani,1,125.0,0,0,3,0,3,Algeria
Ali Gagarin,3,225.0,0,1,4,2,6,Sudan
Ali Gerba,6,611.0,0,0,8,4,12,Canada
Ali Gholizadeh,2,202.0,0,0,1,2,3,Iran
Ali Hamam,0,68.0,1,0,1,1,2,Lebanon
Ali Hosni,1,59.0,0,0,1,0,1,Iraq
Ali Jabbari,1,391.0,0,0,2,3,5,Iran
Ali Kaabi,2,191.0,0,0,1,2,3,Tunisia
Ali Kadhim,2,46.0,0,0,2,0,2,Iraq
Ali Karimi,5,659.0,0,0,8,5,13,Iran
Ali Khalil,0,106.0,0,0,3,0,3,Egypt
Ali Mabkhout,6,1530.0,0,5,23,9,32,United Arab Emirates
Ali Madan,0,111.0,0,0,2,0,2,Bahrain
Ali Maher,1,133.0,0,0,3,1,4,Cameroon
Ali Maqseed,1,12.0,0,0,1,0,1,Kuwait
Ali Marwi,6,217.0,0,0,2,4,6,Macau
Ali Maâloul,0,43.0,0,0,1,0,1,Tunisia
Ali Meçabih,2,176.0,0,0,2,2,4,Algeria
Ali Mohammed Al-Saadah,0,90.0,0,0,1,0,1,Qatar
Ali Momin,0,50.0,1,0,0,1,1,Brunei
Ali Mousavi,1,82.0,0,0,0,1,1,Kyrgyzstan
Ali Nasseredine,0,183.0,0,0,2,2,4,Lebanon
Ali Parvin,0,163.0,0,0,2,1,3,Iran
Ali Saad,1,31.0,0,0,1,0,1,Bahrain
Ali Salama,0,27.0,0,0,1,0,1,Libya
Ali Salmeen,0,32.0,0,0,1,0,1,United Arab Emirates
Ali Samooh,0,23.0,0,0,1,0,1,Maldives
Ali Sharafat,0,81.0,0,0,1,0,1,Pakistan
Ali Shiham,0,68.0,0,0,1,0,1,Maldives
Ali Sulieman,0,65.0,0,0,1,0,1,Eritrea
Ali Sylla,0,11.0,0,0,0,1,1,Tunisia
Ali Thani Jumaa,2,43.0,0,0,0,2,2,Yugoslavia
Ali Umar,0,200.0,0,0,3,0,3,Maldives
Ali Zaid,1,47.0,0,0,1,0,1,Qatar
Ali Zitouni,2,449.0,0,0,4,4,8,South Africa
Ali'i Mitchell,1,57.0,0,0,1,0,1,American Samoa
Aliaksandr Kulchiy,0,49.0,0,0,0,1,1,Slovenia
Alicio Solalinde,0,77.0,0,0,0,1,1,Ecuador
Alick Maemae,0,208.0,0,0,3,0,3,Solomon Islands
Alick Saurei,1,90.0,0,0,0,1,1,Fiji
Alier Ashurmamadov,2,94.0,0,0,2,1,3,Vietnam
Alimardon Shukurov,1,136.0,0,0,2,1,3,Kyrgyzstan
Alin Toșca,0,11.0,0,0,1,0,1,Romania
Alireza Azizi,0,90.0,0,0,2,0,2,Iran
Alireza Jahanbakhsh,3,423.0,0,1,6,2,8,Iran
Alireza Khorshidi,0,145.0,0,0,2,0,2,Iran
Alireza Mansourian,0,91.0,0,0,4,0,4,Iran
Alireza Vahedi Nikbakht,0,153.0,0,0,3,2,5,Iran
Alirou Rachidou,0,87.0,0,0,1,0,1,Togo
Alisher Dzhalilov,0,91.0,0,0,2,0,2,Tajikistan
Alistair Johnston,1,44.0,0,0,0,1,1,Cayman Islands
Alivate Driu,0,1.0,0,0,0,1,1,Papua New Guinea
Aljaž Struna,0,35.0,0,0,1,0,1,Slovenia
Alkhaly Bangoura,0,90.0,0,0,1,0,1,Guinea
Allan Boath,0,19.0,0,0,1,0,1,New Zealand
Allan Brown,0,26.0,0,0,2,0,2,Scotland
Allan Clarke,1,159.0,0,3,2,1,3,Czechoslovakia
Allan Cruz,1,75.0,0,0,1,0,1,Costa Rica
Allan Hansen,0,156.0,0,1,2,0,2,Denmark
Allan Hunter,0,32.0,0,0,1,0,1,Northern Ireland
Allan Johnston,0,100.0,0,0,0,2,2,Faroe Islands
Allan Mørkøre,0,21.0,0,0,0,1,1,Denmark
Allan Nielsen,2,317.0,0,0,3,4,7,Armenia
Allan Oviedo,0,145.0,0,0,1,1,2,Costa Rica
Allan Simonsen,0,433.0,0,3,6,3,9,Cyprus
Allan Wanga,0,77.0,0,0,1,0,1,Kenya
Allean Richard Grant Velasquez,0,87.0,0,0,0,1,1,Bermuda
Allianni Urgelles,0,90.0,0,0,1,0,1,Cuba
Alloysius Atuegbu,0,65.0,0,0,2,0,2,Nigeria
Ally Abubakari,0,54.0,0,0,0,1,1,Ghana
Ally McCoist,1,604.0,0,0,10,3,13,Scotland
Almazbek Mirzaliev,0,90.0,0,0,1,0,1,Kyrgyzstan
Almedin Hota,0,89.0,0,0,0,1,1,Liechtenstein
Almir Da Silva,0,28.0,0,0,0,1,1,Bolivia
Almiro Lobo,1,143.0,0,1,2,1,3,Mozambique
Almoez Ali,13,898.0,0,2,10,10,20,Qatar
Alon Hazan,0,64.0,0,0,1,0,1,Israel
Alon Mizrahi,0,225.0,0,0,5,1,6,San Marino
Alonso Botero,1,72.0,0,0,1,1,2,Bolivia
Alonso Solís,0,188.0,0,0,1,2,3,Guatemala
Aloísio,0,46.0,0,0,0,1,1,Saudi Arabia
Alpaslan Eratlı,0,54.0,0,0,0,1,1,Switzerland
Alpay Özalan,0,176.0,0,0,3,0,3,Turkey
Alphonse Leweck,0,232.0,0,0,1,2,3,Luxembourg
Alphonse Tchami,3,374.0,0,0,6,5,11,Cameroon
Alphonso Davies,8,455.0,0,1,2,7,9,French Guiana
Alphonsus Brown,0,66.0,0,0,1,0,1,Saint Vincent and the Grenadines
Alphose Qorig,3,163.0,0,1,0,3,3,American Samoa
Alsény Diaby,0,14.0,0,0,1,0,1,Guinea
Altin Haxhi,1,122.0,0,0,2,0,2,Albania
Altin Lala,0,101.0,0,0,1,1,2,Albania
Altin Rraklli,0,304.0,0,0,5,1,6,Albania
Altino Marcondes,0,9.0,0,0,1,0,1,Brazil
Altymyrat Annadurdyýew,2,252.0,0,0,2,2,4,Oman
Aluísio Francisco da Luz,0,47.0,0,0,0,1,1,Peru
Alvaro José Rodrigues Valente,1,10.0,0,0,1,0,1,Brazil
Alvin Ceccoli,0,42.0,0,0,1,0,1,Australia
Alvin Corneal,0,28.0,0,0,1,0,1,Trinidad and Tobago
Alvin Jones,0,37.0,0,0,1,0,1,Trinidad and Tobago
Alvin Kieh,0,85.0,0,0,1,0,1,Liberia
Alvin Tehau,6,265.0,0,0,3,4,7,Samoa
Alvin Thomas,1,89.0,0,0,1,0,1,Trinidad and Tobago
Alwin Hou,3,144.0,0,0,2,1,3,Cook Islands
Alwin Komolong,1,24.0,0,0,0,1,1,Solomon Islands
Alwyn Guy,0,248.0,0,0,5,1,6,Honduras
Alyaksandr Martynovich,0,82.0,1,0,0,1,1,Belarus
Alyaksandr Taykow,0,57.0,0,0,1,0,1,Belarus
Amad Al-Hosni,3,423.0,0,1,8,2,10,Oman
Amad Ali,0,94.0,0,0,0,2,2,India
Amadeo Ortega,2,88.0,0,0,2,0,2,Paraguay
Amado Guevara,5,871.0,0,4,10,5,15,Honduras
Amadou Haidara,1,37.0,0,0,0,1,1,Angola
Amadou Pathé Diallo,1,46.0,0,0,0,1,1,Ivory Coast
Amadou Sabo,1,68.0,0,0,0,1,1,Djibouti
Amadou Touré,0,107.0,0,0,0,2,2,Ethiopia
Amancio Amaro,1,436.0,0,0,9,0,9,Spain
Amani Habimana,0,78.0,0,0,1,0,1,Burundi
Amar Ramadan,0,45.0,0,0,0,1,1,Benin
Amara Simba,0,41.0,0,0,1,0,1,France
Amara Touré,0,115.0,0,0,1,1,2,Guinea
Amarildo Tavares da Silveira,3,175.0,0,0,3,0,3,Brazil
Amaro,1,75.0,0,0,0,1,1,Senegal
Ambroise Oyongo,1,84.0,0,0,0,1,1,Mali
Amby Fogarty,0,164.0,0,0,2,1,3,Czechoslovakia
Amer Deeb,0,271.0,0,0,5,0,5,Jordan
Amer Gojak,0,205.0,0,0,2,2,4,Bosnia and Herzegovina
Amer Mushraf,1,54.0,0,0,1,0,1,Iraq
Amido Baldé,0,62.0,0,0,0,1,1,Liberia
Amilcar Ramos,0,36.0,0,0,1,0,1,São Tomé and Príncipe
Amin Dabo,0,82.0,0,0,1,0,1,Saudi Arabia
Amin Younes,1,128.0,0,0,2,0,2,Germany
Amine Chermiti,1,1.0,0,0,0,1,1,Cameroon
Amir Abrashi,0,90.0,0,0,0,1,1,Andorra
Amir Al-Ammari,1,86.0,0,1,1,0,1,Iraq
Amir Kamal,1,88.0,0,0,0,1,1,Guinea
Amir Rrahmani,1,108.0,0,0,2,1,3,Kosovo
Amir Waithe,0,115.0,0,0,0,2,2,Dominica
Amit Ben-Shushan,1,95.0,0,0,1,1,2,Israel
Amjad Al-Harthi,1,75.0,0,0,0,1,1,China PR
Amjad Attwan,0,57.0,0,0,0,1,1,Cambodia
Amjad Kalaf,1,42.0,0,0,1,0,1,Iraq
Amleto Frignani,1,182.0,0,0,1,2,3,Egypt
Ammar Jemal,0,6.0,0,0,0,1,1,Kenya
Ammar Merrichkou,0,13.0,0,0,0,1,1,Ethiopia
Ammar Rihawi,1,66.0,0,0,0,1,1,Maldives
Ammo Yousif,0,6.0,0,0,0,1,1,Thailand
Amnon Aharonskind,1,70.0,0,0,1,0,1,Israel
Amor Jebali,0,89.0,0,0,0,1,1,Algeria
Amr Zaki,4,756.0,0,0,13,4,17,Libya
Amran Al-Hidi,0,90.0,0,0,1,0,1,Oman
Amredin Sharifi,1,47.0,0,0,0,1,1,Bangladesh
Amri Kiemba,0,28.0,0,0,1,1,2,Morocco
Américo Gallego,0,14.0,0,0,1,0,1,Argentina
Américo Galván,1,69.0,0,0,0,3,3,Chile
Amílcar Barbuy,1,198.0,0,1,4,0,4,Brazil
An Chol-Hyok,0,171.0,0,0,0,2,2,Bahrain
An Se-Uk,1,30.0,0,0,1,0,1,North Korea
An Yong-hak,0,122.0,0,0,2,0,2,North Korea
Anani Afanou,0,58.0,0,0,0,1,1,Senegal
Anas Al Khouja,0,57.0,1,0,1,0,1,Kuwait
Anas Al-Zboun,1,90.0,0,0,1,0,1,Jordan
Anas Bani Yaseen,1,26.0,0,0,0,1,1,Australia
Anas Elnour,0,52.0,0,0,1,0,1,Sudan
Anas Farah Ali,1,32.0,0,0,1,0,1,Djibouti
Anastasios Bakasetas,0,209.0,0,2,1,2,3,Spain
Anastasios Donis,0,80.0,0,0,0,1,1,Liechtenstein
Anastasios Douvikas,0,45.0,0,0,0,1,1,Kosovo
Anatoli Banişevski,0,245.0,0,0,0,5,5,Greece
Anatoli Ilyin,3,312.0,0,0,2,4,6,Russia
Anatoli Isayev,0,32.0,0,0,0,2,2,Finland
Anatolie Doroș,0,160.0,0,1,1,1,2,Moldova
Anatoliy Banishevskiy,1,354.0,0,0,4,2,6,North Korea
Anatoliy Byshovets,5,422.0,0,0,3,5,8,Russia
Anatoliy Demyanenko,1,163.0,0,0,3,1,4,Russia
Anatoliy Konkov,2,92.0,0,0,2,1,3,Hungary
Anbar Bashir Abubakr,0,82.0,0,1,1,0,1,Qatar
Anders Grönhagen,0,166.0,0,0,1,2,3,France
Anders Limpar,0,37.0,0,0,0,1,1,Israel
Anders Svensson,1,578.0,0,0,9,3,12,Azerbaijan
Andi Herzog,0,239.0,0,1,4,0,4,Austria
Andi Lala,0,26.0,0,0,0,1,1,Singapore
Andile Jali,0,169.0,0,1,1,1,2,Angola
Andoni Goikoetxea,0,65.0,0,0,0,1,1,Scotland
Andoni Goikoetxea Olaskoaga,1,68.0,0,1,0,1,1,Denmark
Andoni Zubizarreta,1,73.0,1,0,0,1,1,Spain
Andranik Eskandarian,1,43.0,1,0,0,1,1,Iran
Andranik Teymourian,0,271.0,0,0,2,2,4,Malaysia
Andraž Kirm,0,65.0,0,0,1,1,2,Slovenia
Andraž Struna,0,50.0,0,0,1,0,1,Slovenia
Andraž Šporar,0,162.0,0,0,1,2,3,Israel
Andre Boucaud,1,42.0,0,0,1,0,1,Trinidad and Tobago
Andre Espinoza,0,3.0,0,0,0,1,1,Jamaica
Andre Gray,0,159.0,0,0,1,1,2,Panama
Andre Hinds,0,166.0,0,0,2,2,4,Puerto Rico
Andre Kona N'Gole,1,90.0,0,0,0,1,1,Morocco
Andre Schembri,0,143.0,0,0,3,0,3,Malta
Andre Sinedo,1,79.0,0,0,0,1,1,Fiji
Andre Wabealo,1,11.0,0,0,0,1,1,Australia
Andre de Jong,1,75.0,0,0,1,0,1,New Zealand
Andrea Belotti,0,414.0,0,1,1,8,9,North Macedonia
Andrea Dossena,1,45.0,1,0,0,1,1,Italy
Andrea Pirlo,4,406.0,0,3,6,4,10,Italy
Andreas Andersson,0,120.0,0,0,1,1,2,Sweden
Andreas Avraam,0,134.0,0,0,1,1,2,Portugal
Andreas Bjelland,0,28.0,0,0,1,0,1,Denmark
Andreas Bonovas,0,63.0,0,0,1,0,1,Greece
Andreas Brehme,4,295.0,0,1,5,1,6,Germany
Andreas Christensen,1,176.0,0,0,1,2,3,Republic of Ireland
Andreas Cornelius,0,204.0,0,0,3,1,4,Czech Republic
Andreas Granqvist,2,408.0,0,5,4,3,7,Sweden
Andreas Heraf,0,55.0,0,0,0,1,1,Latvia
Andreas Herzog,1,934.0,0,5,13,4,17,Austria
Andreas Ivanschitz,0,299.0,0,1,4,2,6,Austria
Andreas Jakobsson,0,48.0,0,0,1,0,1,Sweden
Andreas Krause,0,11.0,0,0,1,0,1,German DR
Andreas Lava Olsen,0,82.0,0,0,0,1,1,Austria
Andreas Malin,0,80.0,1,0,1,0,1,Bosnia and Herzegovina
Andreas Möller,2,354.0,0,0,9,0,9,Germany
Andreas Niniadis,0,37.0,0,1,1,0,1,Greece
Andreas Ogris,1,241.0,0,0,3,2,5,Austria
Andreas Papaemmanouil,0,178.0,0,0,3,1,4,Greece
Andreas Ravelli,0,114.0,1,0,2,0,2,Sweden
Andreas Samaris,1,42.0,0,0,1,0,1,Greece
Andreas Skov Olsen,0,214.0,0,0,2,3,5,Austria
Andreas Sotiriou,0,187.0,0,0,4,2,6,Faroe Islands
Andreas Thom,0,615.0,0,0,5,6,11,Yugoslavia
Andrei Agius,0,89.0,1,0,1,1,2,Malta
Andrei Finonchenko,0,118.0,0,0,1,1,2,Kazakhstan
Andrei Fyodorov,0,219.0,0,2,3,1,4,Uzbekistan
Andrei Kanchelskis,0,246.0,0,0,3,2,5,Russia
Andrei Karpovich,0,34.0,0,0,1,0,1,Kazakhstan
Andrei Karyaka,0,168.0,1,0,2,3,5,Russia
Andrei Mostovoy,0,56.0,0,0,1,0,1,Russia
Andrei Piatnitski,0,14.0,0,0,0,1,1,Hungary
Andrei Sidorenkov,0,66.0,1,0,0,1,1,Estonia
Andrei Stepanov,0,27.0,0,0,1,0,1,Estonia
Andrei Zygmantovich,1,29.0,0,0,0,1,1,Cameroon
Andrej Kramarić,2,575.0,0,0,7,4,11,Croatia
Andrej Kvašňák,2,438.0,0,2,6,4,10,Czechoslovakia
Andrejs Cigaņiks,0,89.0,0,0,1,0,1,Latvia
Andrejs Perepļotkins,0,86.0,0,0,0,1,1,Luxembourg
Andrejs Prohorenkovs,0,166.0,0,0,1,2,3,Latvia
Andrejs Rubins,0,97.0,0,0,2,1,3,Scotland
Andrejs Štolcers,0,185.0,0,0,1,3,4,Norway
Andres Oper,0,906.0,0,0,10,7,17,Estonia
Andrew Hainault,0,54.0,0,0,0,1,1,Honduras
Andrew Lepani,3,155.0,0,0,0,4,4,American Samoa
Andrew Mobberley,1,35.0,0,0,1,1,2,Samoa
Andrew Murunga,0,53.0,0,0,0,1,1,Malawi
Andrew Robertson,0,91.0,0,0,1,1,2,Lithuania
Andrew Sinkala,0,35.0,0,0,0,1,1,Angola
Andrew Tembo,1,157.0,0,0,1,1,2,Zambia
Andrey Akopyants,1,82.0,0,0,0,1,1,Turkmenistan
Andrey Arshavin,2,678.0,0,0,5,8,13,Luxembourg
Andrey Galabinov,0,6.0,0,0,1,0,1,Bulgaria
Andrey Krasnov,0,92.0,0,0,1,0,1,Kyrgyzstan
Andrey Movsisyan,0,67.0,0,0,1,0,1,Armenia
Andrey Tikhonov,0,34.0,0,0,0,1,1,Luxembourg
Andrey Zhelyazkov,0,111.0,0,0,3,0,3,Bulgaria
Andrezinho,0,16.0,0,0,1,0,1,Azerbaijan
Andri Guðjohnsen,0,173.0,0,0,2,0,2,Iceland
Andri Sigthórsson,0,66.0,0,0,1,0,1,Iceland
Andrija Delibašić,0,373.0,0,0,4,2,6,Montenegro
Andrius Gedgaudas,0,90.0,0,0,1,0,1,Lithuania
Andrius Skerla,0,89.0,0,0,0,1,1,Faroe Islands
Andriy Bal,1,34.0,0,0,0,1,1,Brazil
Andriy Husin,0,504.0,0,0,2,5,7,Lithuania
Andriy Polunin,0,18.0,0,0,0,1,1,Italy
Andriy Rusol,1,124.0,0,0,1,2,3,Albania
Andriy Shevchenko,2,2073.0,0,5,20,20,40,Ukraine
Andriy Vorobey,0,290.0,0,0,4,0,4,Ukraine
Andriy Voronin,0,183.0,0,0,4,0,4,Ukraine
Andriy Yarmolenko,3,1126.0,0,2,13,12,25,Ukraine
Andronikos Kakoullis,0,89.0,0,0,0,1,1,Slovenia
Andros Townsend,0,150.0,0,0,2,0,2,England
Andrzej Buncol,1,123.0,0,0,2,0,2,Poland
Andrzej Iwan,0,6.0,0,0,1,0,1,Poland
Andrzej Jarosik,0,247.0,0,1,4,1,5,Poland
Andrzej Juskowiak,0,445.0,0,1,5,6,11,Poland
Andrzej Niedzielan,0,73.0,0,0,0,2,2,Hungary
Andrzej Pałasz,0,80.0,0,0,1,0,1,Poland
Andrzej Szarmach,7,536.0,0,0,7,6,13,Poland
András Schäfer,0,105.0,0,0,0,2,2,Germany
András Tóth,1,81.0,0,1,1,0,1,Hungary
András Törőcsik,0,96.0,0,0,1,2,3,Hungary
André Abegglen,4,262.0,0,0,0,4,4,Netherlands
André Ayew,13,861.0,0,4,8,8,16,Burkina Faso
André Bikey,0,11.0,0,0,0,1,1,Mauritius
André Biyogo Poko,0,11.0,0,0,0,1,1,Libya
André Carrillo,5,446.0,1,0,3,6,9,Chile
André De Nul,0,75.0,0,0,1,0,1,Belgium
André Egli,0,98.0,0,1,2,1,3,Norway
André Guy,0,80.0,0,0,0,2,2,Luxembourg
André Halter,0,57.0,0,0,1,0,1,Switzerland
André Kalonzo,1,70.0,0,0,1,0,1,DR Congo
André Kana-Biyik,3,370.0,0,0,2,5,7,Zambia
André Luiz Moreira,1,3.0,0,0,1,0,1,Brazil
André Maschinot,2,130.0,0,0,2,0,2,France
André Mbouta,1,81.0,0,0,1,0,1,Congo
André Onana,0,43.0,1,0,0,1,1,Cameroon
André Ooijer,0,64.0,0,0,2,0,2,Netherlands
André Piters,0,11.0,0,0,1,0,1,Belgium
André Schürrle,4,967.0,0,0,4,11,15,Azerbaijan
André Silva,1,558.0,0,0,3,8,11,Portugal
André van Herpe,0,9.0,0,0,0,1,1,Iceland
André-Frank Zambo Anguissa,2,117.0,0,0,1,2,3,Cameroon
André-Pierre Gignac,0,179.0,0,0,3,1,4,Faroe Islands
Andrés Andrade,0,14.0,0,0,0,1,1,Jamaica
Andrés Augusto Mendoza,0,86.0,0,0,0,1,1,Ecuador
Andrés Aurelio González,0,53.0,0,0,1,0,1,Peru
Andrés Cabrero,0,91.0,0,0,2,0,2,Puerto Rico
Andrés D'Alessandro,1,140.0,0,0,2,0,2,Argentina
Andrés Escobar,0,35.0,1,0,1,0,1,United States
Andrés Guardado,13,1094.0,0,4,11,9,20,United States
Andrés Iniesta,2,479.0,0,1,3,5,8,Spain
Andrés Martínez,1,45.0,0,0,1,0,1,Uruguay
Andrés Mendoza,0,171.0,0,0,2,1,3,Peru
Andrés Prieto,2,82.0,0,0,2,0,2,Chile
Andrés Scotti,0,77.0,0,0,1,0,1,Uruguay
Andrėjus Tereškinas,0,85.0,0,0,0,1,1,Latvia
Andualem Nigussie,0,118.0,0,0,2,0,2,Ethiopia
Andy Aleong,0,83.0,0,0,2,0,2,Trinidad and Tobago
Andy Baptiste,0,90.0,0,0,1,0,1,Saint Lucia
Andy Carroll,1,23.0,0,0,0,1,1,Sweden
Andy Cole,0,90.0,0,0,0,1,1,Albania
Andy Egli,0,75.0,0,0,1,1,2,Switzerland
Andy Furtado,0,107.0,0,0,2,0,2,Costa Rica
Andy Gray,0,103.0,0,0,1,1,2,Austria
Andy Herron,3,216.0,0,0,4,1,5,Costa Rica
Andy Jones,0,86.0,0,0,1,0,1,Wales
Andy Keogh,0,90.0,0,0,1,0,1,Republic of Ireland
Andy McEvoy,0,122.0,0,0,1,2,3,Spain
Andy Melville,0,181.0,1,0,1,3,4,Wales
Andy Najar,2,131.0,0,0,2,0,2,Honduras
Andy Reid,0,45.0,0,0,2,0,2,Republic of Ireland
Andy Selva,0,380.0,0,1,6,1,7,San Marino
Andy Sophie,0,134.0,0,1,1,1,2,Cape Verde
Andy Townsend,0,143.0,0,0,1,3,4,Poland
Andy Williams,3,381.0,0,3,2,6,8,Costa Rica
Anel Ahmedhodžić,0,77.0,0,0,0,1,1,Ukraine
Anfilogino Guarisi,0,40.0,0,0,1,0,1,Italy
Anfilogino Marques,1,16.0,0,0,1,0,1,Brazil
Angel Chiessa,1,10.0,0,0,1,0,1,Argentina
Angel Mussenden,0,35.0,1,0,1,0,1,Saint Vincent and the Grenadines
Angel Perucca,2,176.0,0,0,2,0,2,Argentina
Angel Rambert,0,17.0,0,0,1,0,1,France
Angelo Cijntje,0,90.0,0,0,1,0,1,Curaçao
Angelo Costanzo,1,83.0,0,0,1,0,1,Australia
Angelo Domenghini,1,358.0,0,0,6,1,7,Cyprus
Angelo Martina,1,11.0,0,0,1,0,1,Curaçao
Angelo Schiavio,0,206.0,0,0,4,0,4,Italy
Angelo Sormani,0,86.0,0,0,0,1,1,Turkey
Angelo Zimmerman,1,199.0,1,0,2,1,3,Curaçao
Angelos Basinas,0,262.0,0,4,2,3,5,Portugal
Angelos Charisteas,3,893.0,0,2,12,8,20,Greece
Angelos Tsolakis,0,89.0,0,0,0,1,1,Hungary
Anghel Iordănescu,0,349.0,0,2,4,3,7,Finland
Angus Eve,1,722.0,0,0,9,3,12,Dominican Republic
Ani Gome,1,7.0,0,0,0,1,1,Egypt
Anice Badri,0,78.0,0,0,0,1,1,DR Congo
Anicet Abel,1,86.0,0,0,1,1,2,Madagascar
Anicet Adjamossi,1,147.0,1,0,1,1,2,Madagascar
Anicet Yala Ngoukou,0,56.0,0,0,1,0,1,Gabon
Anil Gurung,0,19.0,0,2,2,0,2,Nepal
Anirudh Thapa,1,68.0,0,0,0,1,1,Thailand
Anis Ben Slimane,0,90.0,0,0,0,1,1,Zambia
Anjan Bista,1,69.0,0,1,1,2,3,Taiwan
Anjas Asmara,1,71.0,0,0,0,2,2,Iraq
Anon Nanok,0,30.0,0,0,1,0,1,Thailand
Ansi Agolli,0,78.0,0,0,1,0,1,Albania
Ansyari Lubis,0,58.0,0,0,2,0,2,Indonesia
Antal Dunai,0,110.0,0,0,2,3,5,Hungary
Antal Nagy,0,50.0,0,0,1,0,1,Hungary
Antal Róth,0,49.0,0,0,0,1,1,Cyprus
Antar Yahia,1,163.0,0,0,4,0,4,Algeria
Ante Juric,1,36.0,0,0,1,0,1,Australia
Ante Milicic,1,28.0,0,0,2,1,3,Australia
Ante Razov,0,209.0,0,0,2,2,4,Guatemala
Ante Rebić,1,66.0,0,0,0,2,2,Argentina
Ante Žanetić,0,55.0,0,0,0,1,1,France
Anteneh Alameraw,0,48.0,0,0,1,0,1,Ethiopia
Anthonie van der Linden,0,11.0,0,0,1,0,1,Netherlands
Anthony Abrams,0,73.0,0,0,0,1,1,Barbados
Anthony Annan,0,83.0,0,0,1,0,1,Ghana
Anthony Augustine,0,72.0,0,0,1,0,1,Grenada
Anthony Contreras,0,89.0,0,0,1,1,2,El Salvador
Anthony Dominique,0,8.0,0,0,1,0,1,Dominica
Anthony Hernandez,1,30.0,0,0,1,0,1,Gibraltar
Anthony Laffor,0,50.0,0,0,1,0,1,Liberia
Anthony Lozano,0,147.0,0,0,1,2,3,El Salvador
Anthony Martial,0,50.0,0,0,0,1,1,Ukraine
Anthony Modeste,0,233.0,0,0,1,2,3,Barbados
Anthony Rougier,0,21.0,0,0,2,0,2,Trinidad and Tobago
Anthony Réveillère,0,66.0,0,0,1,0,1,France
Anthony Straker,0,33.0,0,1,1,0,1,Grenada
Anthony Yeboah,1,29.0,0,0,1,0,1,Ghana
Anthony van den Hurk,0,17.0,0,0,1,0,1,Curaçao
Antoine Griezmann,4,1142.0,0,6,18,6,24,France
Antoine Kohn,0,6.0,0,0,1,0,1,Luxembourg
Antoine Mocude,0,64.0,0,0,1,0,1,Mauritius
Antolín Alcaraz,2,71.0,0,0,1,1,2,Italy
Anton Allemann,0,124.0,0,0,2,0,2,Switzerland
Anton Camilleri,0,20.0,0,0,1,0,1,Malta
Anton Doboş,0,35.0,0,0,0,1,1,Liechtenstein
Anton Haven,0,28.0,0,0,1,1,2,Anguilla
Anton Jongsma,0,15.0,0,0,0,1,1,Nicaragua
Anton Miranchuk,0,41.0,0,0,1,0,1,Russia
Anton Moravčík,0,23.0,0,0,0,1,1,German DR
Anton Ondruš,2,99.0,1,0,1,2,3,Portugal
Anton Polster,0,138.0,0,0,2,0,2,Austria
Anton Putsila,0,145.0,0,0,1,1,2,Belarus
Anton Rogan,0,30.0,1,0,1,0,1,Spain
Anton Saroka,0,44.0,0,0,0,1,1,France
Anton Schall,1,93.0,0,0,1,0,1,Austria
Anton Silva,1,14.0,0,0,1,0,1,Sri Lanka
Anton Weibel,0,77.0,1,0,0,1,1,Switzerland
Anton Zabolotny,0,82.0,0,0,1,0,1,Russia
Anton Zemlianukhin,0,188.0,0,1,2,2,4,Bangladesh
Anton Žlogar,0,83.0,0,0,1,0,1,Slovenia
Antonee Robinson,0,100.0,0,0,1,1,2,Honduras
Antonhy Stanton,0,43.0,0,0,1,0,1,Guyana
Antoni Lima Solá,0,80.0,0,0,0,1,1,Bulgaria
Antonio Alzamendi,3,271.0,0,0,1,4,5,Uruguay
Antonio Angelillo,0,69.0,0,0,1,0,1,Italy
Antonio Blanco,1,80.0,0,0,1,0,1,Argentina
Antonio Cabrini,1,189.0,0,1,3,0,3,Italy
Antonio Campolo,1,48.0,0,0,0,1,1,Brazil
Antonio Candreva,0,183.0,0,2,1,4,5,Italy
Antonio Cassano,3,373.0,0,0,7,2,9,Italy
Antonio Cerroti,0,41.0,0,0,1,0,1,Argentina
Antonio Conte,1,122.0,0,0,0,2,2,Denmark
Antonio Di Natale,2,358.0,0,0,0,6,6,Ukraine
Antonio Flores,0,78.0,0,0,2,0,2,Mexico
Antonio González,1,11.0,0,0,0,1,1,Venezuela
Antonio Gómez,0,89.0,0,0,0,1,1,Uruguay
Antonio López Guerrero,0,1.0,0,0,0,1,1,San Marino
Antonio Maceda,2,319.0,0,0,2,4,6,Republic of Ireland
Antonio Martina,1,90.0,0,0,1,0,1,Curaçao
Antonio Muñoz Gómez,0,18.0,0,0,0,1,1,Albania
Antonio Pacheco D'Agosti,1,90.0,0,0,0,1,1,United Arab Emirates
Antonio Rada,1,226.0,0,1,3,0,3,Colombia
Antonio Ravelo,2,173.0,0,0,1,1,2,Bolivia
Antonio Rüdiger,0,88.0,0,0,1,1,2,Germany
Antonio Sacco,0,123.0,0,0,0,2,2,Peru
Antonio Sanabria,0,130.0,0,0,1,1,2,Colombia
Antonio Sardina,0,17.0,0,0,0,1,1,Gabon
Antonio Sastre,1,53.0,0,0,1,0,1,Argentina
Antonio Urdinarán,2,45.0,0,2,0,2,2,Brazil
Antonio Valencia,2,353.0,0,0,6,2,8,Ecuador
Antonio Valentín Angelillo,8,289.0,0,0,8,0,8,Argentina
Antonio Zelaya,0,86.0,0,0,1,0,1,Honduras
Antonio de Miguel,2,126.0,0,0,2,0,2,Argentina
Antonio de Nigris,0,33.0,0,0,2,0,2,Mexico
Antonio dos Santos,0,1.0,0,0,1,0,1,Cuba
Antonis Antoniadis,0,139.0,0,1,2,2,4,Spain
Antonis Migiakis,1,73.0,0,0,0,1,1,Israel
Antony,0,176.0,0,0,1,1,2,Venezuela
Antony de Ávila,4,363.0,0,0,4,3,7,Venezuela
Antonín Barák,1,168.0,0,0,1,4,5,San Marino
Antonín Panenka,3,449.0,0,5,9,2,11,Czechoslovakia
Antonín Puč,1,121.0,0,0,1,1,2,Czechoslovakia
Antti Sumiala,0,429.0,0,1,4,3,7,Finland
Antwan Russell,0,52.0,0,0,1,0,1,Bermuda
António Dias Teixeira,0,81.0,0,0,1,0,1,Portugal
António Folha,0,148.0,0,0,1,1,2,Estonia
António Luís Alves Ribeiro Oliveira,0,175.0,0,0,1,1,2,Finland
António Mendonça,0,84.0,0,0,1,0,1,Angola
António Neto,0,44.0,0,0,0,1,1,Zimbabwe
António Nogueira,0,1.0,0,0,1,0,1,Portugal
António Simões,1,104.0,0,0,1,1,2,Brazil
António Sousa,1,52.0,0,0,1,0,1,Portugal
Antônio Almeida,1,72.0,0,0,1,0,1,Brazil
Antônio Carlos Zago,0,77.0,0,0,1,1,2,Brazil
Anvarjon Soliev,0,306.0,0,0,4,0,4,Uzbekistan
Anwar Ahmed,0,8.0,0,0,0,1,1,Brunei
Anwar Jackaria,0,17.0,0,0,0,1,1,Kenya
Anwar Shakunda,1,86.0,0,0,1,0,1,Somalia
Anzur Ismailov,0,117.0,0,0,2,1,3,Uzbekistan
Aníbal Ciocca,3,184.0,0,0,2,3,5,Chile
Aníbal Godoy,1,225.0,1,0,3,1,4,Costa Rica
Aníbal Médicis Candiota,1,46.0,0,0,1,0,1,Brazil
Aníbal Tarabini,0,43.0,0,0,0,1,1,Bolivia
Ao Tanaka,1,59.0,0,0,2,0,2,Japan
Aples Tecuari,0,73.0,0,0,1,0,1,Indonesia
Apostolos Giannou,1,90.0,0,0,0,1,1,Palestine
Ara Hakobyan,0,177.0,0,0,1,2,3,Armenia
Aram Ayrapetyan,0,80.0,1,0,0,1,1,Armenia
Aram Hakobyan,0,52.0,0,0,0,1,1,Andorra
Aras Özbiliz,0,139.0,0,0,2,1,3,Denmark
Arash Afshin,1,67.0,0,0,0,1,1,United Arab Emirates
Arash Borhani,0,147.0,0,0,1,1,2,Qatar
Araz Abdullayev,0,24.0,0,0,1,0,1,Azerbaijan
Arben Minga,0,86.0,0,0,1,0,1,Albania
Arbër Zeneli,0,61.0,0,0,1,0,1,Kosovo
Arcadia Martin Wesay Toe,0,54.0,0,0,0,1,1,Mali
Archie Gemmill,2,417.0,0,3,4,2,6,Scotland
Archie Robertson,0,29.0,0,0,1,0,1,Scotland
Archie Thompson,1,1180.0,0,0,18,3,21,Australia
Archil Arveladze,0,205.0,0,0,2,1,3,Georgia
Arda Turan,1,697.0,0,0,8,3,11,Switzerland
Ardian Kozniku,0,81.0,0,0,1,0,1,Croatia
Aref Al Agha,2,74.0,0,0,0,2,2,Maldives
Aref Al-Shewaier,1,73.0,0,0,0,1,1,Yemen
Arfon Griffiths,0,234.0,0,0,3,1,4,Austria
Argenis Tortolero,0,40.0,0,0,1,0,1,Venezuela
Argjend Beqiri,0,75.0,0,0,1,0,1,North Macedonia
Argo Arbeiter,0,90.0,0,0,0,1,1,Czech Republic
Ari Hjelm,0,284.0,0,0,4,3,7,Turkey
Ari Mäkynen,0,82.0,0,1,1,0,1,Finland
Ari Valvee,0,209.0,0,0,2,1,3,Austria
Ariagner Smith,2,53.0,0,0,0,2,2,Turks and Caicos Islands
Arie Haan,2,120.0,0,0,1,2,3,Netherlands
Ariel Francisco Rodríguez,1,4.0,0,0,1,0,1,Costa Rica
Ariel Graziani,3,526.0,0,0,3,7,10,Ecuador
Ariel Lassiter,1,21.0,0,0,1,0,1,Costa Rica
Ariel Martínez,3,183.0,0,0,3,0,3,Cuba
Ariel Ortega,3,338.0,0,0,5,5,10,Japan
Ariel Álvarez,0,56.0,0,0,1,0,1,Cuba
Arif Erdem,0,513.0,0,0,4,5,9,San Marino
Arif Kocabıyık,0,86.0,0,0,1,0,1,Turkey
Arif Mirzoyev,0,80.0,0,0,1,0,1,Turkmenistan
Arijan Ademi,0,284.0,0,0,1,3,4,Slovakia
Aristide Bancé,4,554.0,0,1,6,3,9,Burundi
Aritatsu Ogi,1,68.0,1,0,0,1,1,Japan
Aritz Aduriz,0,85.0,0,0,1,0,1,Spain
Ariza Makukula,0,84.0,0,0,0,1,1,Kazakhstan
Arj Changatamilman,0,31.0,0,0,1,0,1,Singapore
Arjan Bellaj,0,25.0,0,0,0,1,1,Moldova
Arjan Beqaj,0,42.0,1,0,1,0,1,Netherlands
Arjen Robben,8,1010.0,0,1,12,10,22,Netherlands
Arkadiusz Głowacki,0,57.0,1,0,0,1,1,Poland
Arkadiusz Milik,1,594.0,0,0,8,2,10,Poland
Arlindo Gomes Semedo,0,237.0,0,0,5,0,5,Cape Verde
Arman Karamyan,0,27.0,0,0,0,1,1,Northern Ireland
Armand Djerabe,0,47.0,0,0,1,0,1,Chad
Armand Jurion,0,82.0,0,1,1,1,2,Yugoslavia
Armand Muller,0,3.0,0,0,1,0,1,Luxembourg
Armand Penverne,0,40.0,0,0,0,1,1,Republic of Ireland
Armando Alonso,0,167.0,0,0,1,2,3,Grenada
Armando Broja,0,228.0,0,0,2,1,3,Albania
Armando Contreras,0,44.0,0,0,1,1,2,Chile
Armando Cooper,1,103.0,0,0,2,1,3,Jamaica
Armando Cruz,0,79.0,0,1,0,1,1,Haiti
Armando Macamo,0,25.0,0,0,1,0,1,Mozambique
Armando Sadiku,1,251.0,0,0,2,5,7,Albania
Armando Tapia,1,77.0,0,0,1,0,1,Bolivia
Armando Tobar,1,77.0,0,0,1,0,1,Chile
Armands Zeiberliņš,0,230.0,0,0,2,1,3,Northern Ireland
Armel Disney,0,222.0,0,0,4,0,4,Congo
Armen Shahgeldyan,0,313.0,0,1,2,3,5,Armenia
Armend Dallku,0,90.0,0,0,1,0,1,Albania
Armin Hodžić,0,209.0,0,0,1,2,3,Bosnia and Herzegovina
Armin Krings,0,28.0,0,0,0,1,1,Republic of Ireland
Arminas Narbekovas,0,96.0,0,0,1,1,2,Northern Ireland
Arnaldo Owanga,0,50.0,0,0,1,0,1,Mozambique
Arnar Gunnlaugsson,0,3.0,0,0,0,1,1,Sweden
Arnar Viðarsson,0,6.0,0,0,1,0,1,Iceland
Arnaut Danjuma,0,75.0,0,0,1,0,1,Netherlands
Arnbjørn Hansen,0,150.0,0,0,3,0,3,Faroe Islands
Arne Brustad,1,83.0,0,0,0,1,1,Italy
Arne Friedrich,1,169.0,2,0,1,2,3,Germany
Arne Larsen Økland,0,205.0,0,0,1,3,4,Belgium
Arne Nyberg,3,123.0,0,0,0,3,3,Cuba
Arne Pedersen,0,16.0,0,0,1,0,1,Norway
Arne Selmosson,0,26.0,0,0,1,0,1,Sweden
Arno Bertogna,1,90.0,0,0,1,0,1,Australia
Arnold Bouka Moutou,0,87.0,0,0,0,1,1,Egypt
Arnold Cruz,0,19.0,0,0,1,0,1,Honduras
Arnold Dwarika,2,491.0,0,2,6,3,9,United States
Arnold Mühren,0,151.0,0,1,3,0,3,Netherlands
Arnold Wetl,0,226.0,1,0,2,1,3,Austria
Arnoldo Iguarán,8,701.0,0,0,8,6,14,Colombia
Arnulfo Valentierra,0,67.0,0,0,0,1,1,Uruguay
Arnór Guðjohnsen,0,317.0,0,0,5,1,6,Iceland
Arnór Ingvi Traustason,1,90.0,0,0,1,0,1,Iceland
Arnór Sigurðsson,0,38.0,0,0,1,0,1,Iceland
Aron Gunnarsson,0,137.0,0,0,1,1,2,Latvia
Aron Jóhannsson,0,122.0,0,0,1,1,2,Panama
Aron Winter,1,270.0,0,0,2,2,4,Malta
Arouna Koné,0,43.0,0,0,0,1,1,Egypt
Arsen Avakov,0,131.0,0,0,3,1,4,Vietnam
Arsenio Luzardo,0,68.0,0,0,1,0,1,Uruguay
Arshad Al-Alawi,0,90.0,0,0,2,0,2,Oman
Arslanmyrat Amanow,1,414.0,0,0,2,5,7,Indonesia
Art Hughes,0,135.0,0,0,2,0,2,Canada
Art Welch,0,70.0,0,0,1,0,1,Jamaica
Artak Grigoryan,0,50.0,0,0,1,0,1,Armenia
Artem Besyedin,0,165.0,0,0,0,2,2,Finland
Artem Dovbyk,1,289.0,0,0,0,3,3,Sweden
Artem Dzyuba,0,1377.0,0,4,14,10,24,Russia
Artem Fedetskiy,0,158.0,0,0,1,1,2,Montenegro
Artem Kontsevoy,0,87.0,0,0,0,1,1,Wales
Artem Kravets,1,226.0,0,0,4,2,6,Ukraine
Artem Milevskyi,0,135.0,0,1,2,0,2,Ukraine
Arthur Fitzsimons,0,97.0,0,0,2,0,2,Republic of Ireland
Arthur Friedenreich,2,308.0,0,0,6,1,7,Brazil
Arthur Melo,0,33.0,0,0,0,1,1,Uruguay
Arthur Minasyan,0,39.0,0,0,1,0,1,Armenia
Arthur Moses,0,89.0,0,0,1,0,1,Ghana
Artim Šakiri,0,352.0,0,1,6,3,9,North Macedonia
Artiom Rudņev,0,83.0,0,0,1,0,1,Latvia
Arto Tolsa,0,128.0,0,0,2,1,3,Yugoslavia
Artur Correia,0,37.0,0,0,1,0,1,Portugal
Artur Geworkýan,0,156.0,0,0,3,0,3,Turkmenistan
Artur Ioniță,0,73.0,0,0,0,1,1,Montenegro
Artur Jorge,0,46.0,0,0,1,0,1,Portugal
Artur Petrosyan,0,454.0,0,0,5,4,9,Denmark
Artur Sarkisov,0,250.0,0,0,1,2,3,Slovakia
Artur Wichniarek,0,45.0,0,0,0,1,1,Luxembourg
Arturo Arrieta,1,49.0,0,0,1,0,1,Argentina
Arturo Carmona,2,78.0,0,0,1,1,2,Argentina
Arturo Mendoza,1,52.0,0,0,0,1,1,Argentina
Arturo Mina,1,128.0,1,0,2,0,2,Ecuador
Arturo Norambuena,0,70.0,0,0,1,0,1,Chile
Arturo Tardío,1,84.0,0,0,1,0,1,Bolivia
Arturo Vidal,5,1299.0,1,6,15,10,25,Chile
Arturo Vázquez Ayala,1,45.0,0,1,1,0,1,Mexico
Arturo Álvarez,1,146.0,0,0,2,0,2,El Salvador
Artyom Filiposyan,0,44.0,1,0,0,1,1,Uzbekistan
Artýom Nazarow,0,70.0,0,0,0,1,1,Sri Lanka
Artūras Fomenka,0,169.0,0,0,2,0,2,Lithuania
Artūrs Zjuzins,0,182.0,0,0,2,1,3,Latvia
Aruna Dindane,3,475.0,0,1,6,4,10,Ivory Coast
Arvydas Novikovas,0,434.0,0,3,3,3,6,San Marino
Ary Papel,0,56.0,0,0,1,0,1,Angola
Arístides Rojas,0,165.0,0,0,2,1,3,Uruguay
Arístides del Puerto,1,74.0,0,0,2,0,2,Paraguay
Arūnas Šuika,0,124.0,0,0,3,0,3,Lithuania
Asa Hartford,0,35.0,0,0,1,0,1,Scotland
Asadhulla Abdulla,0,37.0,0,0,1,0,1,Maldives
Asam Duraiban,1,16.0,0,0,1,0,1,Yemen
Asamoah Gyan,12,1198.0,0,4,10,14,24,Ghana
Aschalew Tamene,0,90.0,0,1,1,0,1,Ethiopia
Asher Welch,0,11.0,0,0,1,0,1,Jamaica
Ashish Bhadra,0,15.0,0,0,0,1,1,India
Ashkan Dejagah,2,211.0,0,3,6,0,6,Iran
Ashley Grimes,0,2.0,0,0,1,0,1,Republic of Ireland
Ashley Rambanapasi,0,78.0,0,0,1,0,1,Zimbabwe
Ashley Williams,1,79.0,1,0,1,1,2,Wales
Ashley Young,0,136.0,0,0,2,2,4,England
Ashraf Luthfy,0,82.0,0,0,1,0,1,Maldives
Ashraf Uddin Ahmed Chunnu,1,213.0,0,0,2,1,3,North Korea
Asier Illarramendi,0,76.0,0,0,0,1,1,Israel
Asier del Horno,0,75.0,0,0,1,0,1,Spain
Asimakis Krassas,0,95.0,0,0,0,1,1,Faroe Islands
Askhat Kadyrkulov,1,82.0,0,0,0,1,1,Nepal
Asmeron Germa,0,180.0,0,0,2,0,2,Ethiopia
Asnake Tenkir,0,50.0,0,0,1,0,1,Ethiopia
Asparuh Nikodimov,1,12.0,0,0,1,0,1,Bulgaria
Assad Ghani,0,65.0,0,0,1,0,1,Maldives
Assan Ceesay,0,65.0,0,0,0,1,1,Angola
Assan Sarr,0,90.0,0,0,0,1,1,Libya
Assani Bajope,0,17.0,0,0,1,0,1,Uganda
Astrit Ziu,0,22.0,0,0,0,1,1,Turkey
Asuquo Ekpe,1,78.0,0,0,0,1,1,Egypt
Atanas Iliev,0,39.0,0,0,0,1,1,Italy
Atanas Mihaylov,0,84.0,0,0,1,1,2,Bulgaria
Atdhe Nuhiu,1,102.0,0,0,1,1,2,Kosovo
Athanas Tendeng,1,50.0,0,0,1,0,1,Senegal
Athuman Iddy,0,5.0,0,0,1,0,1,Tanzania
Ati Kepo,2,133.0,0,0,0,2,2,Fiji
Atiba Harris,0,87.0,0,0,1,1,2,Saint Kitts and Nevis
Atiba Hutchinson,1,370.0,1,0,4,2,6,Honduras
Atik Ismail,0,202.0,0,0,4,0,4,Finland
Atilio Ancheta,0,76.0,0,0,1,0,1,Uruguay
Atilio Cremaschi,8,453.0,0,0,6,2,8,Chile
Atilio García,5,255.0,0,0,0,5,5,Ecuador
Atilio López,4,103.0,0,0,2,2,4,Paraguay
Atkin Kaua,1,32.0,0,0,1,1,2,Solomon Islands
Atli Eðvaldsson,1,441.0,0,0,5,2,7,Iceland
Atnesh Prasad,2,170.0,0,0,0,2,2,Samoa
Ats Purje,0,167.0,0,0,1,1,2,Slovenia
Atsuhiro Miura,1,77.0,0,0,0,1,1,Peru
Atsushi Yanagisawa,3,105.0,0,0,1,2,3,Saudi Arabia
Atsuto Uchida,1,140.0,1,0,2,0,2,Japan
Attila Abonyi,2,235.0,0,1,4,2,6,Australia
Attila Fiola,0,90.0,0,0,1,1,2,Andorra
Attila Korsós,0,117.0,0,0,2,0,2,Hungary
Attila Pinte,0,80.0,0,0,0,1,1,North Macedonia
Attila Pintér,0,120.0,0,0,2,0,2,Hungary
Attilio Lombardo,0,56.0,0,0,0,2,2,Cyprus
Atusaye Nyondo,0,70.0,0,0,0,1,1,Djibouti
Au Chi Yin,0,78.0,0,0,2,0,2,Hong Kong
Au Wai Lun,1,166.0,0,0,2,1,3,Hong Kong
Au-yeong Pak Kuan,0,90.0,0,0,1,0,1,Singapore
Audel Laville,1,82.0,0,0,1,0,1,Dominica
Audrius Kšanavičius,0,142.0,0,0,0,2,2,Georgia
Audrius Žuta,0,87.0,0,0,0,1,1,Slovenia
August Foe a Man,0,45.0,0,0,1,0,1,Suriname
August Starek,0,177.0,0,0,0,4,4,Scotland
Augustine Ahinful,0,109.0,0,0,2,0,2,Ghana
Augustine Ofuokwu,0,90.0,0,0,0,1,1,Cameroon
Augustine Peli,0,146.0,0,0,0,2,2,Tonga
Augusto Espinoza,0,151.0,0,0,2,1,3,Guatemala
Augusto da Costa,0,15.0,0,0,1,0,1,Brazil
Aung Khin,1,80.0,0,0,1,0,1,Myanmar
Aung Thu,1,171.0,0,0,2,1,3,Myanmar
Aurel Ţicleanu,0,67.0,0,0,1,0,1,Romania
Aurelien Bekogo,1,34.0,0,0,0,1,1,DR Congo
Aurelijus Skarbalius,0,61.0,0,0,0,1,1,Ukraine
Aurelio Domínguez,0,60.0,0,0,1,0,1,Chile
Aurelio González,6,410.0,0,0,6,1,7,Paraguay
Aurelio Martínez,0,57.0,0,0,0,1,1,Colombia
Aurelio Vidmar,0,373.0,0,1,9,1,10,Australia
Aurélien Chedjou,1,104.0,1,0,1,1,2,Cameroon
Aurélien Joachim,0,454.0,0,1,3,4,7,Luxembourg
Aurélien Tchouaméni,1,17.0,0,0,0,1,1,England
Ausberto García,1,334.0,0,0,6,0,6,Bolivia
Austin Berry,1,22.0,0,1,2,1,3,Costa Rica
Austin Huggins,0,108.0,0,0,2,1,3,Saint Kitts and Nevis
Austin Makacha,0,40.0,0,0,0,1,1,Namibia
Avdija Vršajević,1,135.0,0,0,2,0,2,Bosnia and Herzegovina
Avelino Salvador Maluana,1,57.0,0,0,0,1,1,Zambia
Avi Cohen,0,54.0,0,0,1,1,2,Israel
Avi Nimni,0,289.0,0,1,0,6,6,Austria
Avi Yehiel,0,39.0,0,0,0,1,1,Republic of Ireland
Aviram Baruchyan,0,15.0,0,0,1,0,1,Israel
Avondale Williams,0,229.0,0,1,1,2,3,British Virgin Islands
Avraam Papadopoulos,0,90.0,1,0,0,1,1,Greece
Avraham Menchel,1,32.0,0,0,1,0,1,Israel
Avraham Nudelmann,0,61.0,0,0,0,1,1,Egypt
Awad Koka,0,70.0,0,0,1,0,1,Sudan
Awad Ragheb,0,90.0,0,0,1,0,1,Jordan
Awer Mabil,4,94.0,0,0,3,1,4,Palestine
Axel Méyé,0,103.0,0,0,0,2,2,Ivory Coast
Axel Temataua,3,120.0,0,0,3,0,3,Tahiti
Axel Witsel,2,228.0,0,0,2,4,6,Austria
Ayad Al-Qadi,0,70.0,0,1,1,0,1,Libya
Ayad El-Ghadi,0,30.0,0,0,1,0,1,Libya
Ayan Sadakov,0,87.0,0,0,0,2,2,Luxembourg
Aydın Yelken,0,60.0,0,0,1,0,1,Turkey
Ayedi Hamrouni,0,181.0,0,0,3,0,3,Tunisia
Ayel Mayélé,0,43.0,0,0,1,1,2,Mozambique
Ayhan Elmastaşoğlu,0,43.0,0,0,1,1,2,Czechoslovakia
Ayila Yussuf,0,62.0,0,0,1,0,1,Nigeria
Ayman Al Husaini,0,8.0,0,0,0,1,1,Malaysia
Ayman Mansour,1,25.0,0,0,1,1,2,Togo
Ayman Younes,1,58.0,0,0,1,0,1,Egypt
Aymen Abdennour,0,58.0,0,0,1,0,1,Tunisia
Aymen Barkok,0,20.0,0,0,1,0,1,Morocco
Aymen Hussein,2,188.0,0,0,1,3,4,Iraq
Aymeric Laporte,0,45.0,0,0,1,0,1,Spain
Ayoub El Kaabi,0,223.0,0,0,5,0,5,Morocco
Ayrton Preciado,2,84.0,0,0,1,1,2,Venezuela
Aytec Genc,0,4.0,0,0,1,0,1,Australia
Ayub Masika,0,23.0,0,0,0,1,1,Mauritius
Azamat Ishenbaev,0,55.0,0,0,1,0,1,Kyrgyzstan
Azinho Solomon,1,86.0,0,0,1,0,1,Saint Vincent and the Grenadines
Aziz Behich,1,166.0,2,0,2,0,2,France
Aziz Bouderbala,0,176.0,0,0,2,1,3,Morocco
Aziz Bouhaddouz,2,104.0,1,0,1,1,2,Morocco
Aziz Ibrahimov,0,147.0,0,0,0,2,2,Malaysia
Aziz Mashaan,1,61.0,0,0,1,0,1,Kuwait
Azizbek Haydarov,1,7.0,0,0,0,1,1,Yemen
Azizol Abu Haniffah,2,183.0,0,0,3,1,4,Malaysia
Azmahar Ariano,0,69.0,0,0,1,0,1,Panama
Azman Adnan,2,249.0,0,0,5,2,7,Malaysia
Azubuike Egwuekwe,0,89.0,0,0,0,1,1,Malawi
Azzedine Ounahi,0,75.0,0,0,2,0,2,Morocco
Azər Salahlı,0,82.0,0,0,1,0,1,Azerbaijan
Aïssa Laïdouni,0,18.0,0,0,1,0,1,Tunisia
Aïssa Mandi,1,83.0,1,0,0,2,2,Algeria
Baba Adamu,1,90.0,0,0,1,0,1,Ghana
Baba Otu Mohammed,3,129.0,0,0,2,1,3,Nigeria
Babacar Gueye,0,21.0,0,0,1,0,1,Senegal
Babatounde Bello,0,137.0,0,0,2,0,2,Benin
Babiker Santo,0,170.0,0,0,1,2,3,Zambia
Babkin Melikian,0,117.0,0,0,1,1,2,Lebanon
Baboucar Sowe,0,22.0,0,0,1,0,1,Gambia
Bachirou Osseni,0,12.0,0,0,0,1,1,Libya
Bachirou Salou,0,29.0,0,0,2,0,2,Togo
Backer Aloenouvo,0,90.0,0,0,1,0,1,Togo
Badal Das,0,76.0,0,0,1,0,1,Bangladesh
Badar Al-Mahrouqi,0,89.0,0,0,1,0,1,Oman
Badar Al-Maimani,1,235.0,0,0,4,1,5,Oman
Badawi Abdel Fattah,1,160.0,0,0,1,2,3,Egypt
Baddrol Bakhtiar,0,59.0,0,0,1,0,1,Malaysia
Bader Al-Mutawa,6,766.0,0,4,8,6,14,Malaysia
Badr Abdul Hameed Bo Abbas,0,76.0,0,0,1,0,1,Kuwait
Badr Haji,1,84.0,0,1,0,1,1,Indonesia
Badran Al-Shagran,0,286.0,0,0,2,3,5,Uzbekistan
Baghdad Bounedjah,2,130.0,0,2,2,2,4,Algeria
Baha' Abdel-Rahman,2,130.0,0,0,3,0,3,Jordan
Baha' Faisal,2,320.0,0,1,4,3,7,Jordan
Bahodir Nasimov,0,290.0,0,0,2,2,4,Kyrgyzstan
Bahtiyor Kambaraliev,0,30.0,0,0,1,0,1,Uzbekistan
Bai He,0,87.0,0,0,1,0,1,Hong Kong
Bai Malleh Wadda,0,81.0,0,0,1,0,1,Gambia
Baichung Bhutia,0,88.0,0,1,2,0,2,India
Baihakki Khaizan,0,62.0,1,0,1,0,1,Lebanon
Bajram Franholli,0,57.0,0,0,1,0,1,Albania
Bakalevu Moceimereke,0,209.0,0,0,3,0,3,Fiji
Bakar Ibor,0,53.0,0,1,0,1,1,Madagascar
Bakari Koné,3,433.0,0,0,3,4,7,Ivory Coast
Bakary Koné,1,82.0,1,0,1,0,1,Ivory Coast
Bakary Sako,1,37.0,0,0,1,1,2,Ivory Coast
Bakary Traoré,1,10.0,0,0,1,0,1,Mali
Bakaye Traoré,1,30.0,0,0,1,0,1,Mali
Bakhit Alabadla,0,60.0,0,0,0,1,1,Uzbekistan
Bakhtiyar Duyshobekov,0,7.0,0,0,1,0,1,Kyrgyzstan
Bakhtiyar Zaynutdinov,0,181.0,0,0,1,3,4,Kazakhstan
Bakhtiyor Ashurmatov,0,6.0,0,0,1,0,1,Uzbekistan
Bako,1,76.0,0,0,0,1,1,Tahiti
Bako Touré,2,117.0,0,0,2,0,2,Mali
Bakri Almadina,0,2.0,0,0,1,0,1,Sudan
Bakri Ibni,1,78.0,0,0,1,0,1,Malaysia
Bal Gopal Maharjan,1,52.0,0,0,0,1,1,Macau
Balal Arezou,0,63.0,0,0,0,1,1,Palestine
Baltazar,4,567.0,0,0,8,3,11,Brazil
Baltazar Maria de Morais Júnior,0,57.0,0,0,1,0,1,Brazil
Balázs Dzsudzsák,2,641.0,0,3,7,3,10,Hungary
Bamba Dieng,1,174.0,0,0,1,1,2,Senegal
Bambang Nurdiansyah,0,149.0,0,0,3,1,4,Indonesia
Bambang Pamungkas,0,262.0,0,0,3,1,4,Indonesia
Banana Yaya,1,156.0,0,0,1,1,2,Zambia
Banou Diawara,0,179.0,0,0,2,0,2,Burkina Faso
Barak Yitzhaki,0,11.0,0,0,0,1,1,North Macedonia
Barrios Zapata,0,3.0,0,0,1,0,1,Honduras
Barry Ferguson,0,148.0,0,0,1,1,2,Faroe Islands
Barry Hulshoff,0,149.0,0,0,2,1,3,Netherlands
Barry Hunter,0,53.0,0,0,1,0,1,Northern Ireland
Barry Opdam,0,38.0,0,0,0,1,1,Czech Republic
Bart Goor,0,309.0,0,0,6,0,6,Belgium
Bart McGhee,1,23.0,0,0,0,1,1,Belgium
Bartosz Bosacki,2,98.0,0,0,0,2,2,Costa Rica
Bartosz Kapustka,0,82.0,0,0,1,1,2,Poland
Bartosz Karwan,0,250.0,0,0,2,1,3,Norway
Basam Al-Khateeb,1,88.0,0,0,1,0,1,Jordan
Basanta Thapa,2,121.0,0,0,1,1,2,Nepal
Basaula Lemba,1,48.0,0,0,0,1,1,Mali
Basel Abdul Rahim,1,84.0,0,1,0,1,1,Macau
Basem Fathi,0,85.0,0,0,0,1,1,China PR
Bashar Abdulaziz,0,154.0,0,0,1,2,3,Saudi Arabia
Bashar Abdullah,3,542.0,0,0,8,2,10,Kuwait
Bashar Bani Yaseen,1,112.0,0,0,0,2,2,Uzbekistan
Bashar Rashid,1,10.0,0,0,1,0,1,Iraq
Bashar Resan,2,42.0,0,0,1,1,2,Yemen
Bashar Srour,0,365.0,0,1,8,0,8,Syria
Basheer Saeed,1,308.0,1,0,4,1,5,Kuwait
Bashir Abdel Samad,2,114.0,0,0,2,0,2,Egypt
Basile Boli,0,25.0,0,0,0,1,1,Albania
Basile de Carvalho,0,38.0,0,0,1,0,1,Guinea-Bissau
Bassala Touré,0,84.0,0,0,2,0,2,Mali
Bassam Al-Rawi,2,127.0,0,0,2,0,2,Qatar
Bassam Jeridi,0,123.0,0,0,5,1,6,Benin
Bastian Schweinsteiger,3,715.0,0,1,7,7,14,Germany
Batman Furigi,0,88.0,0,0,1,0,1,Papua New Guinea
Batram Suri,6,599.0,0,1,4,6,10,Tahiti
Bauyrzhan Islamkhan,0,79.0,0,0,1,0,1,Kazakhstan
Bauyrzhan Turysbek,0,144.0,0,0,1,1,2,Romania
Bayarzorig Davaa,1,36.0,0,0,0,1,1,Bangladesh
Bayazir al-Said,3,271.0,0,0,2,4,6,Syria
Beat Sutter,0,28.0,0,0,0,1,1,Luxembourg
Bebeto,5,1018.0,0,0,13,6,19,Brazil
Bedel Moyimbouabeka,0,7.0,0,0,1,0,1,Congo
Beder Caicedo,0,46.0,0,0,0,1,1,Bolivia
Bedri Omuri,0,150.0,0,0,1,2,3,Belgium
Begençmuhammet Kulyýew,2,497.0,0,0,5,3,8,Turkmenistan
Behailu Assefa,0,57.0,0,0,1,0,1,Ethiopia
Behtash Fariba,7,434.0,0,0,2,6,8,Kuwait
Bekim Balaj,0,305.0,0,0,2,3,5,Portugal
Bekuretsion Gebre-Hiwot,0,86.0,0,0,1,0,1,Ethiopia
Ben Acheampong,3,97.0,0,0,1,2,3,DR Congo
Ben Badi,1,14.0,0,0,0,1,1,Algeria
Ben Brereton Díaz,1,173.0,0,0,4,0,4,Chile
Ben Chilwell,0,17.0,0,0,0,1,1,Andorra
Ben Davies,0,77.0,0,0,1,0,1,Wales
Ben Federspiel,0,11.0,1,0,0,1,1,Luxembourg
Ben Iroha,1,26.0,0,0,1,0,1,Nigeria
Ben Lemana,2,88.0,0,1,1,1,2,American Samoa
Ben Malango,0,236.0,0,0,1,2,3,Tanzania
Ben Olsen,1,23.0,0,0,1,0,1,United States
Ben Sahar,0,393.0,0,0,5,0,5,Israel
Ben Sigmund,1,98.0,0,0,0,2,2,New Caledonia
Ben Waine,1,75.0,0,0,0,1,1,Papua New Guinea
Ben Wattman,0,90.0,0,0,0,1,1,Mexico
Ben Wijnstekers,0,30.0,0,0,1,0,1,Netherlands
Ben Woodburn,0,74.0,0,0,1,0,1,Wales
Benas Šatkus,0,18.0,1,0,1,0,1,Northern Ireland
Benedict Akwuegbu,0,50.0,0,0,2,0,2,Nigeria
Benedicto Godoy Véizaga,2,87.0,0,0,2,0,2,Bolivia
Bengally Sylla,3,89.0,0,1,2,1,3,Guinea
Bengt Berndtsson,0,20.0,0,0,1,0,1,Sweden
Benigno Apocada,1,173.0,0,0,0,2,2,Ecuador
Benigno Gutiérrez,3,270.0,0,0,3,2,5,Ecuador
Benito Armingol,1,42.0,0,0,1,0,1,Chile
Benito Lorenzi,1,78.0,0,0,0,1,1,Belgium
Benjamin Fischer,0,109.0,0,0,1,1,2,Liechtenstein
Benjamin Huggel,0,22.0,0,0,0,1,1,Luxembourg
Benjamin Kololli,0,16.0,1,0,1,0,1,North Macedonia
Benjamin Källman,0,57.0,0,0,0,1,1,Liechtenstein
Benjamin Moukandjo,2,101.0,0,0,2,2,4,Cameroon
Benjamin Pavard,1,57.0,0,0,1,0,1,France
Benjamin Totori,0,239.0,0,0,5,0,5,Solomon Islands
Benjamin Verbič,0,262.0,0,0,3,1,4,Malta
Benjamin Šeško,0,67.0,0,0,0,1,1,Malta
Benjamín Delgado,3,125.0,0,0,3,0,3,Argentina
Benjamín Galindo,5,589.0,0,6,11,2,13,Mexico
Benjani Mwaruwari,1,299.0,0,0,3,2,5,Zimbabwe
Benni McCarthy,9,453.0,0,1,7,5,12,South Africa
Bennie Muller,0,52.0,0,0,1,0,1,Netherlands
Benny Feilhaber,0,73.0,0,0,1,0,1,United States
Benny Nielsen,0,150.0,0,1,3,0,3,Denmark
Benny Tabak,0,54.0,0,0,3,0,3,Israel
Bent Burgess,0,65.0,0,0,1,0,1,Belize
Bent Christensen Arensøe,1,172.0,0,0,2,4,6,Yugoslavia
Bent Hansen,0,19.0,0,0,1,0,1,Denmark
Bent Jensen,0,84.0,0,1,0,1,1,Republic of Ireland
Bep Bakhuys,0,291.0,0,0,2,2,4,Netherlands
Berat Djimsiti,0,23.0,0,0,0,1,1,Armenia
Berat Sadik,0,90.0,0,0,0,1,1,Northern Ireland
Berdi Şamyradow,0,84.0,0,0,0,1,1,Indonesia
Bernard Akue Adovi,0,57.0,0,0,0,1,1,Togo
Bernard Blanchet,0,118.0,0,0,0,2,2,Norway
Bernard Chanda,3,411.0,0,0,4,3,7,Zambia
Bernard Genghini,3,260.0,0,0,3,1,4,France
Bernard Lacombe,1,170.0,0,0,3,3,6,Bulgaria
Bernard Leclézio,0,48.0,1,0,1,0,1,Malawi
Bernard N'Guessan,0,129.0,0,1,2,0,2,Ivory Coast
Bernard Parker,1,447.0,1,1,6,2,8,South Africa
Bernard Rahis,0,59.0,0,0,0,1,1,Austria
Bernard Tchoutang,1,358.0,0,0,5,0,5,Cameroon
Bernard Voorhoof,2,162.0,0,0,3,1,4,Belgium
Bernardo Añor,0,64.0,0,0,1,0,1,Venezuela
Bernardo Redín,3,268.0,0,1,0,3,3,Chile
Bernardo Silva,1,228.0,0,0,2,3,5,New Zealand
Bernd Bransch,0,106.0,0,0,2,0,2,German DR
Bernd Hölzenbein,2,244.0,0,0,1,2,3,Germany
Bernd Krauss,0,30.0,1,0,1,0,1,Germany
Bernd Schneider,1,180.0,0,1,1,1,2,Germany
Bernd Schuster,0,80.0,0,0,0,2,2,Albania
Bernhard Cullmann,0,129.0,0,0,1,2,3,Germany
Bernhard Klodt,1,52.0,0,0,1,0,1,Germany
Bernt Haas,0,10.0,0,0,1,0,1,Switzerland
Bert Patenaude,4,144.0,0,0,0,4,4,Belgium
Berthy Suárez,1,152.0,0,0,2,1,3,Bolivia
Berti Vogts,1,141.0,1,0,2,0,2,Germany
Bertil Ericsson,0,83.0,0,0,2,0,2,Sweden
Bertrand Bouity,0,26.0,0,0,1,0,1,Congo
Bertrand Crasson,0,24.0,0,0,0,1,1,Wales
Bertrand Kaï,6,366.0,0,0,0,6,6,Vanuatu
Bertrand St. Ange,0,44.0,0,0,0,1,1,Burkina Faso
Bertrand Traoré,2,164.0,0,0,3,1,4,Burkina Faso
Besar Halimi,0,70.0,0,0,0,1,1,Spain
Besart Abdurahimi,0,90.0,0,0,1,0,1,North Macedonia
Besnik Hasi,0,137.0,0,0,1,1,2,Albania
Bessam,0,3.0,0,0,1,0,1,Mauritania
Beto,1,39.0,0,0,0,1,1,United States
Beto Gonçalves,0,49.0,0,0,2,0,2,Indonesia
Bharat Khawas,0,80.0,0,0,1,0,1,Nepal
Bhola Silwal,0,56.0,0,0,1,0,1,Nepal
Bhupinder Thakur,3,143.0,0,0,2,1,3,India
Bibiano Zapirain,0,95.0,0,0,3,0,3,Uruguay
Bibras Natcho,0,166.0,0,0,0,3,3,Azerbaijan
Bijou Kisombe Mundaba,1,77.0,0,0,0,1,1,Ghana
Bikash Panji,0,120.0,0,0,1,1,2,Bangladesh
Bilal Al-Laham,1,16.0,0,0,0,1,1,Taiwan
Bilal Kısa,0,47.0,0,0,0,1,1,Latvia
Bilal Mohammed,0,30.0,0,0,2,0,2,Qatar
Bilal Sidibé,0,16.0,1,0,1,0,1,Tunisia
Bill Looby,0,176.0,0,0,0,4,4,Mexico
Bill Tchato,0,88.0,0,0,0,1,1,Egypt
Bill Tuiloma,3,174.0,0,0,1,2,3,New Zealand
Bill de Graaf,2,63.0,0,0,2,0,2,New Zealand
Billel Dziri,3,204.0,0,0,1,2,3,Burkina Faso
Billy Bingham,0,69.0,0,0,1,1,2,Portugal
Billy Bremner,0,86.0,0,0,2,0,2,Scotland
Billy Caskey,0,83.0,0,0,0,1,1,Bulgaria
Billy Dodds,0,307.0,0,1,6,1,7,Scotland
Billy Forbes,0,22.0,0,0,0,1,1,Saint Kitts and Nevis
Billy Hamilton,2,200.0,0,0,1,3,4,Scotland
Billy Humphries,0,54.0,0,0,0,1,1,Poland
Billy McAdams,0,168.0,0,0,3,0,3,Northern Ireland
Billy McClure,0,5.0,0,1,1,0,1,New Zealand
Billy McKinlay,0,101.0,0,0,1,2,3,Malta
Billy McNeill,0,33.0,0,0,2,0,2,Scotland
Billy Simpson,0,60.0,0,0,1,0,1,Northern Ireland
Billy Steel,0,23.0,0,0,0,1,1,Northern Ireland
Billy Wright,0,212.0,0,0,6,0,6,New Zealand
Bima Sakti,0,51.0,0,0,1,0,1,Indonesia
Biplu Ahmed,0,81.0,0,0,0,1,1,Oman
Biram Kayal,0,81.0,0,0,1,0,1,Israel
Biren Basnet,0,90.0,0,0,1,0,1,Bhutan
Birkir Bjarnason,1,488.0,0,0,3,9,12,Albania
Birkir Már Sævarsson,1,100.0,1,0,0,2,2,Iceland
Bixente Lizarazu,0,174.0,0,0,2,0,2,France
Bizwell Phiri,1,166.0,0,0,1,1,2,Burkina Faso
Bjarni Guðjónsson,0,73.0,0,0,1,0,1,Iceland
Björn Andersson,0,27.0,0,0,1,0,1,Sweden
Björn Bergmann Sigurðarson,1,25.0,0,0,0,1,1,Kosovo
Bjørn Borgen,1,64.0,0,0,0,1,1,Russia
Bjørn Helge Riise,0,74.0,0,0,0,1,1,Bosnia and Herzegovina
Bjørn Maars Johnsen,0,173.0,0,0,1,2,3,Norway
Blagoje Marjanović,1,187.0,0,0,2,1,3,Bolivia
Blagoy Georgiev,0,171.0,0,0,0,2,2,Slovenia
Blaise Matuidi,1,21.0,0,0,0,2,2,Switzerland
Blaise Nkufo,0,269.0,0,0,3,2,5,Israel
Blas Pérez,10,1315.0,0,0,16,8,24,Panama
Blas Saruppo,2,165.0,0,0,3,0,3,Argentina
Blati Touré,1,82.0,0,0,1,0,1,Burkina Faso
Blaž Slišković,0,50.0,0,0,1,0,1,Yugoslavia
Bledar Kola,2,252.0,0,1,3,1,4,Albania
Blerim Džemaili,2,250.0,0,1,3,2,5,Switzerland
Blessing Makunike,0,43.0,0,0,1,0,1,Zimbabwe
Bo Börjesson,0,137.0,0,0,2,1,3,Switzerland
Bo Larsson,1,380.0,0,3,4,4,8,Cyprus
Boaz Kofman,0,31.0,0,0,0,1,1,Cyprus
Bob Latchford,0,167.0,0,0,2,2,4,Denmark
Bob Peeters,0,261.0,0,0,3,1,4,Latvia
Boban Babunski,0,53.0,1,1,1,1,2,North Macedonia
Boban Grnčarov,0,79.0,0,0,0,1,1,Norway
Boban Nikolov,0,162.0,0,0,1,2,3,Liechtenstein
Bobby Brennan,0,75.0,0,0,0,1,1,England
Bobby Chalmers,2,117.0,0,0,2,0,2,Zimbabwe
Bobby Charlton,2,703.0,0,0,9,5,14,Luxembourg
Bobby Collins,1,74.0,0,0,0,1,1,Paraguay
Bobby Convey,0,67.0,0,0,1,0,1,United States
Bobby Decordova-Reid,1,26.0,0,0,1,0,1,Jamaica
Bobby Despotovski,5,296.0,0,1,5,0,5,Australia
Bobby Hogg,0,86.0,1,0,0,1,1,Australia
Bobby Johnstone,0,42.0,0,0,1,0,1,Scotland
Bobby Lennox,0,113.0,0,0,1,1,2,Scotland
Bobby Murdoch,0,143.0,0,0,2,1,3,Scotland
Bobby Smith,0,132.0,0,0,0,3,3,Luxembourg
Bobby Sookram,0,90.0,0,0,0,1,1,Suriname
Bobby Tambling,0,74.0,0,0,0,1,1,France
Bobby Wood,0,278.0,0,0,4,2,6,United States
Bobo Bola,0,81.0,0,0,0,1,1,Mauritania
Bodunha,0,99.0,0,0,2,0,2,Angola
Bogdan Stancu,1,453.0,0,3,2,7,9,Romania
Bogi Løkin,0,47.0,0,0,1,0,1,Faroe Islands
Bohdan Masztaler,0,27.0,0,0,1,0,1,Poland
Bohumil Veselý,0,201.0,0,0,3,0,3,Czechoslovakia
Boitumelo Mafoko,0,80.0,0,0,0,1,1,Mozambique
Bokang Mothoana,0,22.0,0,0,0,1,1,Burundi
Boldyn Buman-Uchral,1,90.0,0,0,0,1,1,Bangladesh
Bolombo Tokala,0,34.0,0,0,0,1,1,Ivory Coast
Bonaventure Djonkep,1,143.0,0,0,2,1,3,Cameroon
Bonaventure Kalou,1,191.0,0,1,3,1,4,Ghana
Bongani Khumalo,0,20.0,0,0,1,0,1,South Africa
Bongani Zungu,2,139.0,0,0,1,1,2,South Africa
Bongokuhle Hlongwane,0,83.0,0,0,1,0,1,South Africa
Boniek García,0,62.0,0,0,2,0,2,Honduras
Boniface Simutowe,0,62.0,0,1,1,0,1,Zambia
Bora Kostić,0,268.0,0,0,3,1,4,Portugal
Boraî Bashir,0,58.0,0,0,1,0,1,Sudan
Boris Cebotari,0,14.0,0,0,0,1,1,Belarus
Boris Céspedes,0,45.0,0,0,0,1,1,Paraguay
Boris Kazakov,1,14.0,0,0,1,0,1,Russia
Boris Kopitović,0,49.0,1,0,1,0,1,Czech Republic
Boris Tatushin,1,9.0,0,0,1,0,1,Russia
Borislav Dimitrov,0,2.0,0,0,1,0,1,Bulgaria
Borna Barišić,0,44.0,0,0,1,0,1,Croatia
Borče Jovanovski,0,35.0,0,0,0,1,1,Cyprus
Boualem Amirouche,0,97.0,0,1,1,1,2,Ethiopia
Boualem Khoukhi,1,362.0,0,0,5,2,7,Qatar
Boubacar Bagili,0,64.0,0,0,1,1,2,South Sudan
Boubacar Sanogo,1,255.0,0,0,4,2,6,Ivory Coast
Bouchaib El Moubarki,0,63.0,0,0,0,1,1,Gambia
Boudewijn Zenden,1,174.0,0,0,4,0,4,Netherlands
Boujemaa Benkhrif,0,72.0,0,0,1,0,1,Morocco
Boukari Adamou,0,17.0,0,0,0,1,1,Sierra Leone
Boulat Esmagambetov,0,92.0,0,0,2,1,3,Kazakhstan
Boulaye Dia,0,71.0,0,0,1,2,3,Congo
Boureima Zongo,1,83.0,0,0,1,0,1,Burkina Faso
Boycho Velichkov,0,44.0,0,0,2,0,2,Bulgaria
Bozhidar Iskrenov,0,107.0,0,0,1,1,2,Yugoslavia
Bozhil Kolev,0,253.0,0,1,4,1,5,Bulgaria
Bořek Dočkal,0,199.0,0,0,1,4,5,Bulgaria
Boško Balaban,0,343.0,0,0,5,3,8,Croatia
Boško Gjurovski,0,129.0,0,0,3,0,3,North Macedonia
Boško Janković,0,81.0,0,0,1,2,3,Serbia
Boštjan Cesar,0,365.0,0,0,2,5,7,Slovenia
Božidar Senčar,0,44.0,0,0,1,0,1,Yugoslavia
Brad Evans,0,90.0,0,0,0,1,1,Jamaica
Brad Maloney,0,106.0,0,0,2,0,2,Australia
Bradley August,0,54.0,0,0,1,0,1,South Africa
Bradley Woods-Garness,0,83.0,0,0,1,0,1,Montserrat
Brahim Kerrit,1,89.0,0,0,0,1,1,Morocco
Brahim Zafour,1,52.0,0,0,0,1,1,Cameroon
Brahima Korbeogo,0,83.0,0,0,1,0,1,Burkina Faso
Brahima Traore,0,81.0,0,0,1,0,1,Burkina Faso
Braian Samudio,1,33.0,0,0,0,1,1,Chile
Branco,4,214.0,0,1,1,4,5,Venezuela
Brandley Kuwas,1,7.0,0,0,0,1,1,British Virgin Islands
Brandon Beresford,0,27.0,0,0,0,1,1,Saint Vincent and the Grenadines
Brandon McDonald,0,37.0,0,0,1,0,1,Guam
Brandur Olsen,0,70.0,0,0,1,0,1,Faroe Islands
Branimir Subašić,0,6.0,0,0,1,0,1,Azerbaijan
Branislav Ivanović,0,371.0,0,0,3,4,7,Portugal
Branko Bošković,0,89.0,1,0,1,1,2,Azerbaijan
Branko Brnovic,0,2.0,0,0,0,1,1,Hungary
Branko Buljevic,0,55.0,0,0,1,1,2,Australia
Branko Ilić,0,88.0,0,0,1,0,1,Slovenia
Branko Oblak,1,100.0,0,0,3,0,3,Yugoslavia
Branko Zebec,1,128.0,0,0,0,2,2,Israel
Braulio Luna,0,75.0,0,0,0,1,1,Saudi Arabia
Brayan Moya,0,86.0,0,0,2,0,2,Honduras
Brede Hangeland,0,185.0,0,0,0,3,3,Iceland
Breel Embolo,2,404.0,0,1,4,5,9,Switzerland
Brehima Traoré,0,125.0,0,0,2,0,2,Mali
Brek Shea,0,151.0,0,0,2,0,2,United States
Brendan Augustine,1,39.0,0,0,1,0,1,South Africa
Brendan Gan,0,26.0,0,0,1,0,1,Malaysia
Brenden Aaronson,0,141.0,0,0,1,1,2,United States
Brent Fisher,4,137.0,0,0,4,0,4,New Zealand
Brent Sancho,1,25.0,1,0,1,0,1,Paraguay
Brett Emerton,1,834.0,0,1,8,7,15,New Zealand
Brett Holman,3,299.0,0,0,3,3,6,Ghana
Brian Brendell,2,104.0,0,0,1,1,2,Namibia
Brian Ching,0,431.0,0,0,7,1,8,Jamaica
Brian Flynn,0,219.0,0,1,2,3,5,Wales
Brian Hardman,0,90.0,0,0,1,0,1,New Zealand
Brian Haynes,0,41.0,0,0,0,1,1,Jamaica
Brian Kaltak,2,120.0,0,1,1,1,2,Vanuatu
Brian Laudrup,5,805.0,0,0,9,7,16,Bulgaria
Brian McBride,5,889.0,0,1,19,4,23,United States
Brian McClair,1,34.0,0,0,2,0,2,Scotland
Brian Mwila,0,102.0,0,0,3,0,3,Zambia
Brian Onyango,0,19.0,0,0,1,0,1,Kenya
Brian Philley,0,44.0,0,0,1,1,2,Canada
Brian Quinn,0,46.0,0,0,1,0,1,United States
Brian Said,0,241.0,2,0,3,2,5,Malta
Brian Steen Nielsen,0,87.0,0,0,1,1,2,Israel
Brian Turner,0,504.0,0,1,5,6,11,New Zealand
Brice Dahité,1,89.0,0,1,1,0,1,New Caledonia
Brice Jovial,2,143.0,0,0,0,2,2,Panama
Brice Mackaya,2,65.0,0,1,2,1,3,DR Congo
Briel Thomas,2,31.0,1,0,1,1,2,Dominica
Brighton Sinyangwe,1,299.0,0,0,3,1,4,Zambia
Britt Assombalonga,1,78.0,0,0,0,1,1,Zimbabwe
Bronisław Bula,0,90.0,0,0,1,1,2,Luxembourg
Bror Mellberg,1,33.0,0,0,0,1,1,Spain
Brown Ideye,1,30.0,0,0,0,1,1,Mali
Bruce Murray,3,329.0,0,0,4,1,5,Austria
Bruce Rioch,0,93.0,0,0,2,0,2,Scotland
Brunel Fucien,0,90.0,0,0,1,0,1,Haiti
Bruno Akrapović,0,48.0,0,0,0,1,1,Israel
Bruno Alves,0,397.0,0,0,3,5,8,Azerbaijan
Bruno Bellone,0,99.0,0,0,1,1,2,Republic of Ireland
Bruno Conti,1,154.0,0,0,3,0,3,Italy
Bruno Coutinho,1,85.0,0,0,1,0,1,India
Bruno Ecuele Manga,1,162.0,1,0,3,1,4,Libya
Bruno Fernandes,2,298.0,0,1,5,1,6,Luxembourg
Bruno Guimarães,0,66.0,0,0,0,1,1,Bolivia
Bruno Martins Indi,0,48.0,0,0,0,2,2,Hungary
Bruno Mauro,0,106.0,0,0,1,1,2,Chad
Bruno Michaud,0,33.0,1,0,0,1,1,Switzerland
Bruno Miranda,0,38.0,0,0,0,1,1,Venezuela
Bruno Mora,1,170.0,0,0,3,0,3,Italy
Bruno Petković,1,315.0,0,0,4,1,5,Slovakia
Bruno Pezzey,1,154.0,0,0,4,1,5,Norway
Bruno Valdez,0,11.0,0,0,1,0,1,Paraguay
Bruno Versavel,0,74.0,0,0,1,2,3,Belgium
Bruno Zita Mbanangoyé,2,351.0,0,0,2,2,4,Algeria
Brutil Hosé,2,123.0,0,0,2,0,2,Curaçao
Bryan Acosta,1,75.0,0,0,1,0,1,Honduras
Bryan Hamilton,0,76.0,0,0,2,0,2,Northern Ireland
Bryan Joseph,0,13.0,0,0,1,0,1,Guyana
Bryan Oviedo,1,7.0,0,0,1,0,1,Costa Rica
Bryan Robson,3,582.0,0,0,6,8,14,Norway
Bryan Roy,1,139.0,0,0,1,3,4,Morocco
Bryan Ruiz,6,1014.0,0,1,11,9,20,Honduras
Brynjar Gunnarsson,0,168.0,0,0,2,2,4,Liechtenstein
Brynjar Ingi Bjarnason,0,78.0,0,0,1,0,1,Iceland
Budi Johannis,0,90.0,0,0,1,0,1,Indonesia
Budi Sudarsono,1,109.0,0,0,2,2,4,Turkmenistan
Buenaventura Ferreira,2,180.0,0,0,2,1,3,Colombia
Bukayo Saka,3,366.0,0,0,4,2,6,England
Burak Yılmaz,2,1012.0,0,4,12,10,22,Belgium
Burhan Sargın,4,212.0,0,0,2,3,5,Turkey
Burton Mugala,0,47.0,0,0,1,0,1,Zambia
Bushara Abdel-Nadief,1,49.0,0,0,0,1,1,Morocco
Byron Bonilla,0,46.0,0,0,1,0,1,Nicaragua
Byron Bubb,0,169.0,0,0,1,1,2,Guyana
Byron Tenorio,0,5.0,0,0,0,1,1,Venezuela
Byun Byung-joo,2,163.0,0,0,3,1,4,South Korea
Bálint Vécsei,0,88.0,0,0,1,0,1,Hungary
Bård Borgersen,0,129.0,0,0,0,2,2,Armenia
Béla Illés,0,489.0,0,1,5,2,7,Hungary
Béla Várady,0,227.0,0,0,3,1,4,Hungary
Bülent Eken,0,44.0,0,0,1,0,1,Turkey
Bülent Korkmaz,1,148.0,0,0,2,1,3,Turkey
Bănel Nicoliţă,0,69.0,0,0,0,1,1,Slovenia
Cacau,1,70.0,0,0,1,0,1,Germany
Caetano Izzo,1,21.0,0,0,1,0,1,Brazil
Cai Jinbiao,1,27.0,0,0,1,0,1,China PR
Cai Sheng,3,285.0,0,0,0,4,4,Pakistan
Cain Attard,0,98.0,0,0,2,0,2,Malta
Caio Canedo,1,148.0,0,0,4,0,4,United Arab Emirates
Caio Ribeiro Decoussau,3,97.0,0,0,1,2,3,Brazil
Callum McGregor,0,121.0,0,0,2,0,2,Scotland
Callum Robinson,0,134.0,0,0,0,3,3,Azerbaijan
Calum Willock,0,51.0,0,0,2,0,2,Saint Kitts and Nevis
Camara Toure,0,49.0,0,0,1,0,1,Guinea
Cameron Hepple,0,36.0,0,1,0,1,1,Turks and Caicos Islands
Camille Dimmer,0,160.0,0,0,0,3,3,England
Camille Libar,0,4.0,0,0,1,0,1,Luxembourg
Camille Wagner,0,3.0,0,0,0,1,1,Switzerland
Camillo Gonsalves,0,54.0,0,0,1,0,1,India
Camillo Jerusalem,0,15.0,0,0,1,0,1,Austria
Camilo Romero,1,59.0,1,0,1,0,1,Brazil
Campbell Best,0,119.0,0,0,0,2,2,Samoa
Capucho,0,64.0,0,0,1,0,1,Portugal
Careca,8,698.0,0,1,12,2,14,Brazil
Carey Harris,0,29.0,0,0,1,0,1,Guyana
Carl Bertelsen,1,209.0,0,0,1,2,3,Denmark
Carl Emil Christiansen,0,42.0,0,0,0,1,1,Malta
Carl Fister,0,58.0,0,0,1,0,1,United States
Carl Fletcher,0,47.0,0,0,0,1,1,Costa Rica
Carl Harris,0,67.0,0,0,0,1,1,Turkey
Carl Medjani,0,140.0,0,0,1,1,2,Burkina Faso
Carl Robinson,0,37.0,0,0,0,1,1,Northern Ireland
Carl Valeri,1,82.0,0,0,0,1,1,Uzbekistan
Carl Veart,1,233.0,0,0,4,2,6,Solomon Islands
Carles Puyol,2,152.0,1,0,0,3,3,Spain
Carles Rexach,0,127.0,0,0,1,1,2,Spain
Carlo Corazzin,5,379.0,0,2,4,3,7,Canada
Carlo Costly,9,1202.0,0,0,15,7,22,Panama
Carlo Galli,1,48.0,0,0,0,1,1,Belgium
Carlo Valentini,0,89.0,1,0,0,1,1,San Marino
Carlos Aguilera,0,324.0,0,0,2,3,5,Venezuela
Carlos Alberto Raffo,5,497.0,0,0,6,4,10,Ecuador
Carlos Alberto Torres,1,86.0,0,0,1,0,1,Brazil
Carlos Alonso,0,86.0,1,0,1,0,1,Saint Vincent and the Grenadines
Carlos Andrés Sánchez,0,30.0,0,0,0,1,1,Peru
Carlos Aragonés,0,459.0,0,3,7,1,8,Bolivia
Carlos Arango,3,216.0,0,1,3,2,5,Colombia
Carlos Astondoa,0,43.0,0,0,0,1,1,Aruba
Carlos Babington,1,66.0,0,0,0,1,1,Poland
Carlos Bacca,1,166.0,0,0,3,2,5,Bolivia
Carlos Bernárdez,2,93.0,0,0,2,0,2,Belize
Carlos Bocanegra,0,314.0,0,0,6,2,8,United States
Carlos Borges,7,311.0,0,0,1,7,8,Scotland
Carlos Bueno,3,583.0,0,1,6,3,9,Uruguay
Carlos Báez,0,21.0,0,0,1,0,1,Paraguay
Carlos Campillo,2,31.0,0,0,1,1,2,Argentina
Carlos Campos Sánchez,0,104.0,0,0,2,1,3,Chile
Carlos Castro Borja,0,157.0,0,1,4,1,5,Nicaragua
Carlos Caszely,0,290.0,0,0,5,2,7,Chile
Carlos Cecconato,2,95.0,0,0,2,0,2,Argentina
Carlos Chavarría,1,190.0,0,0,1,3,4,Nicaragua
Carlos Chimomole,0,62.0,0,0,1,0,1,Mozambique
Carlos Discua,0,69.0,0,0,0,1,1,United States
Carlos Dunga,0,54.0,0,0,1,0,1,Brazil
Carlos Eduardo Gallardo,1,157.0,0,1,2,1,3,Trinidad and Tobago
Carlos Edwards,0,68.0,0,0,1,2,3,Guatemala
Carlos Elizeche,1,7.0,0,0,1,0,1,Paraguay
Carlos Figueroa,0,15.0,0,0,1,0,1,Guatemala
Carlos Fumo Gonçalves,1,54.0,0,0,1,0,1,Mozambique
Carlos Gabriel Rodríguez,1,68.0,0,0,1,0,1,Panama
Carlos Gamarra,3,255.0,1,0,7,1,8,Paraguay
Carlos Geerman,0,19.0,1,0,1,0,1,Puerto Rico
Carlos Giudice,1,54.0,0,0,1,0,1,Chile
Carlos González,0,77.0,0,0,2,0,2,Mexico
Carlos Gruezo,0,88.0,0,1,0,1,1,Bolivia
Carlos Guerini,0,89.0,0,0,1,0,1,Argentina
Carlos Guirland,1,38.0,0,0,1,0,1,Paraguay
Carlos Gómez Sánchez,5,290.0,0,0,2,3,5,Argentina
Carlos Hermosillo,3,863.0,0,0,15,3,18,Mexico
Carlos Hernández,0,288.0,0,0,4,1,5,Costa Rica
Carlos Humberto Paredes,0,333.0,0,0,7,1,8,Paraguay
Carlos Humberto Suazo,0,69.0,0,0,2,0,2,Honduras
Carlos Izaguirre,2,112.0,0,0,2,1,3,Argentina
Carlos Jara Saguier,0,116.0,0,0,1,1,2,Colombia
Carlos José Báez,0,54.0,0,0,0,1,1,Brazil
Carlos Lapetra,0,63.0,0,0,1,0,1,Spain
Carlos Lobatón,1,101.0,0,0,0,1,1,Colombia
Carlos Loswijk,0,14.0,0,0,1,0,1,Suriname
Carlos Maldonado,3,253.0,0,0,2,2,4,Brazil
Carlos Manuel,1,241.0,0,0,3,3,6,Portugal
Carlos Marchena,0,90.0,0,0,1,0,1,Spain
Carlos María Morales,1,53.0,0,0,1,0,1,Uruguay
Carlos Mejía,0,90.0,0,0,1,0,1,Guatemala
Carlos Miguel da Silva Júnior,1,57.0,0,0,1,0,1,Brazil
Carlos Monteagudo,1,22.0,0,0,0,1,1,Anguilla
Carlos Morais Caló,0,159.0,0,0,0,3,3,Burkina Faso
Carlos Muñoz,1,54.0,0,0,2,1,3,Brazil
Carlos Muñoz Cobo,0,206.0,0,0,3,1,4,Spain
Carlos Ochoa,1,90.0,0,0,1,0,1,Mexico
Carlos Pavón,9,1553.0,0,5,23,11,34,Honduras
Carlos Pedro Silva Morais,0,145.0,0,0,1,1,2,Eswatini
Carlos Peucelle,2,191.0,0,0,3,1,4,Argentina
Carlos Peña,0,87.0,0,0,0,1,1,New Zealand
Carlos Pineda Alvarado,1,32.0,0,0,0,1,1,Argentina
Carlos Reinoso,0,76.0,0,0,0,1,1,Peru
Carlos Reyes,0,44.0,0,0,1,0,1,Dominican Republic
Carlos Rivas,0,112.0,0,1,4,0,4,Chile
Carlos Rivera,1,33.0,0,0,1,0,1,Panama
Carlos Rojas,1,4.0,0,0,1,0,1,Chile
Carlos Romero,2,245.0,0,0,0,3,3,Bolivia
Carlos Ruiz,10,2115.0,0,4,32,15,47,Guatemala
Carlos Salcido,2,318.0,0,0,3,3,6,Mexico
Carlos Saucedo,0,109.0,0,0,3,0,3,Bolivia
Carlos Scarone,2,235.0,0,1,3,3,6,Uruguay
Carlos Secretário,0,19.0,0,0,1,0,1,Portugal
Carlos Septién,0,85.0,0,0,1,0,1,Mexico
Carlos Soler,1,120.0,0,0,2,1,3,Sweden
Carlos Soto,1,15.0,0,0,1,0,1,Bolivia
Carlos Sánchez,1,6.0,1,0,1,0,1,Bolivia
Carlos Tenorio,2,163.0,0,0,2,2,4,Ecuador
Carlos Tevez,5,386.0,0,0,6,1,7,Peru
Carlos Torres Garcés,0,64.0,0,1,1,0,1,Ecuador
Carlos Valderrama,3,217.0,0,1,3,3,6,Bolivia
Carlos Valdés,0,49.0,0,0,1,0,1,Colombia
Carlos Varela,1,25.0,0,0,1,0,1,Chile
Carlos Vela,4,454.0,0,1,5,5,10,Belize
Carlos Verdejo,2,105.0,0,0,2,0,2,Chile
Carlos Vidal,2,68.0,0,0,2,0,2,Chile
Carlos Villanueva,1,86.0,0,0,0,1,1,Ecuador
Carlos Vivo Goban,0,51.0,0,0,1,0,1,Costa Rica
Carlos Zambrano,0,107.0,0,0,1,1,2,Peru
Carlos Ángel López,0,5.0,0,0,0,1,1,Bolivia
Carlton Chapman,1,39.0,0,0,0,1,1,Sri Lanka
Carlton Palmer,0,78.0,0,0,1,0,1,England
Carlyle Mitchell,0,110.0,1,0,1,1,2,Honduras
Carmel Busuttil,0,526.0,0,1,6,4,10,Malta
Carmelo Micciche,0,38.0,0,0,1,0,1,France
Carnejy Antoine,1,181.0,0,0,0,4,4,Turks and Caicos Islands
Carol Creiniceanu,0,75.0,0,0,1,0,1,Romania
Carolus Andriamatsinoro,2,108.0,0,0,1,1,2,Guinea
Carsten Jancker,1,124.0,0,0,2,1,3,Finland
Carsten Ramelow,0,7.0,0,0,1,0,1,Germany
Carvalho Leite,3,101.0,0,0,3,0,3,Brazil
Casemiro,1,191.0,0,0,3,1,4,Brazil
Casiano Mba,0,67.0,0,0,0,1,1,Congo
Cassim Langaigne,0,76.0,0,0,0,1,1,Saint Vincent and the Grenadines
Catalino Rivarola,0,129.0,0,0,3,0,3,Paraguay
Catilina Aubameyang,0,56.0,0,0,0,1,1,Algeria
Cavafe,1,80.0,0,0,1,0,1,Cuba
Cayetano Ré,4,117.0,0,0,1,3,4,Paraguay
Cecil Jones Attuquayefio,2,173.0,0,0,0,2,2,DR Congo
Cecilio Martínez,3,119.0,0,0,2,1,3,Colombia
Cecilio Waterman,0,440.0,0,0,5,2,7,Panama
Cedric Itten,0,243.0,0,0,2,2,4,Switzerland
Cees Schapendonk,0,48.0,0,0,1,0,1,Netherlands
Ceferino Ramírez,3,228.0,0,0,0,3,3,Bolivia
Celino Mora,2,136.0,0,0,2,3,5,Bolivia
Celso Ayala,1,36.0,0,0,1,1,2,Nigeria
Celso Borges,6,767.0,0,1,10,7,17,Costa Rica
Celso Pontes,0,59.0,0,0,1,0,1,São Tomé and Príncipe
Cemil Turan,0,348.0,0,1,5,2,7,Turkey
Cengiz Ünder,1,170.0,0,0,2,2,4,Kosovo
Cenk Tosun,0,522.0,0,0,6,4,10,Turkey
Cesc Fàbregas,4,327.0,0,0,4,2,6,Spain
Cesáreo Onzari,1,11.0,0,0,1,0,1,Argentina
Cha Bum-kun,1,467.0,0,1,4,4,8,Cambodia
Cha Du-ri,1,77.0,0,0,2,0,2,South Korea
Chaabane Merzekane,1,85.0,0,0,1,0,1,Algeria
Chad Bertrand,1,34.0,0,0,1,0,1,Dominica
Chadi Hammami,0,142.0,0,0,2,0,2,Tunisia
Chadrac Akolo,0,35.0,0,0,1,0,1,DR Congo
Chalwe Kunda,0,65.0,0,0,0,1,1,Togo
Chaminda Steinwall,1,28.0,0,0,0,1,1,Philippines
Chan Fat Chi,0,79.0,0,0,0,1,1,South Korea
Chan Ho Man,0,72.0,0,0,1,0,1,Hong Kong
Chan Siu Ki,0,257.0,0,0,3,1,4,Hong Kong
Chan Vathanaka,0,143.0,0,0,2,0,2,Cambodia
Chanathip Songkrasin,1,65.0,0,0,0,2,2,Bahrain
Chancel Mbemba,1,100.0,0,0,1,1,2,DR Congo
Chandradasa Karunaratne,0,82.0,0,0,1,0,1,Sri Lanka
Chang Han,0,31.0,0,0,1,0,1,Taiwan
Chang Kuo Chi,1,69.0,0,0,1,1,2,Taiwan
Chang Wu-yeh,0,57.0,0,0,1,0,1,Taiwan
Channa Ediri Bandanage,2,118.0,0,0,2,1,3,Pakistan
Chaouki Ben Saada,2,139.0,0,1,3,1,4,Tunisia
Charles Akonnor,3,321.0,0,0,4,1,5,Algeria
Charles Alerte,1,44.0,0,0,0,1,1,Ecuador
Charles Amoah,0,112.0,0,0,2,1,3,Ghana
Charles Antenen,2,277.0,0,0,2,4,6,Mexico
Charles Aránguiz,2,251.0,0,0,2,4,6,Bolivia
Charles Ashley,0,6.0,0,0,0,1,1,Australia
Charles Galinie,1,90.0,0,0,0,1,1,New Caledonia
Charles Hambira,2,81.0,1,0,1,1,2,Namibia
Charles Hertig,0,42.0,0,0,0,1,1,Netherlands
Charles Imboula,0,85.0,0,0,0,1,1,Ivory Coast
Charles Jumanne,0,44.0,0,0,1,0,1,Tanzania
Charles Kaboré,0,97.0,0,0,2,0,2,Burkina Faso
Charles Lota,0,70.0,0,0,2,0,2,Zambia
Charles Pollard,1,155.0,1,0,1,1,2,Guyana
Charles Scerri,0,48.0,1,0,1,0,1,Portugal
Charles Spiteri,0,77.0,1,0,0,1,1,Malta
Charles Vatú,0,26.0,0,0,1,0,1,Vanuatu
Charlie Davies,1,174.0,0,0,1,3,4,Trinidad and Tobago
Charlie Eliazar,0,58.0,0,0,2,0,2,Haiti
Charlie Fleming,0,116.0,0,0,0,2,2,Northern Ireland
Charlie Nicholas,0,204.0,0,0,3,0,3,Scotland
Charlie Yankos,0,227.0,0,1,3,1,4,Australia
Charlison Benschop,3,84.0,0,1,0,3,3,Cuba
Charlton Vicento,0,89.0,0,0,0,1,1,Montserrat
Charly Loubet,0,272.0,0,0,4,1,5,France
Charly Musonda,0,44.0,0,1,2,0,2,Zambia
Chaswe Nsofwa,0,164.0,0,0,2,1,3,Zambia
Chathura Gunaratne,0,43.0,0,0,1,0,1,Sri Lanka
Chavdar Tsvetkov,0,395.0,0,0,4,1,5,France
Chavdar Yankov,0,195.0,0,0,2,1,3,Bulgaria
Che Bunce,2,73.0,0,0,1,1,2,New Zealand
Che Chi Man,1,78.0,0,0,1,0,1,Macau
Chea Makara,0,90.0,0,0,1,1,2,Cambodia
Cheang Chon Man,1,13.0,0,0,0,1,1,Nepal
Chedly Laaouini,1,53.0,0,0,1,0,1,Tunisia
Cheick Diabaté,2,267.0,0,1,2,3,5,Gabon
Cheick Fantamady Diarra,1,75.0,0,0,1,0,1,Mali
Cheick Tioté,1,50.0,0,0,1,0,1,Ivory Coast
Cheikh Ba,0,63.0,0,0,1,0,1,Senegal
Cheikh Gueye,0,205.0,1,0,1,2,3,Liberia
Cheikh Moulaye Ahmed,0,71.0,0,0,0,1,1,Tunisia
Cheikh N'Doye,0,90.0,0,0,0,1,1,Cape Verde
Cheikh Ndour,0,66.0,0,0,1,0,1,Gambia
Cheikhou Kouyaté,1,88.0,0,0,2,0,2,Senegal
Chen Fu-Yuan,1,78.0,0,0,0,1,1,Oman
Chen Jingang,2,226.0,0,0,1,2,3,China PR
Chen Jiunn-ming,0,90.0,0,0,0,1,1,Syria
Chen Jui-te,0,135.0,0,0,1,2,3,Taiwan
Chen Kuei-jen,1,78.0,0,0,0,1,1,Bangladesh
Chen Po-liang,0,120.0,0,1,1,1,2,Malaysia
Chen Sing-an,0,41.0,0,0,0,1,1,New Zealand
Chen Tao,0,140.0,0,0,2,0,2,China PR
Chen Wei-chuan,0,77.0,1,0,1,0,1,Kuwait
Chen Xirong,1,55.0,0,0,0,1,1,North Korea
Chen Yi-wei,0,21.0,0,0,1,0,1,Taiwan
Chencho Gyeltshen,0,191.0,0,0,3,1,4,Bhutan
Cheng Sin Siu,0,48.0,0,0,1,0,1,Hong Kong
Cheng Siu Kwan,0,85.0,0,0,0,1,1,Iran
Cheng Siu Wai,2,212.0,0,0,2,2,4,Timor-Leste
Cherdsak Chaiyabutr,1,27.0,0,0,1,0,1,Thailand
Cherkaoui Hafnaoui,1,60.0,0,0,1,0,1,Morocco
Chernor Mansaray,0,78.0,0,0,2,0,2,Sierra Leone
Cheung Chi Tak,0,26.0,0,0,0,1,1,China PR
Cheung Ka-Ping,0,88.0,0,0,0,1,1,Macau
Cheung Kam Wa,1,39.0,0,0,1,1,2,Hong Kong
Cheung Sai Ho,0,49.0,0,0,1,0,1,Hong Kong
Cheung Yiu Kwok,1,39.0,0,0,1,0,1,Hong Kong
Chhin Chhoeun,0,45.0,0,0,0,1,1,Laos
Chiang Shih-lu,0,66.0,0,0,0,1,1,Macau
Chico,2,346.0,0,0,6,0,6,Brazil
Chico Faria,0,36.0,0,0,0,1,1,Cyprus
Chidi Odiah,0,51.0,0,0,1,0,1,Nigeria
Chiedozie Ogbene,0,165.0,0,0,0,2,2,Azerbaijan
Chinedu Obasi,1,12.0,0,0,0,1,1,Egypt
Chinesinho,1,35.0,0,0,1,0,1,Brazil
Chiukepo Msowoya,0,410.0,0,0,4,2,6,Malawi
Cho Byung-kuk,0,51.0,0,0,1,0,1,South Korea
Cho Gue-sung,2,164.0,0,0,2,1,3,Lebanon
Cho In-Chol,2,104.0,0,0,2,0,2,North Korea
Cho Kwang-Rae,1,82.0,1,0,0,1,1,South Korea
Cho Min-Kook,1,189.0,0,0,2,1,3,South Korea
Cho Yoon-ok,0,163.0,0,0,4,0,4,South Korea
Cho Young-cheol,1,45.0,0,0,1,0,1,South Korea
Choe Chol-Man,0,28.0,0,0,0,1,1,Bahrain
Choe Kum-chol,0,144.0,0,0,1,1,2,North Korea
Choe Yong-Son,3,302.0,0,0,3,2,5,North Korea
Choi Chung-min,2,337.0,0,0,3,2,5,Japan
Choi Jae-pil,2,89.0,0,0,2,0,2,North Korea
Choi Jin-cheul,1,89.0,0,0,0,2,2,Costa Rica
Choi Jong-duk,1,203.0,0,0,2,1,3,South Korea
Choi Kwang-seok,0,62.0,0,0,0,1,1,Hong Kong
Choi Kwang-suk,0,77.0,0,0,0,2,2,Japan
Choi Moon-Sik,2,316.0,0,0,1,4,5,India
Choi Sang-Kuk,0,72.0,0,0,2,0,2,South Korea
Choi Soon-ho,8,583.0,0,1,7,5,12,Malaysia
Choi Sung-kuk,1,66.0,0,0,1,0,1,South Korea
Choi Won-nam,3,203.0,0,0,2,2,4,North Korea
Choi Yong-soo,0,356.0,0,0,6,3,9,South Korea
Choi York Yee,0,55.0,0,0,1,0,1,Hong Kong
Cholponbek Esenkul Uulu,0,45.0,0,0,1,0,1,Kyrgyzstan
Chris Armas,0,51.0,0,0,1,0,1,United States
Chris Baird,0,56.0,1,0,1,0,1,Latvia
Chris Birchall,1,104.0,0,0,2,0,2,Trinidad and Tobago
Chris Brunt,0,258.0,1,0,3,1,4,San Marino
Chris Coleman,0,62.0,0,0,2,0,2,Wales
Chris Henderson,1,70.0,0,0,2,0,2,United States
Chris Hughton,0,65.0,0,0,1,0,1,Republic of Ireland
Chris Ikonomidis,1,54.0,0,0,1,0,1,Australia
Chris Jackson,0,270.0,0,1,3,2,5,Fiji
Chris James,0,165.0,0,1,1,1,2,Mexico
Chris Killen,2,404.0,0,0,10,0,10,New Zealand
Chris Lawler,0,74.0,0,0,1,0,1,England
Chris Malonga,0,116.0,0,0,1,1,2,São Tomé and Príncipe
Chris Martin,1,166.0,0,0,1,2,3,Gibraltar
Chris McGrath,0,129.0,0,0,2,1,3,Netherlands
Chris Megaloudis,0,32.0,0,0,1,0,1,Puerto Rico
Chris Nicholl,0,23.0,0,0,1,1,2,Sweden
Chris Nurse,0,149.0,0,0,1,1,2,Barbados
Chris Sagramola,0,68.0,0,0,1,0,1,Luxembourg
Chris Waddle,0,204.0,0,0,3,1,4,England
Chris Wondolowski,0,241.0,0,0,5,0,5,United States
Chris Wood,11,929.0,0,2,10,11,21,Papua New Guinea
Chris Zoricich,1,90.0,0,0,1,0,1,New Zealand
Christ Bongo,0,46.0,0,0,1,1,2,DR Congo
Christian Annan,0,23.0,0,0,1,0,1,Hong Kong
Christian Atsu,2,153.0,0,0,3,0,3,Ghana
Christian Atsu Twasam,1,109.0,0,0,1,1,2,Ghana
Christian Bassogog,3,262.0,0,0,1,2,3,Cameroon
Christian Benteke,3,481.0,0,0,7,4,11,Serbia
Christian Benítez,1,455.0,0,0,7,1,8,Ecuador
Christian Bolaños,1,332.0,0,0,4,2,6,Honduras
Christian Callejas,1,90.0,0,0,1,0,1,Uruguay
Christian Chukwu,1,41.0,0,0,2,0,2,Nigeria
Christian Coste,0,16.0,0,0,0,1,1,Belgium
Christian Cueva,2,477.0,0,2,6,5,11,Brazil
Christian Dailly,0,104.0,0,0,1,2,3,Iceland
Christian Dalger,0,89.0,0,0,1,0,1,France
Christian Eriksen,1,918.0,0,6,9,9,18,Iceland
Christian Fassnacht,0,147.0,0,0,1,1,2,Gibraltar
Christian Gytkjær,0,286.0,0,0,1,3,4,Switzerland
Christian Holst,0,101.0,0,0,2,0,2,Faroe Islands
Christian Høgni Jacobsen,0,78.0,0,0,0,1,1,Luxembourg
Christian Javier Bautista,0,112.0,0,0,1,1,2,El Salvador
Christian Karembeu,0,29.0,0,0,0,1,1,Romania
Christian Lara,0,53.0,0,0,1,0,1,Ecuador
Christian Lopez,1,23.0,0,0,1,0,1,France
Christian M'Wokozhi,0,79.0,0,0,0,1,1,Tanzania
Christian Matthey,0,54.0,0,0,1,0,1,Switzerland
Christian Mayrleb,0,200.0,0,0,2,2,4,San Marino
Christian Mouritsen,0,90.0,0,0,0,1,1,Slovenia
Christian Noboa,1,209.0,0,0,3,0,3,Ecuador
Christian Nørgaard,0,39.0,0,0,0,1,1,Moldova
Christian Obodo,1,159.0,0,0,2,1,3,Algeria
Christian Panucci,1,166.0,0,0,1,2,3,Estonia
Christian Perez,0,3.0,0,0,0,1,1,Yugoslavia
Christian Poulsen,0,231.0,0,0,3,1,4,Denmark
Christian Pulisic,1,894.0,0,2,12,4,16,Saint Vincent and the Grenadines
Christian Ramos,0,114.0,0,0,1,1,2,Paraguay
Christian Santamaría,0,117.0,0,0,0,3,3,Saint Vincent and the Grenadines
Christian Santos,0,64.0,0,0,0,1,1,Brazil
Christian Stumpf,0,70.0,0,0,0,1,1,Northern Ireland
Christian Vieri,9,679.0,0,0,15,3,18,Italy
Christian Wilhelmsson,0,382.0,0,0,1,6,7,Iceland
Christian Ziege,1,177.0,0,0,5,0,5,Germany
Christoffer Nyman,0,24.0,0,0,0,1,1,Belarus
Christoph Baumgartner,1,145.0,0,0,1,3,4,Austria
Christoph Metzelder,0,20.0,1,0,0,1,1,Germany
Christophe Berra,0,9.0,0,0,1,0,1,Scotland
Christophe Bonvin,0,54.0,0,0,1,0,1,Switzerland
Christophe Cocard,0,90.0,0,0,1,0,1,France
Christophe Dugarry,1,215.0,0,0,3,3,6,France
Christophe Jallet,0,68.0,0,0,1,0,1,France
Christophe Ohrel,0,297.0,0,0,4,2,6,Switzerland
Christopher Harry,0,82.0,0,1,1,0,1,Saint Vincent and the Grenadines
Christopher Katongo,6,683.0,0,2,5,5,10,Zambia
Christopher Samba,0,61.0,0,0,1,0,1,Congo
Christopher Trimmel,0,22.0,0,0,1,0,1,Austria
Christopher Wreh,0,51.0,0,0,2,0,2,Liberia
Christos Aravidis,0,87.0,0,0,0,1,1,Northern Ireland
Christos Ardizoglou,0,71.0,0,0,1,0,1,Greece
Christos Kolliandris,0,57.0,0,0,1,1,2,Cyprus
Christos Patsatzoglou,0,82.0,0,0,0,1,1,Bosnia and Herzegovina
Chrysis Michael,0,93.0,0,1,1,1,2,Cyprus
Chu Gyong-Sik,1,162.0,0,0,3,0,3,North Korea
Chu Siu Kei,0,89.0,0,0,1,1,2,Malaysia
Chu Wing Wah,0,59.0,0,1,1,0,1,Hong Kong
Chuan Tan Teng,0,58.0,0,1,1,0,1,Singapore
Chuang Yao-tsung,0,23.0,0,0,1,0,1,Taiwan
Chun Keui Chiang,0,13.0,1,0,1,0,1,Australia
Chung Chor Wai,2,231.0,0,1,3,1,4,Hong Kong
Chung Hae-won,3,424.0,0,0,4,2,6,South Korea
Chung Jong-Soo,0,41.0,0,0,1,0,1,South Korea
Chung Kyu-Poong,0,235.0,0,0,3,0,3,South Korea
Chung Kyung-ho,0,55.0,0,0,0,1,1,Kuwait
Chung Nam-sik,0,42.0,0,0,0,2,2,Japan
Chung Soon-cheon,0,183.0,0,0,2,2,4,South Korea
Chung Yong-Hwan,0,1.0,0,0,1,0,1,South Korea
Chuni Goswami,1,77.0,0,0,0,1,1,Hong Kong
Chus Pereda,0,182.0,0,0,5,0,5,Spain
Ché Adams,0,211.0,0,0,2,1,3,Scotland
Chérif Fetoui,1,61.0,0,0,2,0,2,Morocco
Chérif Oudjani,0,120.0,0,0,2,0,2,Algeria
Chérif Souleymane,1,233.0,0,0,3,1,4,Guinea
Chérif Touré Mamam,1,271.0,0,0,2,2,4,Mali
Ciaran Clark,1,71.0,1,0,0,1,1,Republic of Ireland
Cicerone Manolache,0,8.0,0,0,1,0,1,Romania
Ciprian Deac,0,114.0,0,0,1,1,2,Denmark
Ciprian Marica,0,765.0,0,3,11,6,17,Armenia
Cipriano Co,0,60.0,0,1,1,0,1,Guinea-Bissau
Ciriaco Sforza,0,298.0,0,0,3,2,5,Estonia
Ciro Immobile,0,768.0,0,1,7,6,13,Israel
Clarence Goodson,0,151.0,1,0,3,1,4,United States
Clarence Seedorf,0,493.0,0,0,4,5,9,Netherlands
Claude Barthélemy,0,44.0,0,0,0,1,1,El Salvador
Claude Carrara,1,90.0,0,0,0,1,1,Fiji
Claude Nahimana,0,107.0,0,0,1,1,2,Seychelles
Claude Reiter,0,52.0,0,1,0,1,1,Russia
Claudio Caniggia,7,635.0,0,0,8,4,12,Argentina
Claudio Canti,0,29.0,1,0,1,0,1,Netherlands
Claudio García,1,57.0,0,0,1,0,1,Argentina
Claudio Gentile,0,8.0,0,0,0,1,1,Finland
Claudio Husaín,0,89.0,0,0,0,1,1,Chile
Claudio Jara,0,33.0,0,0,0,1,1,United States
Claudio López,1,412.0,0,0,4,4,8,Colombia
Claudio Marchisio,1,36.0,0,0,0,2,2,Serbia
Claudio Pizarro,3,438.0,0,1,7,3,10,Peru
Claudio Reyna,0,5.0,0,0,0,1,1,Canada
Claudio Sulser,0,188.0,0,0,5,0,5,Switzerland
Claudio Suárez,0,119.0,0,0,1,1,2,Saint Vincent and the Grenadines
Claudiu Keșerü,0,514.0,0,0,4,5,9,Andorra
Claus Bech Jørgensen,0,21.0,0,0,0,1,1,Cyprus
Claus Jensen,0,128.0,0,0,1,3,4,Malta
Claus Lundekvam,0,30.0,0,0,1,1,2,Norway
Clayton Blackmore,0,71.0,0,0,1,0,1,Wales
Clayton Donaldson,0,62.0,0,0,0,1,1,Haiti
Clayton Failla,0,87.0,0,1,1,1,2,Malta
Clayton Lewis,1,90.0,0,1,1,0,1,New Zealand
Clayton Zane,6,366.0,0,0,4,2,6,Australia
Cle Kooiman,0,103.0,0,0,1,0,1,United States
Clemens Fritz,0,69.0,0,0,2,0,2,Germany
Clement Temile,2,122.0,0,0,0,3,3,Malawi
Clemente Rolón,0,97.0,0,0,2,0,2,Paraguay
Cleon Wondel,1,44.0,0,0,0,1,1,Montserrat
Clevon Hill,0,15.0,0,0,0,1,1,Montserrat
Cliff Jones,0,145.0,0,1,3,0,3,Wales
Cliff Magnam Valcin,0,204.0,0,0,1,2,3,Aruba
Clifford Odame,0,72.0,0,1,1,0,1,Ghana
Clifton Msiya,1,35.0,0,0,1,0,1,Malawi
Clifton Sandvliet,0,178.0,0,0,3,1,4,Suriname
Climaco Cañarte,0,74.0,0,0,1,0,1,Ecuador
Clint Dempsey,7,1684.0,0,4,30,11,41,United States
Clint Marcelle,1,59.0,0,0,1,0,1,Trinidad and Tobago
Clint Mathis,0,174.0,0,0,0,3,3,Barbados
Clinton Morrison,0,160.0,0,0,1,3,4,Russia
Clinton N'Jie,1,69.0,0,0,1,1,2,Cameroon
Clive Campbell,0,16.0,0,0,1,0,1,New Zealand
Clive Murray,1,190.0,0,0,2,1,3,Grenada
Clodoaldo,1,44.0,0,0,1,0,1,Brazil
Cloudious Zviripayi,0,52.0,0,0,1,0,1,Zimbabwe
Clyde Best,0,51.0,0,0,0,1,1,United States
Cláudio Christovam de Pinho,2,303.0,0,1,5,0,5,Brazil
Cláudio Ibrahim Vaz Leal,0,107.0,0,0,1,1,2,Venezuela
Cléber Chalá,1,213.0,0,0,4,0,4,Ecuador
Clément Lenglet,0,52.0,0,0,1,0,1,France
Clésio,0,6.0,0,0,1,0,1,Mozambique
Clésio Baúque,0,84.0,0,0,1,0,1,Mozambique
Cobi Jones,1,436.0,0,0,3,3,6,United States
Cody Gakpo,2,192.0,0,0,2,2,4,Netherlands
Coen Dillen,0,72.0,0,0,1,0,1,Netherlands
Coffi Agbessi,0,81.0,0,0,1,0,1,Benin
Colin Bell,0,198.0,0,0,2,1,3,Wales
Colin Bennett,0,85.0,0,0,0,1,1,Hong Kong
Colin Calderwood,0,85.0,0,0,0,1,1,San Marino
Colin Cameron,0,152.0,0,0,2,0,2,Scotland
Colin Clarke,4,414.0,0,1,6,4,10,Northern Ireland
Colin Curran,1,58.0,1,0,1,0,1,German DR
Colin Hendry,0,129.0,0,0,2,1,3,Malta
Colin Hill,0,44.0,0,0,0,1,1,Yugoslavia
Colin Latimour,0,90.0,0,0,1,0,1,New Zealand
Colin Miller,1,153.0,0,0,1,2,3,Jamaica
Colin Murdock,0,58.0,0,0,1,0,1,Northern Ireland
Colin Stein,0,269.0,0,0,4,2,6,Cyprus
Colin Walker,0,214.0,0,1,4,0,4,New Zealand
Collen Salelwako,0,72.0,0,0,1,0,1,Eswatini
Collin Samuel,0,63.0,0,0,1,0,1,Trinidad and Tobago
Collins Mbesuma,1,540.0,0,0,5,5,10,Congo
Comlan Lambert Sossa,0,21.0,0,0,0,1,1,Ethiopia
Commins Menapi,10,624.0,0,0,5,7,12,Solomon Islands
Con Boutsianis,0,231.0,0,0,4,0,4,Australia
Con Martin,0,173.0,0,2,3,0,3,Republic of Ireland
Connor Roberts,1,179.0,0,0,1,1,2,Turkey
Conny Torstensson,1,140.0,0,0,1,1,2,Sweden
Conor Casey,0,121.0,0,0,0,2,2,Honduras
Conor Hourihane,0,36.0,0,0,1,0,1,Republic of Ireland
Conor McLaughlin,0,66.0,0,0,1,0,1,Northern Ireland
Conor Washington,0,199.0,0,1,1,3,4,Northern Ireland
Constantin Barbu,0,53.0,0,0,0,1,1,Liechtenstein
Constantin Budescu,0,120.0,0,1,2,2,4,Faroe Islands
Constantin Dinulescu,0,81.0,0,0,1,0,1,Romania
Constantin Frățilă,0,213.0,0,0,3,2,5,Romania
Constantin Gâlcă,0,182.0,0,0,3,0,3,Romania
Constantin Pană,0,55.0,0,0,1,0,1,Romania
Constantin Stanciu,1,79.0,0,0,0,1,1,Peru
Constantinos Charalambides,0,277.0,0,0,6,0,6,Cyprus
Constantinos Makrides,0,152.0,0,0,3,1,4,Cyprus
Cor van der Gijp,0,57.0,0,0,2,0,2,Netherlands
Cordell Cato,1,14.0,0,0,1,0,1,Trinidad and Tobago
Corentin Tolisso,0,9.0,0,0,0,1,1,Albania
Cornel Cacoveanu,0,67.0,0,0,1,0,1,Romania
Cornel Dinu,0,85.0,0,0,1,0,1,Romania
Cornelio Heredia,1,140.0,0,2,0,2,2,Bolivia
Cornelius Casey,0,20.0,0,0,0,1,1,Haiti
Cornelius Stewart,0,134.0,0,0,2,1,3,Saint Vincent and the Grenadines
Cornell Glen,1,234.0,0,0,2,2,4,Trinidad and Tobago
Corriolan Wadson,1,71.0,0,0,1,0,1,Haiti
Corry Evans,0,70.0,0,0,0,1,1,Slovenia
Cory Burke,1,14.0,0,0,0,1,1,Guadeloupe
Cosme da Silva Campos,0,114.0,0,0,1,1,2,Brazil
Cosmin Contra,0,522.0,1,0,3,5,8,Georgia
Costa Khaiseb,0,89.0,0,0,1,0,1,Namibia
Costakis Pierides,0,31.0,0,0,1,0,1,Cyprus
Costas Costa,0,63.0,0,0,0,1,1,Austria
Costas Fasouliotis,0,87.0,0,0,1,0,1,Cyprus
Costin Lazăr,0,129.0,0,0,1,1,2,Romania
Costinha,1,90.0,0,0,0,1,1,Romania
Covi Adé,1,81.0,0,0,0,1,1,Mali
Craig Beattie,0,89.0,0,0,1,0,1,Scotland
Craig Bellamy,0,348.0,0,0,2,5,7,Denmark
Craig Burley,1,87.0,0,0,2,0,2,Scotland
Craig Cathcart,0,31.0,0,0,0,1,1,Finland
Craig Foster,5,404.0,0,0,6,1,7,Australia
Craig Goodwin,1,81.0,0,0,1,1,2,Australia
Craig Mackail-Smith,0,32.0,0,0,0,1,1,Liechtenstein
Craig Moore,1,38.0,0,1,0,1,1,Croatia
Crescencio Gutiérrez,0,209.0,0,0,5,1,6,Mexico
Cris,0,84.0,1,0,1,0,1,Argentina
Cristhian Stuani,0,122.0,0,0,1,1,2,Uruguay
Cristian Arrieta,0,4.0,0,0,1,0,1,Puerto Rico
Cristian Brolli,0,85.0,3,0,2,1,3,San Marino
Cristian Castillo,0,104.0,0,0,1,1,2,El Salvador
Cristian Chivu,1,29.0,0,0,0,2,2,England
Cristian Gamboa,0,85.0,1,0,2,1,3,Costa Rica
Cristian Gil,0,31.0,0,0,1,0,1,El Salvador
Cristian Gonzáles,0,90.0,0,0,4,0,4,Indonesia
Cristian Manea,0,18.0,0,0,1,0,1,Romania
Cristian Martínez,0,111.0,0,0,0,3,3,Republic of Ireland
Cristian Montecinos,3,240.0,0,0,1,2,3,Ecuador
Cristian Queliz,0,87.0,0,0,0,1,1,Aruba
Cristian Ramírez,0,23.0,0,0,1,0,1,Ecuador
Cristian Riveros,2,450.0,0,0,6,2,8,Paraguay
Cristian Rodríguez,1,414.0,0,0,4,4,8,Argentina
Cristian Romero,0,3.0,0,0,0,1,1,Colombia
Cristian Tănase,0,112.0,0,0,1,1,2,Austria
Cristian Zaccardo,1,105.0,1,0,1,1,2,Italy
Cristiano Ronaldo,18,4901.0,0,16,50,41,91,Portugal
Cristián Zapata,0,8.0,0,0,0,1,1,United States
Cristóbal Parralo,0,5.0,0,0,1,0,1,Spain
Csaba Vidáts,0,111.0,0,0,2,0,2,Hungary
Cuauhtémoc Blanco,14,1983.0,0,11,23,11,34,Mexico
Curtis Joseph,0,64.0,0,0,2,0,2,Saint Vincent and the Grenadines
Custódio Pinto,0,19.0,0,0,0,1,1,Sweden
Cuthbert Malajila,0,83.0,0,0,0,1,1,Namibia
Cyle Larin,9,784.0,0,2,13,7,20,Dominica
Cyril Mourgine,0,32.0,0,0,1,0,1,Mauritius
Cyrille Bayala,1,25.0,0,0,1,0,1,Burkina Faso
Cyrille Makanaky,0,78.0,0,0,0,1,1,Morocco
Cyrille Mubiala Kitambala,0,21.0,0,0,1,0,1,DR Congo
Cyrus Christie,1,27.0,0,0,0,1,1,Gibraltar
Cédric Amissi,0,231.0,0,0,4,0,4,Burundi
Cédric Bakambu,4,213.0,0,1,0,5,5,Tunisia
Cédric Soares,1,86.0,0,0,1,0,1,Portugal
Cédrick Fiston,1,54.0,0,0,1,0,1,Guadeloupe
Célestin Oliver,0,17.0,0,0,2,0,2,France
César Augusto Freire,1,47.0,0,0,0,1,1,Argentina
César Azpilicueta,1,57.0,0,0,0,1,1,Croatia
César Brito,0,22.0,0,0,1,0,1,Portugal
César Cabrera,3,135.0,0,0,1,2,3,Ecuador
César Cueto,1,151.0,0,0,3,0,3,Peru
César Delgado,1,119.0,0,0,1,1,2,Venezuela
César Eduardo González,1,120.0,0,1,2,0,2,Venezuela
César García Peralta,0,41.0,0,0,0,1,1,Cayman Islands
César Garnica,0,51.0,0,0,1,0,1,Ecuador
César Larios,0,58.0,0,0,1,0,1,El Salvador
César Lolohea,0,271.0,0,0,3,1,4,New Caledonia
César López Fretes,4,234.0,0,0,2,2,4,Colombia
César Martín,0,119.0,0,0,2,0,2,Spain
César Obando,0,330.0,0,1,4,1,5,Honduras
César Rostrán,0,65.0,0,0,0,1,1,El Salvador
César Sampaio,3,107.0,0,0,3,1,4,Saudi Arabia
César Socarraz,1,53.0,0,0,0,1,1,Argentina
César Yanis,1,126.0,0,0,1,1,2,Panama
César Zeoula,1,38.0,0,1,1,0,1,New Caledonia
Cătălin Carp,0,29.0,0,0,1,0,1,Moldova
Cătălin Munteanu,0,30.0,0,0,1,0,1,Romania
D'Andre Bishop,1,45.0,0,0,1,0,1,Antigua and Barbuda
DaMarcus Beasley,1,755.0,0,0,11,2,13,United States
Daan Schrijvers,0,48.0,0,1,1,0,1,Netherlands
Dadley Fichite,0,105.0,0,0,0,2,2,Libya
Dado Pršo,1,351.0,0,0,7,1,8,Croatia
Dag Szepanski,0,57.0,0,1,1,0,1,Sweden
Dagne Tesfaye,0,37.0,0,0,1,0,1,Ethiopia
Dagoberto Moll,2,107.0,0,0,0,2,2,Bolivia
Dahi Al Naemi,1,151.0,0,0,2,2,4,China PR
Dahiru Sadi,0,18.0,0,0,1,0,1,Nigeria
Dahmed Ould Teguedi,0,68.0,0,0,0,1,1,Morocco
Dai Davies,0,24.0,1,0,1,0,1,Czechoslovakia
Daichi Kamada,0,192.0,0,0,3,0,3,Japan
Dairon Reyes,1,90.0,0,0,1,0,1,Cuba
Daizen Maeda,1,43.0,0,0,1,0,1,Japan
Dale Mitchell,3,389.0,0,0,4,2,6,Canada
Daler Kuzyayev,0,3.0,0,0,0,1,1,San Marino
Daley Blind,1,62.0,0,0,1,1,2,Brazil
Dalibor Stevanović,0,68.0,0,0,0,1,1,San Marino
Dalton Eiley,1,49.0,1,0,1,0,1,Costa Rica
Damani Horton,0,66.0,0,0,1,0,1,Bahamas
Damani Ralph,0,77.0,0,0,1,0,1,Jamaica
Dame N'Doye,1,144.0,0,0,2,0,2,Senegal
Damian Kądzior,0,84.0,0,0,1,0,1,Poland
Damian Mori,5,928.0,0,0,23,2,25,Tahiti
Damian Szymański,0,90.0,0,0,1,0,1,Poland
Damien Duff,1,140.0,0,0,1,2,3,Saudi Arabia
Damien Kamilou,0,90.0,0,0,0,1,1,Ghana
Damion Lowe,0,56.0,0,0,1,0,1,Jamaica
Damion Stewart,1,45.0,0,0,1,0,1,Jamaica
Damir Desnica,0,90.0,0,0,0,1,1,Romania
Damir Kojašević,0,36.0,0,0,0,1,1,Armenia
Damián Ariel Álvarez,0,89.0,0,0,0,1,1,Saint Vincent and the Grenadines
Damon Ming,0,151.0,0,0,3,1,4,Bermuda
Dan Brzokoupil,0,61.0,0,0,0,1,1,Republic of Ireland
Dan Coe,0,23.0,0,0,0,1,1,Czechoslovakia
Dan Corneliusson,0,215.0,0,0,4,2,6,Cyprus
Dan Eggen,1,126.0,0,0,1,1,2,Norway
Dan Einbinder,0,66.0,0,0,0,1,1,Albania
Dan Petrescu,1,485.0,0,0,6,2,8,Romania
Dan Wagalauka,0,75.0,0,0,1,0,1,Uganda
Dane Richards,0,165.0,0,0,2,0,2,Jamaica
Dangelo Bautista,0,62.0,1,0,1,0,1,Canada
Dango Ouattara,1,45.0,0,0,1,0,1,Burkina Faso
Dani Alves,1,312.0,0,0,2,3,5,Brazil
Dani Güiza,2,338.0,0,0,0,4,4,Greece
Dani Olmo,1,204.0,0,0,3,1,4,Spain
Dani Osvaldo,0,186.0,0,0,0,4,4,Bulgaria
Daniar Kenzhekhanov,0,23.0,0,0,1,0,1,Kazakhstan
Daniel Addo,0,64.0,0,0,1,0,1,Ghana
Daniel Agger,1,304.0,1,5,6,1,7,Denmark
Daniel Alejandro Lembo,1,22.0,0,0,1,0,1,Uruguay
Daniel Amokachi,4,598.0,0,0,7,3,10,Nigeria
Daniel Anyanzwa,0,44.0,0,0,1,0,1,Kenya
Daniel Arismendi,0,139.0,0,0,3,0,3,Venezuela
Daniel Arudhi Nicodémus,1,60.0,0,0,1,0,1,Kenya
Daniel Ballard,0,20.0,0,0,0,1,1,Lithuania
Daniel Batista Lima,0,125.0,0,0,2,0,2,Greece
Daniel Bertoni,2,278.0,0,0,4,0,4,Argentina
Daniel Borimirov,1,132.0,0,0,3,0,3,Bulgaria
Daniel Braaten,0,87.0,0,0,2,0,2,Norway
Daniel Chitsulo,0,47.0,0,0,1,1,2,Malawi
Daniel Cousin,1,297.0,0,0,3,2,5,Gabon
Daniel Díaz,0,56.0,0,0,1,0,1,Argentina
Daniel Ebomoa,0,19.0,0,0,0,1,1,Cameroon
Daniel Fonseca,1,258.0,0,0,4,1,5,South Korea
Daniel Gygax,0,84.0,0,0,0,1,1,Cyprus
Daniel Hasler,0,123.0,1,0,0,2,2,Northern Ireland
Daniel Imbert,2,228.0,0,0,2,2,4,Mauritius
Daniel James,0,156.0,0,0,2,1,3,Wales
Daniel Jeandupeux,0,10.0,0,0,1,0,1,Switzerland
Daniel Jensen,0,119.0,0,0,0,2,2,Liechtenstein
Daniel Jimenez,1,23.0,0,0,1,0,1,Belize
Daniel Johnson,0,50.0,0,0,1,0,1,Jamaica
Daniel Kaufmann,0,20.0,1,0,1,0,1,Germany
Daniel Killer,0,111.0,0,0,3,0,3,Argentina
Daniel Kolář,0,90.0,0,0,0,1,1,Armenia
Daniel Majstorović,0,52.0,0,0,1,0,1,Sweden
Daniel Niculae,0,127.0,0,0,2,0,2,Romania
Daniel Noriega,0,45.0,0,0,1,1,2,Uruguay
Daniel O'Shaughnessy,0,73.0,0,0,0,1,1,Bosnia and Herzegovina
Daniel Osorno,3,360.0,0,0,4,2,6,Mexico
Daniel Pancu,0,215.0,0,0,2,3,5,Romania
Daniel Passarella,2,231.0,0,2,4,2,6,Argentina
Daniel Pinto,1,166.0,0,0,1,1,2,Brunei
Daniel Prodan,0,82.0,0,0,1,0,1,Romania
Daniel Pudil,0,79.0,0,0,0,2,2,Cyprus
Daniel Reyes,0,88.0,0,0,0,1,1,Panama
Daniel Ruiz,2,198.0,0,1,1,3,4,Austria
Daniel Shepherd,1,55.0,0,0,0,1,1,Solomon Islands
Daniel Sjölund,0,53.0,0,0,1,0,1,Finland
Daniel Sosah,0,114.0,0,0,1,1,2,Algeria
Daniel Sturridge,2,339.0,0,1,5,1,6,San Marino
Daniel Ulloa,0,49.0,1,0,0,1,1,Peru
Daniel Van Buyten,0,465.0,0,0,1,6,7,Scotland
Daniel Velasquez,0,3.0,0,0,0,1,1,Saint Vincent and the Grenadines
Daniel Veyt,1,59.0,0,0,0,1,1,Paraguay
Daniel Wass,0,14.0,0,0,1,0,1,Denmark
Daniel Xuereb,0,44.0,0,0,0,1,1,Cyprus
Daniel da Mota,0,159.0,0,0,2,1,3,Luxembourg
Daniel Šmejkal,0,5.0,0,1,1,0,1,Czech Republic
Daniele De Rossi,4,621.0,0,3,11,4,15,Italy
Daniele Massaro,1,48.0,0,0,1,0,1,Italy
Danijel Ljuboja,0,88.0,0,0,0,1,1,Wales
Danijel Pranjić,0,90.0,0,0,1,0,1,Croatia
Danilo Alvim,0,79.0,0,0,1,0,1,Brazil
Danilo Menezes,0,61.0,0,0,1,0,1,Uruguay
Danilo Montero Campos,1,108.0,0,0,0,2,2,Guatemala
Danilo Pereira,0,42.0,0,0,1,0,1,Portugal
Danilo Popivoda,0,76.0,0,0,2,0,2,Yugoslavia
Danilo Turcios,1,264.0,0,0,3,2,5,El Salvador
Danival,0,132.0,0,0,1,2,3,Venezuela
Danko Lazović,0,301.0,0,0,2,3,5,Poland
Danny,0,140.0,0,0,1,1,2,Portugal
Danny Blind,0,87.0,0,0,0,1,1,Greece
Danny Halligan,0,200.0,0,1,2,1,3,New Zealand
Danny Hay,1,88.0,0,0,1,0,1,New Zealand
Danny Koevermans,0,43.0,0,0,1,0,1,Netherlands
Danny Moulis,2,270.0,0,0,2,1,3,New Caledonia
Danny Mrwanda,0,148.0,0,0,1,1,2,Tanzania
Danny Tiatto,1,24.0,0,0,1,0,1,Australia
Danny Wabo,0,37.0,0,0,1,0,1,Solomon Islands
Danny Ward,0,49.0,1,0,1,0,1,Czech Republic
Danny Welbeck,1,752.0,0,0,8,4,12,Sweden
Dante,0,45.0,0,0,1,0,1,Brazil
Dante Leverock,2,106.0,0,0,1,2,3,Bahamas
Danylo Sikan,0,90.0,0,0,0,1,1,Kazakhstan
Daoud Midtadi,0,6.0,0,0,0,1,1,Madagascar
Dare Vršič,0,135.0,0,0,2,0,2,Slovenia
Darijo Srna,2,538.0,0,2,8,5,13,Croatia
Darimosuvito Devaraj,0,121.0,0,0,2,0,2,Singapore
Darimosuvito Tokijan,0,125.0,0,0,4,0,4,Singapore
Dario Khan,2,67.0,2,0,1,1,2,Mozambique
Dario Pereyra,0,72.0,0,0,2,0,2,Uruguay
Dario Sierra,0,40.0,1,0,0,1,1,Aruba
Dario Zuffi,0,64.0,0,0,0,1,1,Portugal
Dario Đumić,0,82.0,0,0,1,0,1,Bosnia and Herzegovina
Dario Šimić,0,91.0,0,0,0,2,2,Malta
Darius Maciulevičius,0,129.0,0,0,2,2,4,Estonia
Darius Miceika,0,85.0,0,0,1,0,1,Lithuania
Darius Vassell,0,75.0,0,0,1,0,1,England
Dariusz Adamczuk,0,36.0,0,0,1,0,1,Poland
Dariusz Dudka,0,6.0,0,0,1,0,1,Poland
Dariusz Dziekanowski,0,427.0,0,0,6,3,9,Poland
Dariusz Marciniak,0,26.0,0,0,0,1,1,Hungary
Darko Churlinov,0,83.0,0,0,0,1,1,Liechtenstein
Darko Kovačević,1,129.0,0,0,2,0,2,Serbia
Darko Maletić,0,90.0,0,0,1,0,1,Bosnia and Herzegovina
Darko Pančev,3,651.0,0,0,11,2,13,Cyprus
Darko Velkovski,0,205.0,2,0,2,3,5,Spain
Darren Anderton,1,20.0,0,0,0,1,1,Colombia
Darren Bent,0,134.0,0,0,0,3,3,Switzerland
Darren Debono,0,37.0,1,0,1,0,1,Slovenia
Darren Fletcher,0,163.0,0,0,3,1,4,Scotland
Darren Jackson,0,80.0,0,0,0,1,1,Latvia
Darren Mattocks,4,401.0,0,2,4,3,7,United States
Darren McClennan,0,297.0,0,0,6,2,8,New Zealand
Darren O'Dea,0,88.0,0,0,0,1,1,Faroe Islands
Darryl Gomez,0,16.0,0,0,1,0,1,Saint Kitts and Nevis
Darryl Lachman,0,41.0,0,0,0,1,1,Montserrat
Darryl Roberts,0,76.0,0,0,0,2,2,Bermuda
Darvydas Šernas,0,166.0,0,1,1,3,4,Czech Republic
Darwin Cerén,0,157.0,0,1,1,2,3,El Salvador
Darwin Lom,1,23.0,0,0,1,1,2,British Virgin Islands
Darwin Machís,2,209.0,0,0,3,2,5,Bolivia
Darwin Núñez,0,73.0,0,0,0,1,1,Colombia
Daryl Dike,0,73.0,0,0,2,0,2,United States
Daryl Ferguson,0,86.0,1,0,1,0,1,United States
Daryl Murphy,0,101.0,0,0,2,1,3,Serbia
Darío Franco,2,40.0,0,0,2,0,2,Argentina
Darío Lezcano,0,198.0,0,0,2,2,4,Paraguay
Darío Muchotrigo,0,22.0,0,0,1,0,1,Peru
Darío Rodríguez,1,137.0,0,0,3,0,3,Uruguay
Darío Silva,4,445.0,0,0,7,5,12,Paraguay
Darío Verón,0,57.0,0,0,1,0,1,Paraguay
Datsakorn Thonglao,0,327.0,0,0,1,4,5,Thailand
Dave Bowen,0,63.0,0,0,0,1,1,Israel
Dave Clements,0,69.0,0,0,1,0,1,Northern Ireland
Dave Gibson,0,42.0,0,0,1,0,1,Scotland
Dave Mitchell,0,449.0,0,0,7,1,8,Australia
Dave Taylor,0,222.0,0,0,3,0,3,New Zealand
Davi Banda,1,48.0,0,0,1,0,1,Malawi
David Abdul,0,85.0,0,0,1,0,1,Aruba
David Alaba,0,510.0,0,5,6,5,11,Austria
David Arellano,1,382.0,0,0,8,0,8,Chile
David Ayo,0,90.0,0,0,1,0,1,Cameroon
David Beckham,3,780.0,0,3,7,6,13,Colombia
David Ben Dayan,0,65.0,0,0,1,0,1,Israel
David Brooks,0,77.0,0,0,0,1,1,Croatia
David Carabott,1,273.0,0,2,1,4,5,Belarus
David Carney,1,153.0,0,0,1,1,2,Australia
David Connolly,0,179.0,0,0,4,1,5,Republic of Ireland
David Cotterill,0,13.0,0,0,1,0,1,Wales
David Edgar,0,168.0,0,0,2,0,2,Canada
David Edwards,0,84.0,0,0,1,1,2,Wales
David Embé,1,76.0,0,0,1,1,2,Guinea
David Firisua,1,84.0,0,0,1,0,1,Solomon Islands
David Fleurival,2,80.0,0,0,0,2,2,Canada
David Giles,0,63.0,0,0,1,1,2,Iceland
David Ginola,0,85.0,0,0,2,0,2,France
David Goodwillie,0,66.0,0,1,0,1,1,Spain
David Healy,0,1175.0,0,3,15,7,22,Northern Ireland
David Henry,0,61.0,0,0,0,1,1,Antigua and Barbuda
David Herd,0,144.0,0,0,2,0,2,Scotland
David Hopkin,0,142.0,0,0,2,0,2,Scotland
David Jarolím,0,49.0,0,0,1,0,1,Czech Republic
David Kelly,0,78.0,0,0,0,1,1,North Macedonia
David Kipiani,1,165.0,0,0,1,1,2,Russia
David Lafata,0,242.0,0,0,2,2,4,Czech Republic
David Limberský,0,13.0,0,0,0,1,1,Latvia
David Lowery,0,31.0,0,0,1,0,1,Turks and Caicos Islands
David Luiz,0,87.0,0,0,2,0,2,Brazil
David Martínez,0,7.0,0,0,1,0,1,Paraguay
David McCaulay,0,28.0,0,0,1,0,1,Belize
David McGoldrick,0,85.0,0,0,1,0,1,Republic of Ireland
David Muchineripi,0,29.0,0,0,1,0,1,Zimbabwe
David Mulligan,0,188.0,0,0,2,1,3,Vanuatu
David Nakhid,1,52.0,0,0,1,0,1,Trinidad and Tobago
David Narey,1,18.0,0,0,0,1,1,Brazil
David Nugent,1,90.0,0,0,0,1,1,Andorra
David Nyathi,1,79.0,0,0,0,1,1,Morocco
David O'Leary,0,40.0,0,0,1,0,1,Republic of Ireland
David Obua,0,328.0,0,1,2,3,5,Uganda
David Ospina,0,77.0,1,0,1,0,1,Peru
David Oteo,0,59.0,0,0,1,0,1,Mexico
David Owino,0,6.0,0,0,1,0,1,Kenya
David Paniagua,0,46.0,0,0,0,1,1,Peru
David Patiño,2,63.0,0,0,0,2,2,Argentina
David Phillips,0,63.0,0,0,1,0,1,Wales
David Platt,2,568.0,0,0,7,5,12,England
David Powell,0,83.0,0,0,1,0,1,Wales
David Provan,0,54.0,0,0,1,0,1,Scotland
David Ramírez,2,120.0,0,0,2,0,2,Costa Rica
David Ratcliffe,0,32.0,0,0,1,0,1,Australia
David Rugamas,1,398.0,0,0,2,6,8,El Salvador
David Silva,5,916.0,0,0,13,7,20,Russia
David Siradze,0,340.0,0,0,4,1,5,Georgia
David Stokes,0,30.0,0,0,1,0,1,Guatemala
David Strelec,0,123.0,0,0,2,0,2,Slovakia
David Suazo,2,569.0,0,0,6,5,11,El Salvador
David Targamadze,0,19.0,0,0,1,0,1,Georgia
David Trezeguet,3,763.0,0,0,9,5,14,France
David Turpel,0,219.0,0,0,2,2,4,North Macedonia
David Vaughan,0,16.0,0,0,0,1,1,Liechtenstein
David Villa,18,2063.0,0,4,26,15,41,Slovakia
David Watson,0,111.0,0,0,2,1,3,England
David Weir,0,53.0,0,0,1,0,1,Scotland
David Wotherspoon,1,25.0,0,0,0,1,1,Cayman Islands
David Zdrilic,2,908.0,0,0,17,0,17,Australia
David Zeman,0,16.0,1,0,1,0,1,Israel
Davide Astori,1,24.0,0,0,0,1,1,Uruguay
Davide Gualtieri,1,1.0,0,0,1,0,1,San Marino
Davide Simoncini,0,24.0,2,0,2,0,2,Sweden
Davie Cooper,0,195.0,0,2,3,1,4,Wales
Davie Wilson,0,37.0,0,0,0,1,1,Finland
Davit Janashia,0,66.0,0,0,0,1,1,Moldova
Davit Mujiri,0,16.0,0,0,0,1,1,Faroe Islands
Davor Jozić,2,130.0,0,0,1,1,2,Germany
Davor Vugrinec,0,319.0,0,0,2,2,4,Malta
Davor Šuker,8,1774.0,0,6,15,17,32,Yugoslavia
Davron Ergashev,0,81.0,0,0,0,1,1,Mongolia
Davy Arnaud,0,6.0,0,0,1,0,1,United States
Davy Klaassen,1,278.0,0,0,2,4,6,Netherlands
Davy Pröpper,0,112.0,0,0,2,1,3,Netherlands
Davy Walsh,0,92.0,0,0,1,1,2,Sweden
Dawa Hotessa,0,4.0,0,0,0,1,1,Cameroon
Dawit Fekadu,0,83.0,0,0,2,0,2,Ethiopia
Dawood Ali,0,54.0,0,0,1,0,1,United Arab Emirates
Dayro Moreno,0,82.0,0,0,1,0,1,Colombia
Dean Furman,0,125.0,0,0,1,1,2,South Africa
Dean Saunders,0,637.0,0,1,8,7,15,Wales
Dean Shiels,0,14.0,0,0,1,0,1,Northern Ireland
Debatik Curri,0,67.0,0,0,0,1,1,Netherlands
Declan Edge,0,13.0,0,0,1,0,1,New Zealand
Declan Rice,0,87.0,0,0,0,1,1,Hungary
Deco,2,202.0,0,1,3,1,4,Portugal
Dede Sulaiman,0,248.0,0,0,3,1,4,Indonesia
Deepak Amatya,1,19.0,0,0,0,1,1,Macau
Deepak Lama,1,67.0,0,0,0,1,1,Macau
Deividas Česnauskis,0,41.0,0,0,0,1,1,San Marino
Deivydas Matulevičius,0,67.0,0,0,1,2,3,Latvia
Dejan Damjanović,0,409.0,0,1,1,6,7,Cyprus
Dejan Govedarica,1,101.0,1,0,2,0,2,Serbia
Dejan Jakovic,1,28.0,0,0,0,1,1,French Guiana
Dejan Lazarević,0,73.0,0,0,1,0,1,Slovenia
Dejan Ljubičić,0,83.0,0,0,1,0,1,Austria
Dejan Lovren,0,234.0,0,0,0,3,3,Malta
Dejan Savićević,6,642.0,0,1,10,4,14,Yugoslavia
Dejan Stanković,2,338.0,0,1,3,6,9,Republic of Ireland
Dejo Fayemi,0,125.0,0,1,1,1,2,Ghana
Dejvi Glavevski,0,80.0,0,0,0,3,3,Liechtenstein
Dele Alli,1,97.0,0,0,1,1,2,England
Delfín Benítez Cáceres,1,44.0,0,0,0,1,1,Bolivia
"Delio ""Maravilla"" Gamboa",3,122.0,0,1,2,1,3,Argentina
Delio Gamboa,2,238.0,0,0,1,2,3,Brazil
Delio Toledo,0,10.0,0,0,1,0,1,Paraguay
Delron Buckley,0,102.0,0,0,0,3,3,Zimbabwe
Delvin N'Dinga,0,75.0,0,0,0,1,1,Ethiopia
Demar Phillips,3,300.0,0,0,6,0,6,Jamaica
Demba Camara,0,23.0,0,0,1,0,1,Guinea
Demba Malick,0,45.0,0,0,0,1,1,Madagascar
Deme N'Diaye,1,10.0,0,0,0,1,1,Libya
Demetrio Albertini,0,88.0,0,0,1,1,2,Italy
Demetrio Angola,1,75.0,0,0,0,1,1,Argentina
Demetrio Neyra,0,31.0,0,0,1,0,1,Peru
Demetris Christofi,0,326.0,0,1,3,2,5,Cyprus
Demis Nikolaidis,0,359.0,0,0,5,3,8,Finland
Demont Mitchell,0,52.0,0,0,1,0,1,Bahamas
Demóstenes Correia de Syllos,1,29.0,0,0,1,0,1,Brazil
Deng Chyan,0,90.0,0,0,1,0,1,Taiwan
Deng Zhuoxiang,1,216.0,0,0,0,3,3,Kuwait
Deni Milošević,0,80.0,0,0,1,0,1,Bosnia and Herzegovina
Denijal Pirić,0,60.0,0,0,0,1,1,Finland
Denil Maldonado,0,10.0,1,0,0,1,1,Honduras
Denis Calincov,0,90.0,0,0,0,1,1,Israel
Denis Caniza,0,19.0,1,0,1,0,1,Chile
Denis Cheryshev,0,425.0,1,0,4,6,10,Russia
Denis Glushakov,1,258.0,0,0,3,1,4,Russia
Denis Houf,0,16.0,0,0,0,1,1,France
Denis Irwin,0,11.0,0,1,2,0,2,Republic of Ireland
Denis Knitel,1,20.0,0,0,1,0,1,Tajikistan
Denis Kovba,0,18.0,0,0,1,0,1,Belarus
Denis Law,0,344.0,0,0,4,3,7,Scotland
Denis Obua,2,185.0,0,0,0,3,3,Ivory Coast
Denis Zakaria,1,125.0,1,0,1,2,3,Georgia
Denis Zmeu,0,30.0,0,0,1,0,1,Moldova
Deniss Ivanovs,0,71.0,0,0,0,1,1,Switzerland
Deniz Bozkurt,0,16.0,0,0,1,0,1,Puerto Rico
Deniz Türüç,0,57.0,0,0,0,1,1,Moldova
Denmark Casey,0,60.0,0,0,0,1,1,Panama
Dennis Alas,1,81.0,0,0,1,0,1,El Salvador
Dennis Bergkamp,10,1398.0,0,1,15,12,27,Netherlands
Dennis Bryce,0,12.0,0,0,1,0,1,Samoa
Dennis Lawrence,0,120.0,0,0,1,1,2,Trinidad and Tobago
Dennis Lota,4,297.0,0,0,5,2,7,Burkina Faso
Dennis López,0,123.0,0,0,1,1,2,Guatemala
Dennis Man,0,145.0,0,0,0,3,3,Malta
Dennis Marshall,1,56.0,0,0,1,0,1,Costa Rica
Dennis Mizzi,0,23.0,0,0,0,1,1,Portugal
Dennis Oliech,1,694.0,0,0,11,5,16,Kenya
Dennis Praet,1,82.0,0,0,1,1,2,Belgium
Dennis Purperhart,0,14.0,0,0,1,0,1,Suriname
Dennis Rennie,0,90.0,0,0,1,0,1,Grenada
Dennis Rommedahl,2,488.0,0,0,4,11,15,Northern Ireland
Dennis Salanović,0,85.0,0,0,0,1,1,Greece
Dennis Tindall,0,50.0,0,0,0,1,1,Australia
Dennis Tueart,0,4.0,0,0,1,0,1,England
Dennis Viollet,0,37.0,0,0,1,0,1,England
Dennis Wilshaw,0,163.0,0,0,0,3,3,Wales
Dennis Wise,0,32.0,0,0,0,1,1,Turkey
Densill Theobald,0,73.0,0,0,1,0,1,Trinidad and Tobago
Denys Harmash,0,108.0,0,0,1,1,2,Montenegro
Denzel Dumfries,1,281.0,0,0,4,0,4,Netherlands
Denílson de Oliveira Araújo,4,277.0,0,0,4,1,5,Brazil
Denís Milar,0,116.0,0,1,2,0,2,Uruguay
Deon Burton,0,439.0,0,0,5,3,8,Jamaica
Deon Kavendji,0,77.0,0,0,1,0,1,Namibia
Deon McCaulay,7,962.0,0,1,8,10,18,Belize
Derby Makinka,0,98.0,0,0,2,0,2,Zambia
Dereck Somanje,0,53.0,0,0,1,0,1,Malawi
Derek Dougan,0,139.0,0,0,2,2,4,Poland
Derek Kevan,2,140.0,0,0,1,1,2,England
Derek Malas,1,137.0,0,0,2,0,2,Vanuatu
Derek Spence,0,151.0,0,0,1,1,2,Netherlands
Derlis González,2,229.0,0,1,1,3,4,Brazil
Derlis Soto,0,165.0,0,0,2,0,2,Paraguay
Dermot Curtis,0,144.0,0,0,1,2,3,Republic of Ireland
Derrick Edwards,0,328.0,0,0,4,2,6,Antigua and Barbuda
Derrick Etienne,0,63.0,0,0,1,0,1,Haiti
Derrik Garden,0,81.0,1,0,1,0,1,El Salvador
Des Palmer,0,155.0,0,0,3,0,3,Wales
Deshawon Nembhard,1,81.0,0,0,1,0,1,Belize
Desiderio Medina,0,59.0,0,0,3,0,3,Chile
Desmond Armstrong,0,31.0,1,0,1,0,1,Mexico
Desmond Bleau,0,60.0,0,0,0,1,1,Guatemala
Desmond Fa'aiuaso,5,254.0,0,0,1,4,5,American Samoa
Devarr Boyles,0,6.0,0,0,1,0,1,Bermuda
Devaughn Elliott,0,44.0,0,0,0,1,1,Saint Lucia
Devaun DeGraff,0,43.0,0,0,0,2,2,Cayman Islands
Dever Orgill,0,56.0,0,0,2,0,2,Jamaica
Devi Muka,0,90.0,0,0,1,0,1,Albania
Devin Vega,0,62.0,0,0,1,0,1,Puerto Rico
Devon Jarrett,2,117.0,0,0,1,1,2,Honduras
Dewan Chand,2,49.0,0,0,2,0,2,Fiji
Dexter Blackstock,0,25.0,0,0,1,0,1,Antigua and Barbuda
Dexter Walker,0,88.0,0,0,1,0,1,Mexico
Dezső Molnár,0,70.0,0,0,0,1,1,Netherlands
Dezső Novák,2,270.0,0,1,3,0,3,Hungary
Dhurgham Ismail,1,135.0,0,1,0,2,2,Iran
Diadie Samassékou,1,60.0,0,0,0,1,1,Tunisia
Diafra Sakho,0,93.0,0,0,0,2,2,Cape Verde
Diamantino Miranda,1,151.0,0,0,3,0,3,Portugal
Dick Kauma,1,89.0,0,0,0,1,1,Tahiti
Dick Nanninga,0,300.0,0,0,1,3,4,Argentina
Dick Schneider,0,48.0,0,1,1,0,1,Netherlands
Dick Schoenaker,2,251.0,0,0,3,3,6,Iceland
Dick van Dijk,0,35.0,0,0,1,0,1,Netherlands
Dickson Makwaza,0,83.0,0,0,1,0,1,Zambia
Didargylyç Urazow,0,90.0,0,0,1,0,1,Turkmenistan
Didi,13,761.0,0,1,12,2,14,Brazil
Didi Torrico,0,87.0,0,0,1,0,1,Bolivia
Didier Deschamps,0,51.0,0,0,2,0,2,France
Didier Drogba,11,1529.0,0,6,20,11,31,Ivory Coast
Didier Six,2,401.0,0,0,5,2,7,France
Didier Ya Konan,1,90.0,0,0,1,0,1,Ivory Coast
Didier Zokora,0,21.0,0,0,1,0,1,Ivory Coast
Diego,1,184.0,0,1,1,1,2,Brazil
Diego Antonio Reyes,1,38.0,0,0,1,0,1,Mexico
Diego Bejarano,0,105.0,0,0,1,1,2,Peru
Diego Calvo,0,82.0,0,0,1,0,1,Costa Rica
Diego Costa,3,411.0,0,0,3,6,9,Luxembourg
Diego Forlán,9,1436.0,0,3,16,12,28,Senegal
Diego Fuser,1,29.0,0,0,1,1,2,Wales
Diego García,1,107.0,0,0,1,1,2,Argentina
Diego Gavilán,0,77.0,0,0,0,1,1,Colombia
Diego Godín,2,400.0,2,0,2,5,7,Uruguay
Diego Latorre,1,3.0,0,0,1,0,1,Argentina
Diego Lugano,1,245.0,0,0,4,3,7,Uruguay
Diego Maradona,8,812.0,0,1,12,3,15,Argentina
Diego Milito,1,90.0,0,0,1,0,1,Argentina
Diego Pérez,1,32.0,0,0,1,1,2,Argentina
Diego Reyes,0,58.0,0,0,0,1,1,Trinidad and Tobago
Diego Rolán,0,96.0,0,0,2,0,2,Uruguay
Diego Simeone,5,279.0,0,0,6,2,8,Argentina
Diego Tristán,0,195.0,0,0,3,0,3,Spain
Dieter Erler,0,273.0,0,0,3,1,4,German DR
Dieter Müller,3,429.0,0,0,2,4,6,Yugoslavia
Dieter Ramusch,0,78.0,0,0,0,1,1,Latvia
Dietmar Hamann,0,14.0,0,0,0,1,1,England
Dietmar Kühbauer,0,58.0,0,0,3,0,3,Austria
Dietrich Albrecht,0,50.0,0,0,1,0,1,United States
Dieudonné Bassanguen,0,90.0,0,0,1,0,1,Cameroon
Dieudonné Londo,0,55.0,0,0,1,0,1,Gabon
Dieudonné Minoungou,1,50.0,0,0,1,0,1,Burkina Faso
Dieumerci Mbokani,5,653.0,0,6,9,6,15,Djibouti
Dieuphane Thelamour,0,83.0,0,0,1,0,1,Haiti
Dikilu Bageta,0,88.0,0,1,1,0,1,DR Congo
Dilshod Vasiev,0,71.0,0,0,1,0,1,Tajikistan
Dimitar Baikushev,0,27.0,0,0,1,0,1,Bulgaria
Dimitar Berbatov,0,1396.0,0,1,14,14,28,Denmark
Dimitar Makriev,0,90.0,0,0,1,0,1,Bulgaria
Dimitar Penev,0,132.0,1,0,1,1,2,Bulgaria
Dimitar Rangelov,0,79.0,0,0,3,0,3,Bulgaria
Dimitar Telkiyski,0,157.0,0,0,3,0,3,Bulgaria
Dimitar Yakimov,1,187.0,0,0,2,2,4,Bulgaria
Dimitri Payet,0,313.0,0,0,5,0,5,France
Dimitri Ramothe,1,4.0,0,0,1,0,1,Guadeloupe
Dimitrij Nazarov,0,206.0,0,0,4,0,4,Azerbaijan
Dimitris Kokkinakis,0,61.0,0,0,0,1,1,Israel
Dimitris Kolovos,0,85.0,0,0,0,1,1,Bosnia and Herzegovina
Dimitris Limnios,0,35.0,0,0,0,1,1,Armenia
Dimitris Markos,0,23.0,0,0,1,0,1,Greece
Dimitris Mavrogenidis,0,85.0,0,0,0,1,1,Georgia
Dimitris Papadopoulos,0,17.0,0,0,1,0,1,Greece
Dimitris Pelkas,0,90.0,0,0,0,1,1,Georgia
Dimitris Salpingidis,2,418.0,0,1,6,4,10,Greece
Dimitris Saravakos,0,280.0,0,0,5,3,8,Greece
Dinardo Rodríguez,0,103.0,0,1,2,2,4,Dominican Republic
Diniyar Bilyaletdinov,0,231.0,0,0,3,1,4,Israel
Dinko Dermendzhiev,1,284.0,0,0,4,2,6,Sweden
Dino Baggio,2,359.0,0,0,5,1,6,Portugal
Dino da Costa,0,56.0,0,0,0,1,1,Northern Ireland
Dinos Kouis,0,260.0,0,0,2,3,5,Denmark
Diogo Jota,0,276.0,0,0,1,5,6,Serbia
Dioh Williams,0,78.0,0,0,1,0,1,Liberia
Dioko Kaluyituka,0,126.0,0,0,2,2,4,Cape Verde
Diomandé Losseni,2,94.0,0,0,0,2,2,Ethiopia
Diomansy Kamara,1,66.0,0,0,0,1,1,Tunisia
Dioni Guerra,0,8.0,0,0,1,0,1,Venezuela
Dionisio Arce,7,280.0,0,1,2,5,7,Paraguay
Dionisio Fernandes,0,50.0,0,0,1,0,1,Guinea-Bissau
Dionisio Mejía,1,267.0,0,0,7,0,7,Mexico
Diphetogo Selolwane,0,188.0,0,0,3,2,5,Botswana
Dipsy Selolwane,1,153.0,0,1,3,1,4,Tunisia
Diquan Adamson,0,7.0,0,0,0,1,1,Bermuda
Dirceu,3,113.0,0,0,3,0,3,Brazil
Dirk Kuyt,2,834.0,0,2,10,5,15,North Macedonia
Divock Origi,1,147.0,0,0,2,0,2,Belgium
Diógenes Domínguez,2,193.0,0,0,2,1,3,Paraguay
Djakaridja Koné,1,144.0,0,0,2,0,2,Burkina Faso
Djalma Campos,1,80.0,0,0,1,1,2,Angola
Djalma Santos,1,18.0,0,1,1,0,1,Brazil
Djalminha,2,97.0,0,0,2,0,2,Brazil
Djamel Amani,0,189.0,0,0,3,0,3,Algeria
Djamel Belmadi,0,34.0,0,0,1,0,1,Algeria
Djamel Menad,1,523.0,0,0,9,3,12,Algeria
Djamel Zidane,2,132.0,0,0,2,1,3,Nigeria
Djibril Cissé,0,326.0,0,0,3,3,6,Cyprus
Djibril Ouattara,0,49.0,0,0,0,1,1,Cameroon
Djibril Sidibé,0,84.0,0,1,1,0,1,Mali
Djihad Bizimana,0,16.0,0,0,1,0,1,Rwanda
Djima Oyawolé,0,52.0,0,0,1,1,2,Togo
Djiman Koukou,0,62.0,0,0,0,1,1,Sudan
Djimy Alexis,1,81.0,0,0,1,0,1,Haiti
Djogou Akoulassi,0,53.0,0,0,0,1,1,Niger
Djumadurdy Meredov,2,186.0,0,0,2,1,3,Turkmenistan
Dmitri Alenichev,0,176.0,0,0,3,1,4,Russia
Dmitri Bulykin,1,169.0,0,0,6,0,6,Russia
Dmitri Cheryshev,0,86.0,0,0,0,1,1,San Marino
Dmitri Khokhlov,0,64.0,0,0,2,0,2,Russia
Dmitri Kirichenko,1,166.0,0,0,3,0,3,Russia
Dmitri Kombarov,0,54.0,0,1,1,0,1,Russia
Dmitri Loskov,0,145.0,0,2,2,0,2,Russia
Dmitri Radchenko,1,280.0,0,0,4,2,6,Russia
Dmitri Sychev,1,604.0,0,0,4,5,9,Belgium
Dmitri Torbinski,1,112.0,0,0,0,1,1,Netherlands
Dmitri Yurist,0,75.0,0,0,1,0,1,Kazakhstan
Dmitriy Shomko,0,90.0,1,0,1,1,2,Republic of Ireland
Dmitry Byakov,0,328.0,0,0,4,3,7,Kazakhstan
Dmitry Verkhovtsov,0,203.0,0,0,2,1,3,Andorra
Dobromir Tashkov,0,53.0,0,0,0,1,1,Romania
Dobromir Zhechev,1,40.0,0,0,1,0,1,Bulgaria
Dobrosav Krstić,0,9.0,0,0,1,0,1,Yugoslavia
Doctor Khumalo,1,21.0,0,0,0,1,1,DR Congo
Doeur Sokhom,3,123.0,0,0,2,1,3,Cambodia
Dollah Kassim,0,70.0,0,0,1,0,1,Singapore
Dollah Salleh,4,389.0,0,1,6,1,7,Malaysia
Dom Dwyer,0,50.0,0,0,1,0,1,United States
Domagoj Vida,0,175.0,0,0,1,1,2,Croatia
Domen Črnigoj,0,51.0,0,0,0,2,2,Latvia
Domenic Mobilio,0,169.0,0,0,2,1,3,Canada
Domenico Berardi,0,14.0,0,0,1,0,1,Italy
Domiciano Cavém,0,97.0,0,0,1,1,2,Portugal
Domingo Peralta,1,162.0,0,0,1,2,3,Dominican Republic
Domingo Pérez,1,173.0,0,0,1,2,3,Bolivia
Domingo Tarasconi,0,109.0,0,0,1,1,2,Argentina
Domingos Paciência,1,291.0,0,0,5,3,8,Northern Ireland
Domingues,0,119.0,0,1,1,2,3,Kenya
Dominic Abui Pretino,0,5.0,0,0,1,0,1,South Sudan
Dominic Adiyiah,0,73.0,0,0,2,0,2,Ghana
Dominic Calvert-Lewin,0,74.0,0,0,2,0,2,England
Dominic Gabriel,1,35.0,0,0,0,1,1,American Samoa
Dominic Kinnear,1,52.0,0,0,1,0,1,United States
Dominik Szoboszlai,0,229.0,0,0,4,0,4,Hungary
Dominique Bathenay,0,138.0,0,0,1,1,2,German DR
Dominique Fred,1,19.0,0,0,0,1,1,Fiji
Dominique Rocheteau,4,388.0,0,0,9,1,10,France
Dominique da Silva,0,82.0,0,1,1,0,1,Mauritania
Don Annacoura,0,52.0,0,0,1,0,1,Seychelles
Don Givens,0,552.0,0,0,10,2,12,Republic of Ireland
Don Hutchison,0,173.0,0,0,1,3,4,Bosnia and Herzegovina
Don Masson,1,78.0,0,1,0,1,1,Wales
Donald Peláez,1,148.0,0,0,0,3,3,Ecuador
Donald-Olivier Sié,3,324.0,0,0,2,2,4,Ivory Coast
Donaldo Rosales,0,66.0,0,0,1,1,2,Honduras
Donatas Kazlauskas,0,79.0,0,0,1,0,1,Lithuania
Donatas Vencevicius,0,88.0,0,0,0,1,1,Faroe Islands
Donato Gama da Silva,0,112.0,0,0,1,1,2,Spain
Donny van de Beek,0,85.0,0,0,0,1,1,Gibraltar
Donorovyn Lkhümbengarav,0,41.0,0,0,0,1,1,North Korea
Donyell Malen,0,319.0,0,0,2,2,4,Germany
Dor Peretz,0,177.0,0,0,2,1,3,Israel
Dorel Stoica,0,118.0,1,0,1,1,2,Romania
Dorin Goian,0,164.0,0,0,3,0,3,Romania
Dorin Mateuț,0,239.0,0,0,5,1,6,Romania
Dorinel Munteanu,1,635.0,0,0,4,9,13,Romania
Dorlan Pabón,0,92.0,0,0,1,1,2,Bolivia
Dorny Romero,2,49.0,0,1,0,2,2,Anguilla
Dorset Langiagne,0,56.0,0,0,1,0,1,Grenada
Dorukhan Toköz,0,40.0,0,0,0,1,1,Iceland
Dossa Júnior,0,60.0,1,0,1,1,2,Andorra
Doudou Diongue,1,10.0,0,0,0,1,1,Ghana
Doug Utjesenovic,0,11.0,0,0,1,0,1,Australia
Dougie Freedman,0,44.0,0,0,1,0,1,Scotland
Douglas Aziz,1,22.0,0,1,1,0,1,Iraq
Douglas Cadeño,0,6.0,0,0,1,0,1,Venezuela
Douglas Costa,1,113.0,0,0,3,0,3,Brazil
Douglas Sequeira,0,12.0,0,0,0,1,1,Cuba
Dové Womé,1,135.0,0,0,0,2,2,Algeria
Doyle Vaca,0,41.0,0,0,1,0,1,Bolivia
Dragan Dimitrovski,0,62.0,0,0,0,1,1,Slovakia
Dragan Džajić,2,673.0,0,0,8,7,15,Luxembourg
Dragan Mladenović,0,73.0,0,0,1,0,1,Serbia
Dragan Načevski,0,63.0,0,0,1,0,1,North Macedonia
Dragan Pantelić,0,60.0,0,2,2,0,2,Yugoslavia
Dragan Stojković,4,683.0,0,2,4,7,11,France
Dragiša Binić,0,35.0,0,0,1,0,1,Yugoslavia
Drago Vabec,0,83.0,0,0,1,0,1,Yugoslavia
Dragoslav Šekularac,0,132.0,0,0,3,0,3,Yugoslavia
Dramane Coulibaly,0,131.0,0,1,3,0,3,Mali
Dramane Traoré,1,34.0,0,0,0,1,1,Senegal
Dražan Jerković,4,501.0,0,0,1,7,8,France
Dražen Ladić,0,17.0,1,0,0,1,1,Croatia
Dražen Mužinić,0,18.0,0,0,0,1,1,Romania
Dries Mertens,3,574.0,0,0,9,3,12,Belgium
Driss Bamous,1,54.0,0,0,1,0,1,Morocco
Dshon Forbes,1,78.0,0,0,0,1,1,Turks and Caicos Islands
Du Zhenyu,0,22.0,0,0,1,0,1,China PR
Duaij Naser Abdulla,1,167.0,0,0,2,0,2,Bahrain
Duane Muckette,1,36.0,0,0,1,0,1,Trinidad and Tobago
Duberty Aráoz,1,30.0,1,0,0,1,1,Bolivia
Duckens Nazon,4,517.0,0,1,3,8,11,Panama
Duddley Hatei,0,61.0,0,0,1,0,1,Solomon Islands
Dudley Steinwall,0,81.0,0,0,1,0,1,Sri Lanka
Dudu Georgescu,0,504.0,0,2,8,1,9,Romania
Duh Deng-Sheng,0,171.0,0,0,0,2,2,Australia
Duilio Davino,1,143.0,0,0,1,1,2,Mexico
Duje Ćaleta-Car,0,22.0,0,0,0,1,1,Malta
Dumisa Ngobe,1,43.0,0,0,1,0,1,South Africa
Dumitru Marcu,0,50.0,0,0,2,0,2,Romania
Duncan Cole,0,36.0,0,0,1,0,1,New Zealand
Duncan Edwards,0,143.0,0,0,2,0,2,England
Duncan Oughton,2,155.0,0,0,2,0,2,New Zealand
Duncan Shearer,0,29.0,0,0,0,1,1,Finland
Dunga,1,11.0,0,0,1,0,1,Brazil
Dusit Chalermsan,1,96.0,0,0,0,2,2,Iraq
Dustin Corea,1,90.0,0,0,0,1,1,Costa Rica
Duván Zapata,2,188.0,0,0,2,1,3,Argentina
Dušan Bajević,3,243.0,0,0,3,3,6,Spain
Dušan Basta,0,19.0,0,0,1,0,1,Serbia
Dušan Galis,0,47.0,0,0,1,0,1,Czechoslovakia
Dušan Kabát,0,112.0,0,0,0,2,2,Turkey
Dušan Savić,0,161.0,0,0,1,1,2,Yugoslavia
Dušan Tadić,0,488.0,0,5,6,4,10,Serbia
Dušan Tittel,0,266.0,0,0,3,2,5,Slovakia
Dušan Vlahović,1,226.0,0,1,4,1,5,Serbia
Dušan Švento,0,14.0,0,0,0,1,1,Wales
Duško Tošić,0,4.0,0,0,0,1,1,Azerbaijan
Dwayne De Rosario,6,678.0,0,5,12,3,15,Canada
Dwayne Stanford,0,80.0,0,0,1,0,1,Barbados
Dwayne Thomas,0,2.0,0,0,0,1,1,British Virgin Islands
Dwight Allers Kelley,0,141.0,0,0,2,1,3,Saint Kitts and Nevis
Dwight Ferguson,0,89.0,1,0,1,0,1,Grenada
Dwight Pezzarossi,0,613.0,0,0,4,4,8,Costa Rica
Dwight Yorke,1,537.0,0,2,7,3,10,Trinidad and Tobago
Dylan Bronn,2,173.0,1,0,2,1,3,Belgium
Dylan Tavares,0,19.0,0,0,1,0,1,Cape Verde
Dzhomikhon Mukhiddinov,0,51.0,0,0,1,0,1,Tajikistan
Dzintars Zirnis,0,13.0,1,0,0,1,1,Latvia
Dániel Böde,0,327.0,0,0,4,1,5,Turkey
Dániel Gazdag,0,153.0,0,0,1,2,3,Andorra
Dániel Tőzsér,0,77.0,0,0,1,0,1,Hungary
Dário Monteiro,0,360.0,0,0,4,1,5,Mozambique
Dávid Hancko,0,85.0,0,0,0,1,1,Azerbaijan
Dávid Holman,0,71.0,0,0,0,1,1,Azerbaijan
Dölgöön Amaraa,0,17.0,0,0,1,0,1,Mongolia
Döwlet Baýramow,0,20.0,0,0,0,1,1,Sri Lanka
Dāvis Ikaunieks,0,90.0,0,0,1,1,2,Latvia
Džemaludin Mušović,0,42.0,0,0,0,1,1,Luxembourg
Dževdet Šainovski,0,55.0,0,0,0,1,1,Croatia
Džoni Novak,0,107.0,0,0,0,2,2,Estonia
E. Karitea,1,66.0,0,0,0,1,1,New Zealand
Eamonn Bannon,0,77.0,0,0,0,1,1,German DR
Eamonn Rogers,0,63.0,0,1,2,0,2,Republic of Ireland
Earl Jean,0,158.0,0,0,3,2,5,Saint Lucia
Earnie Stewart,0,640.0,0,0,8,3,11,United States
Ebbe Sand,1,626.0,0,0,9,4,13,Nigeria
Eber Moas,0,72.0,0,0,1,0,1,Uruguay
Eberhard Vogel,0,337.0,0,1,4,4,8,German DR
Ebi Smolarek,0,231.0,0,0,4,0,4,Poland
Ebrahim Isa,0,42.0,0,0,1,0,1,Bahrain
Ebrahim Taghipour,0,151.0,0,0,0,2,2,Laos
Ebrahim Zowayed,0,57.0,0,0,0,1,1,Qatar
Ebrima Ebou Sillah,0,58.0,0,0,1,0,1,Gambia
Ed Murphy,0,200.0,0,0,2,2,4,United States
Eddie Gray,0,15.0,0,0,1,0,1,Scotland
Eddie Hernández,0,147.0,0,0,1,1,2,Honduras
Eddie Johnson,1,800.0,0,1,11,5,16,El Salvador
Eddie Krncevic,2,507.0,0,0,2,5,7,New Caledonia
Eddie Lewis,0,162.0,0,0,1,3,4,United States
Eddie McMorran,0,54.0,0,0,0,1,1,England
Eddie Pope,0,70.0,0,0,4,0,4,United States
Eddie Rukumana,0,83.0,0,0,1,1,2,Papua New Guinea
Eddie Theobald,0,112.0,0,1,1,1,2,Denmark
Eddy Bembuana-Keve,1,48.0,0,0,1,0,1,DR Congo
Eddy Berdusco,0,68.0,0,0,1,0,1,Canada
Eddy Carazas,1,30.0,0,0,1,0,1,Peru
Eddy Voordeckers,0,135.0,0,0,2,0,2,Belgium
Edelbert Dinha,0,82.0,0,0,1,0,1,Zimbabwe
Edema Fuludu,0,14.0,0,0,1,0,1,Nigeria
Eden Ben Basat,0,299.0,0,0,3,3,6,Luxembourg
Eden Hazard,5,1267.0,0,6,16,8,24,Belgium
Eder,0,109.0,0,0,0,1,1,France
Edgar Alvarez,0,50.0,0,0,1,0,1,Honduras
Edgar Angulo,0,53.0,0,0,1,0,1,Colombia
Edgar Babayan,0,79.0,0,0,0,1,1,Italy
Edgar Bernhardt,0,131.0,0,2,3,1,4,Bangladesh
Edgar Davids,1,125.0,0,0,2,0,2,Netherlands
Edgar Falch,0,74.0,1,0,1,0,1,Hungary
Edgar Manucharyan,0,145.0,0,0,1,1,2,Armenia
Edgar Marín,0,164.0,0,0,1,2,3,Costa Rica
Edgar Núñez,0,90.0,0,0,1,0,1,Costa Rica
Edgar Olivares,0,10.0,0,0,1,0,1,Bolivia
Edgar Salli,0,40.0,0,0,0,1,1,Niger
Edgar Valencia,0,19.0,0,0,1,0,1,Guatemala
Edgar Çani,0,112.0,0,0,2,0,2,Albania
Edgaras Jankauskas,0,280.0,0,1,5,2,7,Lithuania
Edgaras Utkus,0,14.0,1,0,1,0,1,Italy
Edgaras Česnauskis,0,124.0,0,0,0,2,2,Liechtenstein
Edgard Meulens,0,65.0,0,0,0,1,1,Guatemala
Edgardo Adinolfi,0,51.0,0,0,1,0,1,Uruguay
Edgars Gauračs,0,77.0,0,0,1,0,1,Latvia
Edhem Šljivo,0,7.0,0,0,1,0,1,Yugoslavia
Edibily Lunyamila,0,52.0,0,0,1,0,1,Tanzania
Edimilson Fernandes,0,90.0,0,0,1,0,1,Switzerland
Edin Džeko,3,1902.0,0,2,24,18,42,Bosnia and Herzegovina
Edin Mujčin,0,19.0,0,0,1,0,1,Bosnia and Herzegovina
Edin Sprečo,0,84.0,0,0,1,1,2,Yugoslavia
Edin Višća,0,353.0,0,0,6,1,7,Bosnia and Herzegovina
Edinho,0,90.0,0,0,1,0,1,Portugal
Edino Nazareth Filho,1,79.0,0,0,1,0,1,Brazil
Edinson Cavani,10,1394.0,0,3,20,10,30,Uruguay
Edison Flores,3,614.0,0,0,3,7,10,Ecuador
Edivaldo Hermoza,0,47.0,0,0,0,1,1,Argentina
Edixon Perea,2,100.0,0,0,1,1,2,Colombia
Edixon Perea Valencia,0,78.0,0,0,1,0,1,Colombia
Edmar Halovskyi de Lacerda,0,32.0,0,0,1,0,1,Ukraine
Edmond Abazi,0,77.0,0,0,1,0,1,Albania
Edmond Apéti Kaolo,3,165.0,0,1,0,3,3,Mali
Edmond Kapllani,0,253.0,0,0,2,3,5,Albania
Edmund Conen,4,250.0,0,0,0,4,4,Belgium
Edmund Waterval,0,180.0,0,0,2,0,2,Suriname
Edmundo,3,153.0,0,0,3,0,3,Brazil
Edmundo Alves de Souza Neto,2,74.0,0,0,1,1,2,Brazil
Edmílson,1,38.0,0,0,0,1,1,Costa Rica
Edo Ophof,1,22.0,0,1,0,1,1,Malta
Edrissa Sonko,0,79.0,0,0,1,0,1,Gambia
Edson Castillo,1,51.0,0,0,1,0,1,Venezuela
Edson Minga,0,88.0,0,0,2,0,2,Congo
Edson Puch,2,102.0,0,0,0,2,2,Mexico
Edson Tortolero,1,199.0,1,2,2,1,3,Bolivia
Edson Álvarez,2,234.0,1,0,0,3,3,Curaçao
Eduard Abazi,0,65.0,0,0,1,0,1,Albania
Eduard Bello,0,64.0,0,0,1,0,1,Venezuela
Eduard Glieder,0,125.0,0,0,2,1,3,San Marino
Eduard Kozynkevych,0,90.0,0,0,1,0,1,Russia
Eduard Malofeyev,3,300.0,0,0,1,5,6,North Korea
Eduard Moss,0,42.0,0,0,0,1,1,Dominica
Eduard Spertsyan,0,56.0,0,0,1,0,1,Armenia
Eduard Streltsov,1,189.0,0,0,1,3,4,Finland
Eduardo Antunes Coimbra,0,138.0,0,0,1,1,2,Paraguay
Eduardo Bennett,7,688.0,0,5,9,3,12,Canada
Eduardo Chavarria,0,130.0,0,0,2,0,2,Costa Rica
Eduardo Espinoza,1,76.0,0,0,1,0,1,Mexico
Eduardo Fernando Gomes,0,145.0,0,1,2,1,3,Mauritius
Eduardo González Palmer,0,145.0,0,0,2,0,2,Mexico
Eduardo González Valiño,0,3.0,0,0,1,0,1,Spain
Eduardo Guzmán,1,6.0,0,0,0,1,1,Bolivia
Eduardo Hurtado,0,581.0,0,0,10,0,10,Ecuador
Eduardo Ithurbide,0,5.0,0,0,0,1,1,Argentina
Eduardo Laing,1,60.0,0,0,1,0,1,Honduras
Eduardo Machado,0,83.0,0,0,0,1,1,Algeria
Eduardo Malásquez,0,49.0,0,1,0,2,2,Colombia
Eduardo Mario Acevedo,0,45.0,0,0,1,0,1,Uruguay
Eduardo Mingo,2,61.0,0,0,0,2,2,Ecuador
Eduardo Retat,0,75.0,0,0,0,1,1,Ecuador
Eduardo Ricagni,0,84.0,0,0,1,0,1,Italy
Eduardo Sebrango,2,283.0,0,0,2,3,5,Cayman Islands
Eduardo Vargas,12,1231.0,0,0,13,13,26,Chile
Eduardo Vilarete,0,58.0,0,0,0,1,1,Paraguay
Eduardo da Silva,0,1034.0,0,0,9,9,18,Croatia
Eduvigis Rudolfo Dirksz,0,66.0,0,0,0,2,2,Suriname
Edvard Lasota,1,63.0,0,0,1,0,1,Czech Republic
Edvin Murati,0,145.0,0,0,2,1,3,Finland
Edward Acquah,0,449.0,0,0,5,2,7,Ghana
Edward Aggrey-Fynn,0,116.0,0,1,2,0,2,Ghana
Edward Boateng,0,44.0,0,0,1,0,1,Ghana
Edward Herrera,0,77.0,0,0,1,0,1,Malta
Edward Jankowski,0,200.0,0,0,1,3,4,Finland
Edward Jildo,0,17.0,0,0,1,0,1,Sudan
Edward Semwanga,1,31.0,0,0,0,1,1,Congo
Edwin Cardona,1,312.0,0,0,2,2,4,Colombia
Edwin Clarcke,3,95.0,0,0,3,0,3,Argentina
Edwin Congo,1,112.0,0,0,0,2,2,Argentina
Edwin Gyasi,0,63.0,0,0,1,0,1,Ghana
Edwin Miliano Loran,2,64.0,0,0,2,0,2,Curaçao
Edwin Mukenya,0,61.0,0,0,1,0,1,Kenya
Edwin Rarai,1,82.0,0,0,0,1,1,Tahiti
Edwin Schal,0,90.0,0,0,1,0,1,Suriname
Edwin Solano,1,52.0,0,0,1,0,1,Honduras
Edwin Sánchez,0,78.0,0,0,0,1,1,Suriname
Edwin Villatoro,0,74.0,0,0,0,1,1,Costa Rica
Edwin Westphal,2,126.0,0,0,2,0,2,Guatemala
Edy Dublin,0,26.0,0,0,0,1,1,Norway
Edzai Kasinauyo,0,83.0,0,0,1,0,1,Zimbabwe
Edílson,0,78.0,0,0,1,1,2,Brazil
Edú Marangón,1,33.0,0,0,1,0,1,Brazil
Efe Ambrose,0,87.0,0,0,1,0,1,Nigeria
Efrain Chacurian,0,42.0,0,0,0,1,1,Haiti
Efraín Juárez,1,55.0,0,0,1,0,1,Mexico
Efstathios Aloneftis,0,445.0,0,0,7,2,9,Cyprus
Egil Østenstad,0,75.0,0,0,1,0,1,Norway
Egil á Bø,0,83.0,0,0,0,1,1,Romania
Egisto Pandolfini,2,104.0,0,1,2,1,3,Italy
Egor Filipenko,0,32.0,0,0,1,0,1,Belarus
Egor Krimets,0,86.0,0,0,0,1,1,Qatar
Egzon Bejtulai,0,86.0,1,0,0,1,1,North Macedonia
Ehsan Hajsafi,2,186.0,0,3,3,1,4,Iran
Ehson Panjshanbe,0,9.0,0,0,0,1,1,Japan
Eimantas Poderis,0,66.0,0,0,0,1,1,Latvia
Einar Daníelsson,0,28.0,0,0,0,1,1,Liechtenstein
Einar Gunnarsson,0,89.0,1,0,1,0,1,Belgium
Einar Jan Aas,0,3.0,0,0,0,1,1,Scotland
Eitan Tibi,0,22.0,0,0,0,1,1,Liechtenstein
Eiður Guðjohnsen,0,1018.0,0,2,13,8,21,Iceland
Ekanit Panya,0,51.0,0,0,1,0,1,Thailand
Eko Purdjianto,0,78.0,0,0,0,1,1,Cambodia
El Arbi Hababi,0,16.0,0,0,1,0,1,Morocco
El Fardou Ben Nabouhane,1,4.0,0,0,0,1,1,Ghana
El Hadji Diouf,1,658.0,0,1,12,3,15,Senegal
El Hadji Oumar Guèye,1,37.0,0,0,0,1,1,Ethiopia
Eladio Benítez,0,8.0,0,0,1,0,1,Uruguay
Eladio Rojas,0,119.0,0,0,2,0,2,Chile
Eladio Zárate,4,115.0,0,0,1,3,4,Ecuador
Elano,2,217.0,0,0,3,0,3,Brazil
Elba de Padua Lima,1,10.0,0,0,1,0,1,Brazil
Elbasan Rashani,0,90.0,0,0,0,1,1,Bulgaria
Elcio Martina,0,90.0,0,0,0,1,1,El Salvador
Eldar Hansen,1,87.0,0,0,0,1,1,Russia
Eldar Ćivić,0,57.0,0,0,0,1,1,Liechtenstein
Eldor Shomurodov,5,592.0,0,0,6,6,12,Bahrain
Elek Nyilas,0,109.0,0,1,0,2,2,Azerbaijan
Eli Ohana,0,428.0,0,1,7,1,8,Israel
Elias Hossain,0,76.0,0,0,1,0,1,Bangladesh
Elias Maguri,0,43.0,0,0,1,0,1,Tanzania
Elias Pelembe,0,63.0,0,0,1,0,1,Mozambique
Elias Tshimanga,1,90.0,0,0,1,0,1,DR Congo
Elias Uzamukunda,0,58.0,0,0,0,1,1,Eritrea
Elie Aiboy,1,122.0,0,0,2,1,3,Indonesia
Eligio Antonio Insfrán,1,30.0,0,0,0,1,1,Argentina
Elijah Joseph,0,26.0,0,0,1,0,1,Saint Lucia
Elijah Just,1,71.0,0,0,1,0,1,New Zealand
Elijah Litana,3,124.0,0,0,3,1,4,Zambia
Elijah Tana,1,49.0,0,0,2,1,3,Togo
Eliphas Shivute,2,198.0,0,0,0,5,5,Egypt
Eliran Atar,0,83.0,0,0,0,1,1,Albania
Eliseo Prado,0,63.0,0,0,1,0,1,Argentina
Eliseo Quintanilla,1,441.0,0,2,7,0,7,El Salvador
Eliseu,0,87.0,0,0,1,0,1,Portugal
Eljero Elia,0,82.0,0,0,0,1,1,Scotland
Eljif Elmas,0,535.0,0,0,7,1,8,North Macedonia
Elkeson,0,313.0,0,1,2,2,4,Maldives
Elkin Soto,0,134.0,0,0,1,1,2,Colombia
Elly Adero,0,30.0,0,0,1,0,1,Kenya
Ellyes Skhiri,0,93.0,0,0,2,0,2,Tunisia
Elmar Geirsson,0,44.0,0,0,0,1,1,Netherlands
Elmer Acevedo,0,119.0,0,0,1,1,2,El Salvador
Elmer Martínez,0,51.0,0,0,0,1,1,Belize
Elmo Kambindu,0,53.0,0,0,0,1,1,Togo
Elos Elonga-Ekakia,0,159.0,0,0,0,2,2,Mauritius
Eloy,1,70.0,0,0,0,1,1,Algeria
Eloy Olaya,0,87.0,0,0,0,2,2,Austria
Elrio van Heerden,3,142.0,0,0,2,1,3,South Africa
Elroy Kuylen,1,111.0,0,0,1,2,3,Montserrat
Elroy Smith,0,39.0,0,0,0,1,1,Saint Kitts and Nevis
Elsad Zverotić,0,217.0,0,0,2,2,4,Bulgaria
Elseid Hysaj,0,120.0,0,0,2,0,2,Albania
Elson Hooi,0,87.0,0,0,1,0,1,Curaçao
Elvin Mammadov,0,131.0,0,0,1,1,2,Azerbaijan
Elvir Baljić,0,583.0,0,2,4,6,10,Bosnia and Herzegovina
Elvir Bolić,0,663.0,0,0,12,3,15,Slovenia
Elvis Kafoteka,1,38.0,0,0,2,0,2,Malawi
Elvis Macedo Babanco,0,73.0,0,0,1,0,1,Cape Verde
Elyaniv Barda,0,286.0,0,0,8,1,9,Israel
Elías Aguilar,2,99.0,0,0,2,0,2,Costa Rica
Elías Figueroa,0,84.0,0,0,2,0,2,Chile
Elías Hernández,1,29.0,0,0,1,0,1,Mexico
Elías Montes,0,84.0,0,0,3,0,3,El Salvador
Emad Ayoub,2,151.0,0,0,1,3,4,Hong Kong
Emad Mohammed,3,468.0,0,0,7,3,10,Iraq
Emad Moteab,2,505.0,0,0,11,0,11,Egypt
Emad Suleiman,1,123.0,0,0,2,1,3,Egypt
Emanuel Fabri,1,59.0,0,0,2,0,2,Malta
Emanuel Farrugia,0,62.0,0,0,1,0,1,Malta
Emanuel Pogatetz,0,32.0,0,0,0,1,1,Netherlands
Emanuele Giaccherini,1,83.0,0,0,0,2,2,Brazil
Emeka Mamale,0,1.0,0,0,0,1,1,Mauritius
Emelio Caligdong,0,20.0,0,0,1,0,1,Philippines
Emerich Dembrovschi,1,242.0,0,0,3,2,5,Romania
Emerson,1,40.0,0,0,1,0,1,Brazil
Emerson Umaña,0,80.0,0,0,1,0,1,El Salvador
Emery Welshman,1,198.0,0,0,3,0,3,Guyana
Emil Dumitriu,0,153.0,0,0,3,0,3,Romania
Emil Forsberg,5,581.0,0,4,11,2,13,Sweden
Emil Gargorov,0,114.0,0,0,1,1,2,Bulgaria
Emil Hallfreðsson,0,40.0,0,0,1,0,1,Iceland
Emil Kenjisariev,0,86.0,0,0,1,0,1,Kyrgyzstan
Emil Kostadinov,1,1166.0,0,0,10,10,20,Scotland
Emil Lőrincz,0,20.0,0,0,2,0,2,Hungary
Emil Pažický,0,54.0,0,0,1,0,1,Czechoslovakia
Emile Heskey,1,162.0,0,0,0,3,3,Germany
Emile Mbouh,0,123.0,0,0,1,1,2,Gabon
Emile Ounei,0,43.0,0,1,1,0,1,New Caledonia
Emile Pierre Diéme,0,26.0,0,0,1,0,1,Senegal
Emile Saimovici,2,129.0,0,0,2,0,2,Barbados
Emile Smith Rowe,0,58.0,0,0,0,1,1,San Marino
Emiliano González Arqués,0,45.0,0,0,1,0,1,Andorra
Emilio Butragueño,6,843.0,0,1,9,6,15,Spain
Emilio Izaguirre,1,109.0,0,0,2,0,2,Honduras
Emilio Mora,1,26.0,0,0,1,0,1,Mexico
Emilio Nsue,0,176.0,0,0,3,0,3,Equatorial Guinea
Emilio Palacios,0,97.0,0,0,1,1,2,Nicaragua
Emin Ağayev,0,14.0,1,0,1,0,1,Finland
Emin Imamaliev,0,83.0,0,0,1,0,1,Azerbaijan
Emin Mahmudov,0,216.0,0,1,1,3,4,Azerbaijan
Emir Bajrami,0,84.0,0,0,1,0,1,Sweden
Emir Spahić,0,219.0,1,0,4,1,5,Bosnia and Herzegovina
Emmanuel Adebayor,6,843.0,0,0,14,3,17,Togo
Emmanuel Agyemang-Badu,2,150.0,0,0,3,0,3,Ghana
Emmanuel Ake,1,51.0,0,0,0,1,1,Burkina Faso
Emmanuel Amunike,4,233.0,0,0,5,1,6,Nigeria
Emmanuel Chipatala,0,47.0,0,0,1,1,2,Malawi
Emmanuel Duah,0,70.0,0,0,1,0,1,Ghana
Emmanuel Eboué,1,33.0,0,0,1,0,1,Ivory Coast
Emmanuel Emenike,4,369.0,0,1,2,5,7,Nigeria
Emmanuel Feseha,0,90.0,0,0,1,0,1,Ethiopia
Emmanuel Koum,2,123.0,0,0,2,0,2,Cameroon
Emmanuel Kundé,2,379.0,0,3,6,0,6,Cameroon
Emmanuel Maboang,3,271.0,0,0,4,0,4,Cameroon
Emmanuel Mayuka,4,179.0,0,0,2,2,4,Senegal
Emmanuel Musonda,0,60.0,0,0,1,0,1,Zambia
Emmanuel Ofei Ansah,0,59.0,0,0,0,1,1,Guinea
Emmanuel Okocha,0,82.0,0,0,0,1,1,Algeria
Emmanuel Okwi,2,282.0,0,0,3,2,5,Angola
Emmanuel Ola,0,41.0,0,0,1,0,1,Ghana
Emmanuel Olisadebe,1,280.0,0,0,4,5,9,Ukraine
Emmanuel Osei Kuffour,0,44.0,0,0,1,0,1,Ghana
Emmanuel Osigwe,1,114.0,0,0,1,1,2,Nigeria
Emmanuel Petit,0,194.0,0,0,3,0,3,France
Emmanuel Poila,0,90.0,0,0,1,0,1,Solomon Islands
Emmanuel Rivière,1,74.0,0,1,0,2,2,Canada
Emmanuel Sanon,2,109.0,0,0,0,2,2,Italy
Emmanuel Tiki,0,10.0,0,0,1,0,1,Cameroon
Emment Kapengwe,0,166.0,0,0,2,1,3,Zambia
Emmerson Boyce,0,46.0,0,0,0,2,2,Aruba
Emory Núñez,1,40.0,0,0,1,0,1,Belize
Emre Aşık,0,80.0,0,0,0,2,2,Sweden
Emre Belözoğlu,1,284.0,0,1,3,3,6,Turkey
Emre Can,0,81.0,0,0,1,0,1,Germany
Emílio da Silva,2,163.0,0,0,2,1,3,Timor-Leste
Endang Witarsa,0,70.0,0,0,0,1,1,China PR
Ender Konca,0,24.0,0,0,1,0,1,Turkey
Endre Botka,0,18.0,0,0,1,0,1,Hungary
Endri Çekiçi,0,73.0,0,1,1,0,1,Albania
Energio Díaz,1,61.0,0,0,0,1,1,Peru
Enes Ünal,0,38.0,0,1,0,2,2,Andorra
Enis Bardhi,0,331.0,0,2,2,5,7,North Macedonia
Enner Valencia,9,879.0,0,4,10,10,20,Switzerland
Enock Mwepu,0,98.0,0,0,1,1,2,Zambia
Enric Gensana,0,69.0,0,0,1,0,1,Spain
Enrico Chiesa,1,107.0,0,0,1,1,2,Czech Republic
Enrico Hernández,0,37.0,0,0,1,0,1,El Salvador
Enrique Alfaro Rojas,0,8.0,0,0,0,1,1,Canada
Enrique Alvarez,1,19.0,0,1,0,1,1,Brazil
Enrique Borja,1,48.0,0,0,0,1,1,France
Enrique Cantos,2,126.0,0,0,0,3,3,Colombia
Enrique Casaretto,0,107.0,0,0,0,2,2,Brazil
Enrique Collar,0,75.0,0,0,2,0,2,Spain
Enrique Esqueda,0,57.0,0,0,0,1,1,Trinidad and Tobago
Enrique Ferrer,0,62.0,0,0,0,1,1,Haiti
Enrique García,2,132.0,0,0,4,1,5,Argentina
Enrique Guaita,0,19.0,0,0,1,0,1,Italy
Enrique Hormazábal,4,480.0,0,0,8,2,10,Chile
Enrique Jara Saguier,0,88.0,0,0,2,0,2,Paraguay
Enrique Lora,0,66.0,0,0,1,0,1,Spain
Enrique Mateos,0,11.0,0,0,1,0,1,Spain
Enrique Raymondi,1,341.0,0,0,3,3,6,Bolivia
Enrique Raymondi Chávez,0,30.0,0,0,0,1,1,Chile
Enrique Reneau,0,117.0,0,0,1,1,2,Mexico
Enrique Saura,0,155.0,0,0,1,1,2,Cyprus
Enrique Sesma,0,107.0,0,0,1,1,2,United States
Enrique Sorrel,2,123.0,0,1,4,0,4,Chile
Enrique Tenemás,1,62.0,0,0,0,1,1,Argentina
Enrique Vera,1,27.0,0,0,0,1,1,Slovakia
Enrique Ávalos,1,100.0,0,0,0,2,2,Bolivia
Enzo Fernández,2,164.0,1,0,1,1,2,Argentina
Enzo Francescoli,3,499.0,0,3,5,5,10,Uruguay
Enzo Scifo,3,620.0,0,2,6,8,14,Belgium
Eoin Hand,0,79.0,0,0,0,1,1,Russia
Eoin Jess,0,98.0,0,0,2,0,2,Scotland
Epeli Saukuru,0,66.0,0,0,0,1,1,New Caledonia
Epotele Bazamba,1,51.0,0,0,1,0,1,DR Congo
Eran Zahavi,0,1046.0,0,1,11,12,23,Russia
Erasmo Vera,0,29.0,0,0,1,0,1,Chile
Erasto Nyoni,0,87.0,0,2,2,0,2,Tanzania
Erastus Gariseb,0,70.0,0,0,0,1,1,Egypt
Eren Derdiyok,0,247.0,0,0,3,1,4,Latvia
Erhan Önal,0,80.0,0,0,1,0,1,Turkey
Eric Abidal,0,20.0,1,0,1,0,1,Belarus
Eric Akoto,0,86.0,0,0,1,0,1,Togo
Eric Cantona,0,553.0,0,1,8,2,10,France
Eric Carrière,2,231.0,0,0,2,1,3,France
Eric Davis,3,298.0,0,3,2,3,5,Guyana
Eric Dier,1,110.0,0,0,2,0,2,England
Eric Etaeta,0,76.0,0,0,0,1,1,Solomon Islands
Eric Gerets,1,23.0,0,0,1,1,2,Belgium
Eric Godlieb,0,2.0,0,0,1,0,1,Suriname
Eric Hoffmann,0,65.0,1,0,0,1,1,Luxembourg
Eric Komeng,0,68.0,0,0,0,1,1,Samoa
Eric Lichaj,0,45.0,0,0,1,0,1,United States
Eric Maxim Choupo-Moting,2,236.0,0,1,4,2,6,Cameroon
Eric McMordie,0,47.0,0,0,1,0,1,Northern Ireland
Eric Ramírez,0,11.0,0,0,1,0,1,Venezuela
Eric Tinkler,0,21.0,0,0,0,1,1,Malawi
Eric Van Meir,0,26.0,0,0,1,0,1,Belgium
Eric Wynalda,4,859.0,0,3,17,2,19,United States
Eric Young,0,31.0,0,0,0,1,1,Faroe Islands
Erich Beer,0,178.0,0,1,2,1,3,Germany
Erich Hof,0,386.0,0,3,8,2,10,Norway
Erich Obermayer,1,80.0,0,0,1,0,1,Austria
Erich Probst,5,466.0,0,0,11,1,12,Austria
Erick Miranda,1,28.0,0,0,0,1,1,Mexico
Erick Ozuna,0,283.0,0,0,3,2,5,Dominican Republic
Erick Pulgar,1,165.0,0,0,3,1,4,Japan
Erick Scott,2,88.0,0,0,1,1,2,Cuba
Erik Dyreborg,0,25.0,0,0,0,1,1,German DR
Erik Edman,0,74.0,0,0,0,1,1,Bulgaria
Erik Hagen,0,17.0,0,0,1,1,2,Bosnia and Herzegovina
Erik Holmgren,0,164.0,0,0,1,1,2,Malta
Erik Huseklepp,0,162.0,0,0,3,0,3,Norway
Erik Jendrišek,0,82.0,0,0,0,1,1,Czech Republic
Erik Johansen,0,89.0,0,0,1,1,2,Luxembourg
Erik Just Olsen,0,54.0,0,1,0,1,1,Sweden
Erik Lamela,2,84.0,0,0,2,0,2,Argentina
Erik Mykland,0,74.0,0,0,1,0,1,Norway
Erik Persson,0,65.0,0,0,1,0,1,Sweden
Erik Sandvad,0,87.0,1,0,1,0,1,Portugal
Erik Santos de Gouveia,0,13.0,0,0,1,0,1,Aruba
Erik Sorga,0,265.0,0,0,3,1,4,Estonia
Eriq Zavaleta,0,61.0,0,0,1,1,2,El Salvador
Erixon Danso,0,54.0,0,0,2,0,2,Aruba
Erjon Bogdani,0,648.0,0,0,7,4,11,Denmark
Erkan Zengin,0,93.0,0,0,2,1,3,Austria
Erland Johnsen,0,89.0,0,0,0,1,1,Scotland
Erling Haaland,0,196.0,0,1,4,1,5,Norway
Ermen Benítez,1,88.0,0,0,0,1,1,Uruguay
Ermes Muccinelli,1,154.0,0,0,1,1,2,Italy
Ermin Bičakčić,0,174.0,0,0,2,1,3,Slovakia
Ermin Šiljak,0,323.0,0,0,5,5,10,Slovenia
Ermindo Onega,1,154.0,0,0,4,0,4,Argentina
Ermir Lenjani,0,79.0,0,0,1,1,2,Albania
Ernest Brenner,0,10.0,0,0,0,1,1,Norway
Ernest Ebongué,1,223.0,0,0,1,2,3,Cameroon
Ernest Liberati,0,80.0,0,0,0,1,1,Luxembourg
Ernest Mengel,0,27.0,0,0,1,0,1,Luxembourg
Ernest Pohl,0,148.0,0,0,2,1,3,Poland
Ernest Schultz,0,86.0,0,0,1,0,1,France
Ernest Spiteri-Gonzi,1,137.0,0,0,1,2,3,Turkey
Ernesto Belis,1,4.0,0,0,1,0,1,Argentina
Ernesto Betancourt,1,70.0,0,0,0,1,1,Bolivia
Ernesto Cisneros,0,193.0,0,0,3,1,4,Jamaica
Ernesto Cristaldo,1,78.0,0,0,1,0,1,Paraguay
Ernesto Duarte Machado da Silva,2,65.0,0,0,2,0,2,Brazil
Ernesto Díaz,0,249.0,0,0,4,1,5,Colombia
Ernesto Grillo,2,31.0,0,0,2,0,2,Argentina
Ernesto Humberto Juárez,1,86.0,0,0,1,0,1,Argentina
Ernesto Vidal,1,18.0,0,0,0,1,1,Bolivia
Ernie Brandts,3,194.0,1,0,2,3,5,Austria
Ernie Campbell,0,108.0,0,0,1,1,2,New Zealand
Ernie Tapai,1,181.0,0,0,3,1,4,Tahiti
Ernst Albrecht,0,24.0,0,0,0,1,1,Luxembourg
Ernst Baumeister,0,71.0,0,0,0,1,1,Turkey
Ernst Happel,0,68.0,0,1,1,0,1,Austria
Ernst Hufschmid,0,75.0,0,0,1,0,1,Switzerland
Ernst Kozlicek,0,71.0,0,0,1,0,1,Austria
Ernst Lehner,2,184.0,0,0,2,3,5,Austria
Ernst Lörtscher,1,22.0,1,0,1,0,1,Germany
Ernst Ocwirk,1,134.0,0,0,2,1,3,Austria
Ernst Ogris,0,83.0,0,0,0,1,1,Denmark
Ernst Stojaspal,3,84.0,0,1,3,0,3,Austria
Ernst Wilimowski,4,397.0,0,0,1,4,5,Poland
Ernő Solymosi,1,128.0,1,1,2,2,4,German DR
Erol Keskin,1,143.0,0,0,1,1,2,Turkey
Errol Daniels,0,225.0,0,0,3,1,4,Costa Rica
Errol McFarlane,1,297.0,0,0,1,3,4,Saint Vincent and the Grenadines
Errol O'Loughlin,0,86.0,0,0,1,0,1,Saint Kitts and Nevis
Erroll Bennett,4,445.0,0,0,0,5,5,New Caledonia
Ertuğrul Sağlam,0,176.0,0,0,4,0,4,Turkey
Ervin Fakaj,0,90.0,0,0,1,0,1,Albania
Ervin Skela,0,159.0,0,2,1,4,5,Republic of Ireland
Erwin Hochsträsser,0,80.0,0,1,1,0,1,Switzerland
Erwin Hoffer,0,160.0,0,0,3,0,3,Austria
Erwin Koeman,0,74.0,0,0,2,0,2,Netherlands
Erwin Ramírez,1,80.0,0,1,0,1,1,Bolivia
Erwin Romero,0,65.0,0,0,1,0,1,Bolivia
Erwin Saavedra,2,70.0,0,1,0,2,2,Paraguay
Erwin Sánchez,3,697.0,0,1,9,4,13,Peru
Erwin Vandenbergh,2,613.0,0,1,8,7,15,Scotland
Esa Heiskanen,0,49.0,0,0,2,0,2,Finland
Esala Masi,11,604.0,0,1,6,8,14,Fiji
Esam Dariban,0,39.0,0,0,0,1,1,Cambodia
Esey Tesfay,0,58.0,1,0,0,1,1,Eritrea
Esrom Nyandoro,1,140.0,0,0,0,2,2,Cameroon
Essam Abu Touk,0,179.0,0,2,4,1,5,Uzbekistan
Essam Baheeg,2,101.0,0,0,2,0,2,Egypt
Essau Kanyenda,0,207.0,0,0,3,2,5,Ethiopia
Estanislao Struway,0,45.0,0,0,1,0,1,Paraguay
Estanislau Basora,4,336.0,0,0,6,1,7,Spain
Esteban Cambiasso,1,187.0,0,0,1,2,3,Germany
Esteban Obiang,1,70.0,0,0,0,1,1,Algeria
Esteban Paredes,1,104.0,0,0,4,0,4,Chile
Etienne Alain Djissikadie,0,10.0,0,0,1,0,1,Gabon
Etienne Barbara,0,79.0,0,0,1,0,1,Malta
Etienne Bito'o,0,84.0,0,0,0,1,1,Algeria
Etienne Hajason Rasoanaivo,0,67.0,0,0,0,1,1,Zimbabwe
Etienne Mermer,3,273.0,0,0,1,4,5,American Samoa
Etienne Olivier Rasoanaivo,0,82.0,0,0,0,1,1,Zambia
Etienne Rado Rasoanaivo,0,128.0,0,0,2,1,3,Madagascar
Eudalio Arriaga,0,90.0,0,0,1,0,1,Colombia
Eudes Dagoulou,0,7.0,0,0,0,1,1,Madagascar
Eugen Sidorenco,0,248.0,0,0,3,1,4,Moldova
Eugen Walaschek,1,42.0,0,0,0,1,1,Germany
Eugene Kirwan,1,23.0,0,0,1,0,1,Antigua and Barbuda
Eugene Martha,2,123.0,1,0,1,1,2,Curaçao
Eugene Ssepuuya,0,15.0,0,0,1,1,2,Benin
Eugenio Dolmo Flores,2,177.0,0,0,1,2,3,Canada
Eugenio Fernando Bila,0,6.0,0,0,0,1,1,Botswana
Eugenio La Rosa,3,151.0,0,0,3,0,3,Peru
Eugenio Leal,0,75.0,0,0,1,0,1,Spain
Eugenio Morel,0,229.0,0,0,3,2,5,Paraguay
Eugenio Méndez,0,85.0,0,0,2,0,2,Chile
Eugeniu Cebotaru,0,85.0,0,0,1,0,1,Moldova
Eugène Ekéké,1,65.0,0,0,1,0,1,Cameroon
Eugène Kabongo,1,249.0,0,0,3,3,6,Ivory Coast
Euller,0,20.0,0,0,0,1,1,Venezuela
Euloge Placca Fessou,1,187.0,0,0,1,2,3,Togo
Euloge Sacramento,0,43.0,0,0,0,1,1,Tunisia
Eulogio Martínez,1,122.0,0,0,0,2,2,Brazil
Eurico Gomes,0,31.0,0,0,1,0,1,Portugal
Eusebio Escobar,0,27.0,0,0,1,0,1,Colombia
Eustache Manglé,4,243.0,0,0,1,3,4,DR Congo
Eustacio Rizo,1,89.0,0,0,0,1,1,Guatemala
Eustaquio Barreiro,1,63.0,0,0,0,1,1,Ecuador
Eusébio,9,1325.0,0,5,9,17,26,Luxembourg
Euzebiusz Smolarek,0,540.0,0,0,8,4,12,Poland
Evagoras Christofi,0,28.0,0,0,1,0,1,Cyprus
Evair Aparecido Paulino,0,31.0,0,0,1,0,1,Brazil
Evan Dimas,1,60.0,0,0,0,1,1,Thailand
Evan Welsh,0,89.0,0,0,0,1,1,Honduras
Evani Esperance,0,81.0,0,0,1,0,1,Suriname
Evans Sakala,1,38.0,0,0,1,0,1,Zambia
Evaristo de Macedo,8,470.0,0,0,8,0,8,Brazil
Everad Sam,0,75.0,0,0,0,1,1,Honduras
Everon Espacia,0,73.0,0,0,1,0,1,Curaçao
Everton Soares,0,132.0,0,0,3,0,3,Brazil
Evgeny Boldygin,0,103.0,0,0,1,1,2,Pakistan
Evidence Makgopa,0,90.0,0,0,0,1,1,Ethiopia
Ewald Hoeseb,0,28.0,0,0,1,0,1,Namibia
Eyal Berkovic,0,218.0,0,0,3,2,5,France
Eyjólfur Sverrisson,0,426.0,0,0,6,3,9,Iceland
Eyvind Clausen,0,58.0,0,0,2,0,2,Denmark
Ezechiel N'Douassel,0,158.0,0,1,2,0,2,Chad
Ezequiel Jerez,0,87.0,0,0,0,1,1,Guatemala
Ezequiel Lavezzi,1,169.0,0,0,5,1,6,Argentina
Ezgjan Alioski,1,246.0,0,1,2,4,6,Albania
Ezio Pascutti,0,38.0,0,0,1,0,1,Italy
Ezz El-Din Yaqoub,1,56.0,0,0,1,0,1,Egypt
Ezzedine Chakroun,0,229.0,0,0,1,3,4,Algeria
Ezzeldin Osman,0,40.0,0,0,1,0,1,Sudan
Ezzewdin Bezan,0,8.0,0,0,1,0,1,Libya
Fabian Frei,0,20.0,0,0,1,0,1,Switzerland
Fabian Johnson,0,29.0,0,0,1,0,1,United States
Fabian Schär,1,273.0,0,1,3,5,8,Switzerland
Fabio Baudo Franco,3,82.0,0,0,0,3,3,Chile
Fabio Cannavaro,0,52.0,1,0,1,0,1,Russia
Fabio Capello,1,167.0,0,0,1,2,3,Luxembourg
Fabio Celestini,0,87.0,0,0,0,1,1,Republic of Ireland
Fabio D'Elia,0,49.0,0,0,1,0,1,Liechtenstein
Fabio Francini,0,90.0,1,0,1,0,1,Scotland
Fabio Grosso,0,289.0,0,0,2,2,4,Scotland
Fabio Quagliarella,1,327.0,0,2,3,3,6,Lithuania
Fabián Estay,0,171.0,0,0,3,0,3,Chile
Fabián Estoyanoff,2,9.0,0,0,0,2,2,Argentina
Fabián Orellana,0,113.0,0,0,1,1,2,Chile
Fabián Ruiz,0,8.0,0,0,1,0,1,Spain
Fabrice Do Marcolino,1,190.0,0,0,3,0,3,Gabon
Fabrice N'Guessi,0,66.0,0,0,0,1,1,Niger
Fabrice Noël,1,14.0,0,0,1,0,1,Haiti
Fabrice Ondama,1,150.0,0,0,1,1,2,Congo
Fabrice Reuperné,1,90.0,0,0,0,1,1,Canada
Fabricio Coloccini,0,66.0,0,0,0,1,1,Peru
Fabrizio Ravanelli,0,305.0,0,0,5,2,7,Italy
Fadel Keïta,0,162.0,0,0,1,1,2,Rwanda
Fadi Alloush,0,80.0,0,1,1,0,1,Lebanon
Fadi Lafi,1,58.0,0,0,1,0,1,Palestine
Fadil Vokrri,0,183.0,0,0,2,2,4,German DR
Fahad Al Ansari,0,127.0,0,0,2,0,2,Kuwait
Fahad Al Enezi,0,50.0,0,0,1,0,1,Kuwait
Fahad Al Hajeri,0,13.0,0,0,1,0,1,Kuwait
Fahad Al Hamad,0,82.0,0,0,1,0,1,Kuwait
Fahad Al Kuwari,2,182.0,0,1,1,2,3,Qatar
Fahad Al-Bishi,5,312.0,0,2,5,2,7,China PR
Fahad Al-Ghesheyan,1,85.0,0,0,1,0,1,Saudi Arabia
Fahad Al-Mehallel,8,471.0,0,0,7,3,10,Macau
Fahad Al-Musaibeah,1,13.0,0,0,1,0,1,Saudi Arabia
Fahad Al-Muwallad,2,576.0,0,0,8,2,10,Saudi Arabia
Fahad Al-Rashidi,0,81.0,0,0,1,0,1,Kuwait
Fahad Bayo,0,152.0,0,0,2,1,3,Rwanda
Fahad Fallata,0,65.0,0,0,1,0,1,Saudi Arabia
Fahad Khamees,2,183.0,0,0,4,1,5,United Arab Emirates
Fahad Khamis Mubarak,0,61.0,0,0,0,1,1,Singapore
Fahad Yousef Al-Sovayed,0,26.0,0,0,1,0,1,Kuwait
Fahd Ali,0,45.0,0,0,1,0,1,United Arab Emirates
Fahed Masoud,0,90.0,0,0,0,1,1,Brunei
Fahid Ben Khalfallah,0,43.0,0,0,1,0,1,Tunisia
Fahreddin Cansever,0,115.0,0,0,3,0,3,Turkey
Fahrudin Mustafić,0,75.0,0,1,2,0,2,Singapore
Faisal Agab,1,139.0,0,1,2,1,3,Sudan
Faisal Ajab Al-Azemi,0,81.0,0,0,1,0,1,Kuwait
Faisal Al Badri,1,53.0,0,2,2,0,2,Libya
Faisal Al Otaibi,0,7.0,0,0,0,1,1,Lebanon
Faisal Al-Dakhil,4,969.0,0,1,16,4,20,Kuwait
Faisal Antar,2,86.0,0,0,0,3,3,Pakistan
Faisal Aziz Rashed,1,43.0,0,0,0,1,1,Jordan
Faisal Bushaala,0,45.0,0,0,0,1,1,Mali
Faisal Khalil,1,272.0,0,0,2,2,4,United Arab Emirates
Faisal Zayid,1,108.0,0,0,2,0,2,Kuwait
Faitalia Hamilton-Pama,1,18.0,0,0,1,0,1,Samoa
Faiz Nasir,0,78.0,0,0,1,0,1,Malaysia
Fakhreddine Ben Youssef,1,140.0,0,0,0,2,2,Sierra Leone
Falah Hassan,1,85.0,0,0,1,0,1,Iraq
Falimery Ramanamahefa,0,108.0,0,0,2,0,2,Madagascar
Famara Diédhiou,4,271.0,0,0,2,4,6,Senegal
Fan Zhiyi,2,536.0,1,4,6,4,10,Vietnam
Fandi Ahmad,1,227.0,0,0,2,2,4,Vietnam
Faneva Imà Andriatsima,1,280.0,0,1,6,0,6,Madagascar
Fanis Theofanous,0,21.0,0,0,1,0,1,Cyprus
Fanny Hangunyu,0,44.0,0,0,1,0,1,Zambia
Fantamady Keita,4,274.0,0,0,3,2,5,Mali
Faouzi Ghoulam,1,154.0,0,1,3,0,3,Algeria
Faouzi Mansouri,0,14.0,0,0,1,0,1,Algeria
Faouzi Mubarak Aaish,2,186.0,0,2,3,1,4,Bahrain
Faouzi Rouissi,0,103.0,0,2,3,0,3,Tunisia
Faraj Al-Bor'osi,0,89.0,0,0,1,0,1,Libya
Faraj Laheeb,0,247.0,0,0,3,0,3,Kuwait
Fares Aouni,0,175.0,0,0,0,4,4,Namibia
Fares Juma,0,70.0,1,0,1,0,1,Saudi Arabia
Farhad Majidi,2,322.0,0,0,3,2,5,Kyrgyzstan
Farhat Haitbaev,2,136.0,0,0,0,2,2,Maldives
Farhat Musabekov,1,34.0,0,0,0,1,1,Myanmar
Farhod Tadjiyev,0,132.0,0,0,3,0,3,Uzbekistan
Farid Al Masori,1,78.0,0,0,0,1,1,Nepal
Farid Ghazi,1,12.0,0,0,1,0,1,Algeria
Faris Ramli,0,68.0,0,0,2,0,2,Singapore
Farkhod Vosiyev,0,57.0,0,0,0,1,1,Myanmar
Farlen Ilama,0,16.0,0,0,1,0,1,Costa Rica
Faroug Jabra,0,8.0,0,0,1,0,1,Sudan
Farouk Gaafar,0,55.0,0,1,2,0,2,Egypt
Farouk Ibrahim Al Awadi Al Saleh,0,24.0,0,0,0,1,1,Qatar
Farouk Miya,1,212.0,0,0,4,1,5,Togo
Farrukh Ismayilov,0,268.0,0,0,3,0,3,Azerbaijan
Farshad Noor,1,27.0,0,0,1,0,1,Afghanistan
Farshad Pious,2,296.0,0,0,4,2,6,Qatar
Faruk Hadžibegić,0,216.0,0,3,3,1,4,Yugoslavia
Faruq Ibrahim,1,11.0,0,0,0,1,1,Iraq
Fashion Sakala,0,290.0,0,1,4,1,5,Zambia
Fat'hi Kameel Fayaz Matar Marzouq,1,127.0,0,0,1,2,3,Bahrain
Fatai Amoo,0,12.0,0,0,0,1,1,Kenya
Fathi Jaber,0,76.0,0,0,0,1,1,North Korea
Fathi Kameel,3,412.0,0,0,3,4,7,Iran
Fatih Tekke,0,382.0,0,0,3,4,7,Turkey
Fatih Terim,0,128.0,0,1,2,0,2,Turkey
Fatkhullo Fatkhuloev,0,88.0,0,0,0,1,1,Bangladesh
Fatos Bećiraj,0,484.0,0,1,6,6,12,San Marino
Faustino Asprilla,2,556.0,0,0,8,4,12,Argentina
Faustino Delgado,0,3.0,0,1,1,0,1,Peru
Fausto De Amicis,1,144.0,0,0,2,0,2,Australia
Fausto Klinger,0,77.0,0,0,0,1,1,Uruguay
Fawaz Al Ahmad,0,114.0,0,0,2,0,2,Kuwait
Fawzi Al-Issawi,0,76.0,0,0,1,0,1,Libya
Fawzi Bashir,0,171.0,0,0,3,0,3,Oman
Fawzi Bashir Doorbeen,0,52.0,0,0,1,0,1,Oman
Fawzi El-Aisawi,0,22.0,0,1,1,0,1,Libya
Fawzi Moussouni,1,53.0,0,0,0,1,1,South Africa
Fayad Mahmoud,1,44.0,0,1,0,1,1,Saudi Arabia
Fayez Al-Felaij,1,90.0,0,0,1,0,1,Kuwait
Fayez Marzouq,0,87.0,0,0,0,1,1,Thailand
Faysal Shayesteh,1,78.0,0,0,0,1,1,Syria
Fayçal Fajr,0,80.0,0,0,1,0,1,Morocco
Fazrul Nawaz,1,215.0,0,0,2,2,4,Singapore
Federico Bernardeschi,0,163.0,0,0,2,1,3,Italy
Federico Bikoro,0,82.0,0,0,0,1,1,Zambia
Federico Chiesa,2,252.0,0,0,4,0,4,Italy
Federico Magallanes,0,82.0,0,2,3,0,3,Uruguay
Federico Peluso,0,90.0,0,0,1,0,1,Italy
Federico Vairo,1,51.0,0,0,1,0,1,Argentina
Federico Valverde,0,197.0,0,0,1,2,3,Paraguay
Fedor Černych,0,425.0,0,0,7,2,9,Lithuania
Feisal Salum,0,53.0,0,0,1,0,1,Tanzania
Feiz Shamsin,0,75.0,0,0,0,1,1,Laos
Fekri Al-Hubaishi,0,66.0,0,0,1,0,1,Yemen
Felicien Minde,0,74.0,0,0,1,0,1,Tanzania
Felipe Baloy,1,236.0,1,0,3,1,4,Panama
Felipe Buffoni,1,43.0,0,0,0,1,1,Argentina
Felipe Caicedo,2,859.0,0,6,8,9,17,Ecuador
Felipe Cata Edson,0,55.0,0,0,0,1,1,Eswatini
Felipe Gutiérrez,0,101.0,0,0,2,0,2,Chile
Felipe Melo,1,71.0,0,0,1,1,2,Brazil
Felipe Rosas,0,72.0,0,0,1,0,1,Mexico
Felitciano Zschusschen,0,39.0,0,1,1,0,1,Curaçao
Felix Aboagye,1,110.0,0,0,1,1,2,Mozambique
Felix Gasselich,0,123.0,0,0,1,1,2,Austria
Felix Katongo,1,90.0,0,0,1,1,2,Sudan
Felix Khojoyan,0,50.0,0,0,0,1,1,Belarus
Felix Magath,0,33.0,0,0,1,1,2,Austria
Felix Michel Melki,1,27.0,0,0,1,0,1,Lebanon
Felix Owolabi,0,49.0,0,0,1,1,2,Nigeria
Felix Tagawa,7,422.0,0,0,0,7,7,Vanuatu
Fenedy Masauvakalo,1,41.0,0,0,0,1,1,Fiji
Feng Ji-zhi,1,78.0,1,0,1,1,2,Hong Kong
Feras Esmaeel,0,17.0,0,0,0,1,1,Indonesia
Feras Shelbaieh,0,56.0,0,1,1,0,1,Jordan
Ferdinando Riva,0,35.0,0,0,0,1,1,Scotland
Ferenc Bene,5,933.0,0,0,12,13,25,German DR
Ferenc Horváth,0,206.0,0,0,3,1,4,Hungary
Ferenc Machos,0,118.0,0,0,4,0,4,Hungary
Ferenc Mészáros,0,79.0,0,0,1,1,2,Poland
Ferenc Orosz,0,15.0,0,0,1,0,1,Hungary
Ferenc Puskás,4,124.0,0,0,2,2,4,Hungary
Ferenc Sipos,0,24.0,0,0,1,0,1,Hungary
Ferhan Hasani,0,59.0,0,0,1,0,1,North Macedonia
Ferjani Sassi,2,87.0,0,1,1,1,2,Tunisia
Fernand Brosius,0,50.0,1,0,1,0,1,Portugal
Fernand Coulibaly,0,25.0,0,0,0,1,1,Tunisia
Fernandinho,1,97.0,1,0,1,1,2,Brazil
Fernando Amorebieta,0,62.0,0,0,1,0,1,Venezuela
Fernando Arce,1,205.0,0,0,4,0,4,Mexico
Fernando Astengo,2,161.0,0,0,1,1,2,Chile
Fernando Baldeón,0,60.0,0,0,0,2,2,Chile
Fernando Cabrita,0,36.0,0,0,0,1,1,Spain
Fernando Chalana,0,71.0,0,0,1,1,2,Cyprus
Fernando Consul,1,83.0,0,0,1,0,1,Brazil
Fernando Cornejo,0,52.0,0,0,0,1,1,Argentina
Fernando Couto,1,252.0,0,0,4,0,4,Portugal
Fernando Cáceres,0,69.0,0,0,1,0,1,Argentina
Fernando Fiorillo,0,69.0,0,0,1,0,1,Colombia
Fernando Francisco,0,90.0,0,0,0,1,1,Libya
Fernando Gomes,0,503.0,0,0,4,5,9,Scotland
Fernando Gómez Colomer,0,63.0,0,0,1,0,1,Spain
Fernando Hierro,6,1275.0,1,10,20,6,26,Spain
Fernando Jiménez,0,40.0,0,0,1,0,1,Costa Rica
Fernando Kanapkis,1,181.0,0,0,3,1,4,Uruguay
Fernando Llorente,0,254.0,0,0,2,2,4,South Africa
Fernando Manuel Co,0,47.0,0,0,0,1,1,Guinea
Fernando Manuel Sousa,0,51.0,0,0,1,0,1,Angola
Fernando Marcos,0,55.0,0,0,1,0,1,Mexico
Fernando Meira,0,21.0,0,0,1,0,1,Portugal
Fernando Morena,0,242.0,0,3,5,1,6,Ecuador
Fernando Morientes,6,690.0,0,0,10,2,12,Spain
Fernando Navarro Morán,1,72.0,0,0,0,1,1,Martinique
Fernando Ochoaizpur,0,48.0,0,0,1,0,1,Bolivia
Fernando Peres,0,176.0,0,1,2,0,2,Portugal
Fernando Peyroteo,1,72.0,0,1,0,1,1,Switzerland
Fernando Quirarte,0,77.0,0,0,2,0,2,Mexico
Fernando Redondo,0,65.0,0,0,0,1,1,Paraguay
Fernando Riera,4,227.0,0,0,2,2,4,Argentina
Fernando Saucedo,0,83.0,0,0,1,0,1,Bolivia
Fernando Silva,0,143.0,0,0,0,2,2,Armenia
Fernando Torres,17,1369.0,0,3,14,14,28,Spain
Fernando Varela,1,81.0,0,0,1,0,1,Cape Verde
Fernando Vergara,1,52.0,0,0,1,0,1,Chile
Ferran Torres,3,452.0,0,1,5,3,8,Georgia
Ferydoon Zandi,1,53.0,0,0,0,2,2,China PR
Fevzi Davletov,0,5.0,0,0,0,1,1,Oman
Fevzi Zemzem,0,46.0,0,0,1,1,2,Portugal
Feyyaz Uçar,0,433.0,0,1,3,4,7,Turkey
Fidel Escobar,0,22.0,0,0,0,1,1,Honduras
Fidel Martínez,0,74.0,0,0,1,1,2,Ecuador
Fikru Tefera,0,130.0,0,1,2,0,2,Ethiopia
Filip Hološko,0,312.0,0,0,3,2,5,Slovakia
Filip Ivanovski,0,86.0,0,0,1,0,1,North Macedonia
Filip Kostić,0,141.0,0,0,2,1,3,Serbia
Filip Novák,0,71.0,0,0,1,0,1,Czech Republic
Filip Stojković,0,89.0,1,0,1,0,1,Poland
Filip Đorđević,0,8.0,0,0,0,1,1,Wales
Filip Đuričić,0,163.0,0,0,3,0,3,Serbia
Filip Šebo,0,112.0,0,0,2,1,3,Slovakia
Filipe Duarte,0,52.0,0,0,1,0,1,Macau
Filipe Luís,0,114.0,0,0,2,0,2,Brazil
Filipo Bureta,0,81.0,1,0,1,0,1,Australia
Filippo Berardi,0,77.0,0,0,1,0,1,San Marino
Filippo Fabbri,0,15.0,1,0,0,1,1,San Marino
Filippo Inzaghi,3,901.0,0,2,12,10,22,Denmark
Fillisione Taufahema,1,78.0,0,0,1,0,1,Tonga
Finidi George,1,177.0,0,0,2,2,4,Nigeria
Finn Laudrup,0,71.0,0,0,2,0,2,Denmark
Finn Seemann,0,9.0,0,0,1,0,1,Norway
Firas Al-Buraikan,0,191.0,0,0,3,0,3,Saudi Arabia
Firas Al-Khatib,1,254.0,0,2,2,3,5,Syria
Firas Issmael,1,64.0,0,0,0,1,1,Afghanistan
Firmin Ndombe Mubele,2,370.0,0,0,1,4,5,Burundi
Firmin Sanou,0,42.0,0,1,0,1,1,Kenya
Fiston Abdul Razak,0,212.0,0,1,2,2,4,Seychelles
Fitzroy Simpson,1,62.0,0,0,1,0,1,Jamaica
Fivos Vrahimis,0,158.0,0,0,1,2,3,Cyprus
Flavio Maestri,0,268.0,0,0,3,2,5,Chile
Flavius Domide,0,74.0,0,0,1,0,1,Romania
Flemming Povlsen,1,594.0,0,0,7,5,12,Denmark
Fleury Di Nallo,0,255.0,0,0,2,3,5,France
Florea Dumitrache,2,592.0,0,2,6,6,12,Romania
Florea Martinovici,0,15.0,0,0,1,0,1,Romania
Florea Văetuș,0,16.0,0,0,1,0,1,Romania
Florencio Amarilla,2,174.0,0,1,3,2,5,Paraguay
Florent Hadergjonaj,0,29.0,0,0,0,1,1,North Macedonia
Florent Malouda,0,188.0,0,0,1,4,5,Georgia
Florent Rouamba,0,75.0,0,0,0,1,1,Uganda
Florentin Petre,0,187.0,0,0,2,2,4,Azerbaijan
Florian Bohnert,0,90.0,0,0,0,1,1,Bulgaria
Florian Jozefzoon,1,70.0,0,0,0,1,1,Aruba
Florian Myrtaj,0,53.0,0,0,1,0,1,Albania
Florian Thauvin,0,45.0,0,0,0,1,1,Andorra
Florin Andone,0,59.0,0,0,1,0,1,Romania
Florin Bratu,0,77.0,0,0,1,0,1,Romania
Florin Cernat,0,18.0,0,0,0,2,2,Andorra
Florin Răducioiu,10,1174.0,0,2,7,14,21,Romania
Florin Tănase,0,28.0,0,0,1,0,1,Romania
Floros Nicolaou,0,62.0,0,0,0,1,1,Scotland
Floyd Ayité,0,71.0,0,0,1,0,1,Togo
Floyd Guthrie,1,10.0,0,0,0,1,1,Jamaica
Flávio Amado,5,547.0,0,1,8,5,13,Angola
Flávio Conceição,1,28.0,0,0,1,0,1,Brazil
Flávio Minuano,3,234.0,0,0,3,2,5,Brazil
Flórián Albert,4,312.0,0,0,5,6,11,Hungary
Flórián Urbán,0,77.0,0,0,0,1,1,Azerbaijan
Fodé Camara,0,224.0,0,1,5,0,5,Guinea
Fodé Mansaré,0,132.0,0,0,2,0,2,Guinea
Fortunato Castillo,0,131.0,0,0,4,0,4,Bolivia
Fotis Papoulis,0,46.0,0,0,1,1,2,San Marino
Fouad Bushegir,1,90.0,0,0,0,1,1,Syria
Foxi Kéthévoama,0,68.0,0,0,2,0,2,Central African Republic
Fran,0,104.0,0,0,1,1,2,Spain
Fran Karačić,1,38.0,0,0,0,1,1,Nepal
Fran Núñez,0,52.0,0,0,1,0,1,Dominican Republic
Francesco Acerbi,0,21.0,0,0,0,1,1,Bosnia and Herzegovina
Francesco Graziani,1,340.0,0,0,6,2,8,Luxembourg
Francesco Totti,2,368.0,0,2,5,3,8,Belgium
Franchel Ibara,0,67.0,0,0,1,0,1,Congo
Francileudo Santos,8,851.0,0,0,14,4,18,Tunisia
Francis Doe,0,15.0,0,0,0,1,1,Senegal
Francis Dupont,0,81.0,0,0,1,0,1,Saint Vincent and the Grenadines
Francis Kahata,0,35.0,0,0,0,1,1,Nigeria
Francis Kasonde,0,56.0,0,0,0,1,1,Egypt
Francis Lee,0,206.0,0,0,3,0,3,England
Francis N'Ganga,0,104.0,0,0,2,0,2,Congo
Francis Niakuam,0,80.0,0,0,1,0,1,Papua New Guinea
Francis Ouma,0,70.0,0,0,0,1,1,Guinea
Francis Oumar,0,210.0,0,0,3,0,3,Chad
Francis Were,0,44.0,0,0,0,1,1,Burkina Faso
Francisco Antonio Pavón,0,40.0,0,0,1,0,1,Honduras
Francisco Arce,1,93.0,0,1,1,2,3,Uruguay
Francisco Atura,1,43.0,0,0,1,0,1,Palestine
Francisco Calvo,1,43.0,0,0,2,0,2,Costa Rica
Francisco Flores,0,155.0,0,0,4,0,4,Mexico
Francisco Fonseca,4,718.0,0,0,8,5,13,Saint Kitts and Nevis
Francisco Gento,0,231.0,0,0,2,1,3,Spain
Francisco González,1,33.0,0,0,1,0,1,Colombia
Francisco Higuera,0,18.0,0,0,0,1,1,Cyprus
Francisco Hormazábal,0,45.0,0,0,1,0,1,Chile
Francisco Javier Aguilar García,0,63.0,0,0,1,0,1,Spain
Francisco Javier Cruz,0,84.0,0,0,0,1,1,Canada
Francisco Javier Rodríguez,1,83.0,0,0,0,1,1,South Africa
Francisco José Carrasco,1,254.0,0,1,1,3,4,Malta
Francisco Llorente Gento,0,67.0,0,0,1,0,1,Spain
Francisco Lojacono,0,53.0,0,1,0,1,1,Israel
Francisco López Contreras,0,112.0,0,0,1,1,2,Costa Rica
Francisco Massinga,0,59.0,0,0,1,0,1,Mozambique
Francisco Molina,7,345.0,0,0,5,2,7,Chile
Francisco Palacios,0,90.0,0,0,1,0,1,Panama
Francisco Palencia,4,557.0,0,0,4,5,9,Saudi Arabia
Francisco Ramírez,0,137.0,0,0,2,3,5,Jamaica
Francisco Rodrigues,2,69.0,0,0,0,2,2,Bolivia
Francisco Rojas,0,33.0,0,0,1,0,1,Costa Rica
Francisco Rui Marcos,0,55.0,0,1,1,0,1,Mozambique
Francisco Socorro,0,37.0,0,0,0,1,1,Haiti
Francisco Uribe,0,401.0,0,0,4,3,7,Saint Vincent and the Grenadines
Francisco Valdés,1,193.0,0,0,3,0,3,Chile
Francisco Varallo,1,189.0,0,0,4,0,4,Argentina
Francisco Vital,0,58.0,0,0,1,0,1,Portugal
Francisco Zuluaga,1,19.0,0,1,1,0,1,Colombia
Franck Doté,1,26.0,0,0,0,1,1,Ghana
Franck Kessié,2,88.0,0,1,2,0,2,Ivory Coast
Franck Pangop,0,88.0,0,0,1,0,1,Cameroon
Franck Ribéry,1,536.0,0,1,5,5,10,Spain
Franck Sauzée,0,201.0,0,0,4,2,6,Yugoslavia
Franco Causio,1,94.0,0,0,1,1,2,Italy
Franco Navarro,1,332.0,0,0,3,3,6,Peru
Franco Paonessa,0,6.0,0,0,1,0,1,Puerto Rico
Francois Croes,1,27.0,1,0,0,1,1,Aruba
Francois Sakama,0,109.0,0,0,1,1,2,New Zealand
Frane Matošić,0,71.0,0,0,1,0,1,Yugoslavia
Franjo Vladić,0,50.0,0,0,1,0,1,Yugoslavia
Frank Arnesen,3,356.0,0,4,7,3,10,Denmark
Frank Fabra,2,40.0,1,0,1,1,2,Colombia
Frank Farina,0,45.0,0,0,1,0,1,Australia
Frank Feltscher,0,78.0,0,0,0,1,1,Colombia
Frank Klopas,1,20.0,0,0,0,1,1,Argentina
Frank Lampard,2,861.0,0,8,10,9,19,France
Frank Leboeuf,1,214.0,0,1,2,1,3,France
Frank McAvennie,0,59.0,0,0,1,0,1,Scotland
Frank O'Farrell,0,88.0,0,0,1,0,1,Republic of Ireland
Frank O'Neill,0,60.0,0,0,1,0,1,Republic of Ireland
Frank Odoi,1,223.0,0,0,1,2,3,Tunisia
Frank Pingel,1,245.0,0,0,3,2,5,Faroe Islands
Frank Rijkaard,2,254.0,0,0,4,0,4,Netherlands
Frank Seator,0,10.0,0,0,0,1,1,Ghana
Frank Sinalo,0,91.0,0,0,2,0,2,Malawi
Frank Stapleton,0,642.0,0,1,10,5,15,Denmark
Frank Strandli,0,59.0,0,0,1,0,1,Norway
Frank Sturing,1,6.0,0,0,0,1,1,Cayman Islands
Frank Wallace,3,118.0,0,0,1,2,3,Cuba
Frank de Boer,0,529.0,0,1,6,2,8,Finland
Frankie Beauchamp,2,124.0,0,0,0,2,2,Samoa
Frankie Hejduk,1,175.0,0,0,1,2,3,Guatemala
Frankie Oviedo,0,125.0,0,0,1,2,3,Colombia
Franklin Salas,1,139.0,0,0,1,1,2,Ecuador
Franklyn Baptiste,0,44.0,0,0,1,0,1,Grenada
Franky Vercauteren,2,394.0,0,0,4,5,9,Portugal
Frans Geurtsen,0,87.0,0,0,0,1,1,Albania
Frans Janssens,0,28.0,0,0,1,0,1,Belgium
Frans Thijssen,0,115.0,0,0,2,1,3,Netherlands
František Karkó,0,172.0,0,0,0,2,2,Finland
František Knebort,0,164.0,0,0,2,2,4,Czechoslovakia
František Pelcner,0,77.0,0,0,0,1,1,Poland
František Svoboda,1,24.0,0,0,1,0,1,Czechoslovakia
František Veselý,2,263.0,0,0,3,0,3,Czechoslovakia
František Vlk,0,108.0,0,0,1,2,3,Czechoslovakia
František Šafránek,0,38.0,0,1,0,1,1,Romania
František Štambachr,0,140.0,0,0,1,1,2,Czechoslovakia
Frantz Bertin,0,90.0,0,0,1,0,1,Haiti
Frantzdy Pierrot,2,372.0,0,0,2,3,5,Haiti
Franz Aigner,0,22.0,0,0,0,1,1,Liechtenstein
Franz Beckenbauer,5,297.0,0,0,4,1,5,Germany
Franz Binder,0,33.0,0,0,1,0,1,Austria
Franz Burgmeier,0,391.0,1,0,3,3,6,Liechtenstein
Franz Hasil,0,58.0,0,1,1,0,1,Austria
Franz Schiemer,0,159.0,0,0,0,3,3,Romania
Franz Schädler,0,78.0,0,0,1,0,1,Liechtenstein
Franz Wolny,0,54.0,0,0,0,1,1,Russia
François Amégasse,0,37.0,0,0,1,0,1,Gabon
François Heutte,0,182.0,0,0,2,1,3,Austria
François Kamano,2,73.0,0,1,1,1,2,Guinea
François M'Pelé,3,171.0,0,0,3,0,3,Congo
François N'Doumbé,0,67.0,0,0,1,0,1,Cameroon
François Omam-Biyik,5,360.0,0,1,6,5,11,Gabon
François Tahi,0,89.0,0,0,0,1,1,Sudan
François Van der Elst,0,472.0,0,0,5,5,10,Belgium
François Vanden Eynde,2,107.0,0,0,0,2,2,Republic of Ireland
François de Vries,0,59.0,0,0,0,1,1,Luxembourg
Frazer Kamwandi,0,88.0,0,0,2,0,2,Zambia
Fred,2,474.0,0,0,8,0,8,Brazil
Fred Masella,0,35.0,0,0,0,1,1,Costa Rica
Freddie Ljungberg,2,601.0,0,1,5,7,12,Poland
Freddie Mwila,0,179.0,0,0,3,0,3,Zambia
Freddy,0,52.0,0,0,1,0,1,Angola
Freddy Adu,0,76.0,0,0,2,0,2,United States
Freddy Eastwood,0,22.0,0,0,0,1,1,Slovakia
Freddy Elie,0,89.0,0,0,1,0,1,Venezuela
Freddy Fernández,0,30.0,0,0,0,1,1,El Salvador
Freddy García,1,409.0,0,0,7,2,9,Belize
Freddy Grisales,0,81.0,0,0,3,1,4,Colombia
Freddy Góndola,0,52.0,0,0,1,0,1,Panama
Freddy Rincón,5,549.0,0,0,3,8,11,Germany
Freddy Vava,1,90.0,0,0,1,0,1,Vanuatu
Frederic Remi,0,3.0,0,0,0,1,1,Namibia
Frederick Gomez,0,120.0,0,0,1,1,2,Aruba
Frederico Rosa,0,176.0,1,0,1,2,3,Portugal
Fredi Bobić,0,266.0,0,0,2,3,5,Armenia
Fredrik Jensen,0,45.0,0,0,1,1,2,Armenia
Fredrik Strømstad,0,105.0,0,0,1,1,2,Hungary
Fredy Bareiro,1,71.0,0,0,0,1,1,Brazil
Fredy Guarín,0,11.0,0,0,1,0,1,Colombia
Fredy Thompson,0,77.0,0,0,0,1,1,Grenada
Frenkie de Jong,0,108.0,0,0,0,2,2,Germany
Friaça,0,47.0,0,0,1,0,1,Brazil
Fricis Kaņeps,0,203.0,0,1,3,2,5,Latvia
Frickson Erazo,0,81.0,0,0,0,1,1,Argentina
Friday Ekpo,1,75.0,0,0,0,1,1,Cameroon
Friedrich Scherfke,1,23.0,0,1,0,1,1,Brazil
Friso Mando,0,36.0,0,2,1,1,2,Suriname
Fritz Künzli,0,524.0,0,0,7,3,10,Romania
Fritz Szepan,0,8.0,0,0,1,0,1,Germany
Fritz Walter,3,304.0,0,2,2,3,5,Norway
Frode Johnsen,0,87.0,0,0,1,0,1,Norway
Froylán Ledezma,1,140.0,0,0,3,0,3,Costa Rica
Frédéric Chassot,0,87.0,0,0,0,1,1,San Marino
Frédéric Kanouté,6,897.0,0,2,8,9,17,Kenya
Frédéric Mendy,0,11.0,0,0,0,1,1,Sudan
Fróði Benjaminsen,0,114.0,1,1,2,2,4,Italy
Fu Weng Lei,0,87.0,0,0,1,0,1,Macau
Fuad Abou Shaqr,1,105.0,0,0,1,1,2,Bahrain
Fuad Anwar,2,63.0,0,0,1,1,2,Netherlands
Fulgencio Berdugo,3,133.0,0,0,1,2,3,Colombia
Fulvio Collovati,0,40.0,0,0,1,1,2,Luxembourg
Fulvio Nesti,0,67.0,0,0,0,1,1,Switzerland
Fung Chi Ming,1,15.0,0,0,0,1,1,Malaysia
Fung Hing Wa,1,11.0,1,0,0,1,1,Hong Kong
Fyodor Cherenkov,1,140.0,0,0,3,0,3,Russia
Fyodor Kudryashov,0,117.0,1,0,2,0,2,Russia
Fyodor Smolov,0,371.0,0,0,5,1,6,Liechtenstein
Fábio Abreu,0,68.0,0,0,1,0,1,Angola
Fábio Coentrão,0,153.0,0,0,1,1,2,Israel
Fábio César Montezine,0,212.0,0,0,4,0,4,Qatar
Fábio Virginio de Lima,0,289.0,0,0,5,0,5,United Arab Emirates
Félix Arambulo,1,50.0,0,0,0,1,1,Colombia
Félix Castillo,6,310.0,0,0,1,6,7,Paraguay
Félix Lasso,0,127.0,0,0,1,1,2,Chile
Félix Loustau,6,417.0,0,0,7,0,7,Argentina
Félix Ricardo Torres,0,68.0,0,0,1,0,1,Paraguay
Félix Rodríguez,0,36.0,0,0,0,1,1,Dominica
Félix Torres,0,163.0,0,0,2,0,2,Ecuador
Férébory Doré,1,79.0,0,0,2,0,2,Congo
Gabadinho Mhango,3,179.0,0,0,2,2,4,Namibia
Gabino Sosa,6,225.0,0,0,6,0,6,Argentina
Gabriel Achilier,0,30.0,0,0,0,1,1,Peru
Gabriel Barbosa,1,316.0,0,1,3,1,4,Brazil
Gabriel Batistuta,26,1635.0,0,7,28,9,37,Argentina
Gabriel Cedrés,0,184.0,0,0,2,1,3,Uruguay
Gabriel Cichero,1,80.0,0,0,0,1,1,Chile
Gabriel Enrique Gómez,2,192.0,0,2,3,1,4,Panama
Gabriel Gnimassou,0,65.0,0,0,1,0,1,Burkina Faso
Gabriel González,0,30.0,0,0,1,0,1,Paraguay
Gabriel Heinze,2,64.0,1,0,1,2,3,Mexico
Gabriel Jaime Gómez Jaramillo,0,8.0,0,0,0,1,1,Argentina
Gabriel Jesus,0,495.0,0,0,5,4,9,Ecuador
Gabriel Mendes,0,55.0,1,0,1,0,1,Sweden
Gabriel Mercado,1,93.0,0,0,1,2,3,Chile
Gabriel Michel,0,76.0,0,0,3,0,3,Haiti
Gabriel Milito,0,16.0,0,0,0,1,1,Venezuela
Gabriel Miranda,1,88.0,0,0,1,1,2,Paraguay
Gabriel Nzeyimana,0,90.0,0,0,0,1,1,Gabon
Gabriel Riera,0,36.0,0,0,0,1,1,Czech Republic
Gabriel Tamaş,0,105.0,0,0,1,1,2,Slovenia
Gabriel Torje,0,227.0,0,1,1,4,5,Luxembourg
Gabriel Torres,8,890.0,0,5,14,4,18,Mexico
Gabriel Urdaneta,1,111.0,0,1,1,2,3,Mexico
Gabriel Wajoka,2,90.0,0,0,2,0,2,Tahiti
Gabriel Ávalos,1,90.0,0,0,0,1,1,Peru
Gadi Brumer,0,65.0,0,0,1,0,1,Israel
Gaetano Scirea,0,81.0,0,0,0,1,1,Greece
Gafurzhan Suyumbayev,0,104.0,0,0,1,2,3,Denmark
Gagny Coulibaly,1,68.0,0,1,0,1,1,Burkina Faso
Gahrymanberdi Çoňkaýew,0,87.0,0,0,0,1,1,Indonesia
Gaizka Mendieta,3,470.0,0,2,5,2,7,Spain
Gaku Shibasaki,1,81.0,0,0,1,0,1,Japan
Galabgwe Moyana,0,22.0,0,0,0,1,1,Eritrea
Galimzyan Khusainov,1,17.0,0,0,1,1,2,Spain
Galo Fidean Vásquez,0,68.0,0,0,1,0,1,Ecuador
Gamal Abdel Azim,0,4.0,0,0,1,0,1,Egypt
Gamal Abdelhamid,2,150.0,0,0,3,0,3,Egypt
Gao Feng,1,235.0,0,0,1,3,4,Syria
Gao Hongbo,1,378.0,0,0,4,2,6,Pakistan
Gao Lin,3,280.0,1,3,1,3,4,China PR
Gao Sheng,1,13.0,0,0,1,0,1,China PR
Gao Wei-jie,1,62.0,0,0,0,1,1,Australia
Garath McCleary,2,85.0,0,0,1,1,2,Costa Rica
Garba Lawal,3,214.0,0,0,3,1,4,Nigeria
Garba Okoye,0,168.0,0,0,3,1,4,Nigeria
Gareth Bale,7,1614.0,0,6,18,14,32,Wales
Gareth Barry,0,40.0,0,0,0,1,1,Kazakhstan
Gareth McAuley,2,492.0,2,0,5,6,11,San Marino
Gareth Southgate,0,88.0,0,0,0,1,1,Luxembourg
Garfield Gonsalves,0,22.0,1,0,0,1,1,Antigua and Barbuda
Garnik Avalyan,0,127.0,0,1,2,0,2,Armenia
Garra Dembélé,1,56.0,0,0,0,1,1,Botswana
Garrincha,3,194.0,0,0,3,2,5,Brazil
Garry Lund,0,56.0,1,0,0,1,1,New Zealand
Garry O'Connor,0,120.0,0,0,1,1,2,Scotland
Garry Rodrigues,1,260.0,0,0,0,4,4,South Africa
Gary Breen,1,236.0,0,0,2,2,4,Republic of Ireland
Gary Byrne,0,68.0,0,1,1,0,1,Australia
Gary Cahill,0,74.0,0,0,1,1,2,Bulgaria
Gary Caldwell,0,67.0,0,0,1,0,1,Scotland
Gary Cole,0,477.0,0,1,7,2,9,Fiji
Gary Doherty,0,196.0,0,0,1,2,3,Russia
Gary Gillespie,0,58.0,1,0,1,0,1,Yugoslavia
Gary Kelly,0,80.0,0,0,0,1,1,Cyprus
Gary Lineker,10,1012.0,0,3,17,5,22,England
Gary Mabbutt,0,21.0,0,0,1,0,1,England
Gary Mackay,0,86.0,0,0,0,1,1,Bulgaria
Gary McAllister,1,186.0,0,2,2,1,3,Scotland
Gary McSwegan,0,50.0,0,0,1,0,1,Scotland
Gary Medel,0,329.0,1,0,3,3,6,Bolivia
Gary Naysmith,0,63.0,0,0,0,1,1,Iceland
Gary Neville,0,68.0,1,0,1,0,1,Croatia
Gary Ngassebe,1,78.0,0,0,0,1,1,Mali
Gary Speed,0,307.0,0,0,3,4,7,Moldova
Gary Waddock,0,23.0,0,0,1,1,2,Iceland
Garðar Árnason,0,59.0,0,0,1,0,1,Iceland
Gaston Bawa,1,36.0,0,0,0,1,1,Burkina Faso
Gaston Taument,1,86.0,0,0,1,0,1,Netherlands
Gastón Giménez,0,85.0,0,0,0,1,1,Venezuela
Gastón Pereiro,0,90.0,0,0,1,0,1,Uruguay
Gastón Silva,0,24.0,1,0,0,1,1,Uruguay
Gatoch Panom,0,47.0,0,1,1,0,1,Ethiopia
Gavi,1,74.0,0,0,1,0,1,Spain
Gavin Glinton,0,74.0,0,0,1,0,1,Turks and Caicos Islands
Gavril Balint,2,395.0,0,0,6,2,8,Romania
Gavril Serfözö,0,27.0,0,0,0,1,1,Bulgaria
Gayson Gregory,0,185.0,0,0,2,2,4,Bermuda
Gaël Kakuta,0,6.0,0,0,0,1,1,Tanzania
Gbassay Sessay,1,11.0,0,0,1,0,1,Sierra Leone
Gebremedhin Haile,0,9.0,0,0,1,0,1,Ethiopia
Gedo,5,435.0,0,0,3,2,5,Egypt
Geir Frigård,0,88.0,0,0,1,0,1,Norway
Geir Karlsen,0,69.0,1,0,0,1,1,Norway
Gelson,0,2.0,0,0,1,0,1,Angola
Gelson Fernandes,1,142.0,0,0,0,2,2,Moldova
Genar Andrinúa,0,3.0,0,0,0,1,1,Northern Ireland
Genc Tomorri,0,22.0,0,0,0,1,1,Germany
Genki Haraguchi,3,440.0,0,1,3,6,9,Japan
Gennadi Bliznyuk,0,78.0,0,0,2,0,2,Belarus
Gennadi Gusarov,0,45.0,0,0,0,2,2,Turkey
Gennady Yevryuzhikhin,0,77.0,0,0,2,1,3,Cyprus
Genrich Fedosov,1,75.0,0,0,0,1,1,Poland
Geny Catamo,0,158.0,0,1,1,1,2,Mozambique
Geoff Aunger,1,151.0,0,0,3,0,3,Canada
Geoff Brand,0,90.0,0,0,1,0,1,New Zealand
Geoff Cameron,0,86.0,0,0,2,0,2,United States
Geoff Hurst,2,768.0,0,0,11,2,13,England
Geoffrey Sserunkuma,0,107.0,0,0,2,0,2,Uganda
Geofrey Massa,0,107.0,0,0,3,0,3,Uganda
Geofrey Munshya,2,93.0,0,0,0,2,2,Ethiopia
Georg Hammer,0,10.0,0,0,0,1,1,Portugal
Georg Siimenson,0,36.0,0,0,0,2,2,Sweden
George Alhassan,2,311.0,0,0,3,4,7,Ghana
George Best,0,380.0,0,1,5,2,7,Switzerland
George Borba,1,12.0,0,0,1,0,1,Israel
George Cummins,0,120.0,0,0,0,2,2,Luxembourg
George Dangler,0,42.0,0,0,1,0,1,Dominica
George Dublin,0,77.0,0,0,0,2,2,Aruba
George Isaac,0,359.0,0,0,5,1,6,Saint Kitts and Nevis
George Kiriau,0,100.0,0,0,1,1,2,Tonga
George Mallia,0,81.0,0,0,0,2,2,Denmark
George Mbwando,0,81.0,0,0,0,1,1,Mauritania
George McCartney,0,61.0,0,0,1,0,1,Northern Ireland
George Moussis,0,29.0,0,0,0,1,1,Anguilla
George Mouyémé,1,82.0,0,0,0,1,1,Angola
George Ngoma Nanitelamio,0,15.0,0,0,0,1,1,Equatorial Guinea
George Onyango,0,24.0,0,0,1,0,1,Kenya
George Pușcaș,0,220.0,0,0,2,3,5,Romania
George Robledo,1,141.0,0,0,4,0,4,Chile
George Suri,0,42.0,0,0,1,0,1,Solomon Islands
George Weah,2,336.0,0,0,5,2,7,Liberia
Georges Aeby,1,24.0,0,0,1,0,1,Switzerland
Georges Akieremy,0,73.0,0,0,0,1,1,Algeria
Georges Bereta,0,61.0,0,0,1,0,1,France
Georges Bregy,0,400.0,0,2,6,3,9,Switzerland
Georges Gertrude,1,53.0,0,0,0,1,1,Canada
Georges Gope-Fenepej,4,529.0,0,0,1,7,8,Vanuatu
Georges Grün,2,179.0,0,0,2,3,5,Belgium
Georges Lech,0,312.0,0,0,3,2,5,France
Georges Verriest,1,116.0,0,1,0,1,1,Austria
Georges Vuilleumier,0,56.0,0,0,0,2,2,Portugal
Georgi Asparuhov,4,770.0,0,1,11,3,14,Bulgaria
Georgi Bachev,1,88.0,1,0,1,0,1,Spain
Georgi Chilikov,0,37.0,0,0,1,0,1,Bulgaria
Georgi Denev,0,196.0,0,0,5,1,6,Cyprus
Georgi Dimitrov,0,287.0,0,0,2,4,6,Norway
Georgi Dzhikiya,0,111.0,0,0,1,1,2,Russia
Georgi Georgiev,1,131.0,0,0,1,1,2,Uzbekistan
Georgi Iliev,0,69.0,0,0,1,0,1,Bulgaria
Georgi Ivanov,0,157.0,0,0,2,1,3,Bulgaria
Georgi Kinkladze,0,258.0,0,1,3,2,5,Georgia
Georgi Kondratiev,3,147.0,0,0,3,0,3,Russia
Georgi Kostadinov,0,192.0,0,0,1,2,3,Belarus
Georgi Markov,0,18.0,0,0,1,0,1,Bulgaria
Georgi Milanov,0,66.0,0,0,1,0,1,Bulgaria
Georgi Panchediev,0,89.0,0,1,1,0,1,Bulgaria
Georgi Slavkov,0,163.0,0,0,3,1,4,Bulgaria
Georgi Sokolov,1,64.0,0,0,1,0,1,Bulgaria
Georgi Tkavadze,0,18.0,0,0,1,0,1,Turkmenistan
Georgi Yomov,0,89.0,0,0,1,0,1,Bulgaria
Georgi Yordanov,0,39.0,0,0,1,0,1,Bulgaria
Georgina Tura,1,77.0,0,0,0,1,1,Tahiti
Georginio Wijnaldum,0,1055.0,0,0,10,8,18,Netherlands
Georgios Delikaris,0,161.0,0,0,3,1,4,Greece
Georgios Efrem,0,211.0,0,0,5,0,5,Cyprus
Georgios Fotakis,0,79.0,0,0,0,1,1,Georgia
Georgios Georgiadis,0,204.0,0,0,2,2,4,San Marino
Georgios Kamaras,0,83.0,0,0,0,1,1,Israel
Georgios Karagounis,0,30.0,0,0,0,1,1,Finland
Georgios Kostikos,0,141.0,0,1,1,2,3,Greece
Georgios Samaras,2,441.0,0,2,4,2,6,Bosnia and Herzegovina
Georgios Tzavellas,0,90.0,0,0,1,0,1,Greece
Geovani Faria da Silva,0,36.0,0,1,1,0,1,Brazil
Gerald Asamoah,0,51.0,0,0,1,0,1,Germany
Gerald Delmas,1,90.0,0,0,1,0,1,New Caledonia
Gerald Díaz,0,3.0,0,0,1,0,1,Puerto Rico
Gerald Phiri Jr.,0,81.0,0,1,1,0,1,Malawi
Gerald Quennet,3,93.0,0,0,3,0,3,Tahiti
Gerald Vanenburg,0,19.0,0,0,1,0,1,Netherlands
Gerald Willfurth,0,71.0,0,0,1,0,1,Austria
Geraldo,0,41.0,0,0,1,0,1,Angola
Geraldo José da Silva,1,106.0,0,0,0,2,2,Ecuador
Gerard Cieślik,0,93.0,0,0,2,0,2,Poland
Gerard Ellie,0,149.0,0,1,2,0,2,Haiti
Gerard López,0,59.0,0,0,1,1,2,Bosnia and Herzegovina
Gerard Maki,1,38.0,0,0,0,1,1,Cook Islands
Gerard Moreno,0,222.0,0,0,4,0,4,Spain
Gerard Piqué,1,277.0,1,0,4,1,5,Spain
Gerard Plessers,0,12.0,0,0,1,0,1,Belgium
Gerard Williams,1,13.0,0,0,0,1,1,Belize
Gerardo Arce,0,11.0,1,0,1,0,1,Brazil
Gerardo Bedoya,0,170.0,0,0,1,2,3,United States
Gerardo Galindo,1,54.0,0,0,1,0,1,Mexico
Gerardo Gordillo,1,119.0,0,0,2,0,2,Guatemala
Gerardo Rivas,5,222.0,0,0,1,5,6,Paraguay
Gerardo Torrado,4,269.0,0,1,4,1,5,Mexico
Gerardo Yecerotte,0,85.0,0,0,1,0,1,Bolivia
Gerd Kische,0,18.0,0,0,1,0,1,Netherlands
Gerd Müller,12,2147.0,0,3,24,15,39,Germany
Gerd Weber,0,196.0,0,1,2,2,4,German DR
Geremi,2,121.0,0,1,2,0,2,Cameroon
Geremi Njitap,3,250.0,0,0,4,2,6,Cameroon
Geremy Lombardi,0,71.0,0,0,1,0,1,Dominican Republic
Gergely Rudolf,0,395.0,0,0,4,3,7,Sweden
Gergő Lovrencsics,0,26.0,0,0,0,1,1,Greece
Gerhard Hanappi,0,72.0,0,0,2,1,3,Austria
Gerhard Körner,0,35.0,0,1,1,0,1,German DR
Gerhard Rodax,1,63.0,0,0,1,0,1,Austria
Gerhard Siedl,0,55.0,0,0,0,1,1,Norway
Gerhard Strack,0,79.0,0,0,1,0,1,Germany
Gerhard Vogt,0,47.0,0,0,0,1,1,Portugal
Germaine van Dijk,0,11.0,0,0,0,1,1,Guyana
Germán Aceros,3,104.0,0,0,2,1,3,Colombia
Germán Carty,0,69.0,0,0,2,0,2,Peru
Germán Leguía,0,6.0,0,0,1,0,1,Peru
Gernot Jurtin,0,65.0,0,0,1,0,1,Austria
Gerry Armstrong,2,501.0,0,1,7,4,11,Northern Ireland
Gerry Baker,0,81.0,0,0,2,0,2,United States
Gerry Daly,0,413.0,0,1,6,2,8,Denmark
Gerry Hitchens,1,38.0,0,0,0,1,1,Brazil
Gerry McMahon,0,49.0,0,0,0,1,1,Liechtenstein
Gerry Taggart,0,140.0,0,0,1,3,4,Denmark
Gerson Díaz,0,78.0,0,0,0,1,1,Peru
Gerson Mayen,1,131.0,0,0,3,0,3,El Salvador
Gerson Rodrigues,0,520.0,1,1,3,6,9,Luxembourg
Gerson Tinoco,0,94.0,0,0,1,1,2,Saint Vincent and the Grenadines
Gerson Torres,0,90.0,0,0,1,0,1,Costa Rica
Gert Claessens,0,32.0,0,0,1,0,1,Belgium
Gert Dörfel,0,142.0,0,0,0,3,3,Northern Ireland
Gert Verheyen,0,220.0,0,0,2,3,5,Belgium
Gervais Batota,0,96.0,0,0,1,1,2,Congo
Gervatius Uri Khob,2,237.0,0,0,0,4,4,Mozambique
Gervinho,8,528.0,0,0,8,3,11,Ivory Coast
Gerónimo Barbadillo,0,64.0,0,0,2,1,3,Peru
Getaneh Kebede,2,580.0,1,1,8,2,10,Ethiopia
Gevorg Ghazaryan,0,580.0,0,0,6,4,10,Armenia
Ghafour Jahani,0,207.0,0,0,4,1,5,Hong Kong
Ghailene Chaalali,0,47.0,0,0,1,0,1,Tunisia
Ghanem Al-Hajri,1,58.0,0,0,0,1,1,Qatar
Ghanem Hamarsheh,0,176.0,0,0,2,0,2,Jordan
Ghanem Sultan,1,53.0,1,0,0,1,1,Egypt
Gharib Amzine,0,46.0,0,0,0,1,1,Algeria
Gharib Hareb,0,33.0,0,1,1,0,1,United Arab Emirates
Ghazi Al Kuwari,0,82.0,0,0,1,0,1,Bahrain
Gheorghe Andronic,0,87.0,0,0,1,0,1,Moldova
Gheorghe Boghiu,0,43.0,0,0,0,1,1,Liechtenstein
Gheorghe Bucur,0,237.0,0,0,4,0,4,Romania
Gheorghe Constantin,0,138.0,0,0,2,0,2,Romania
Gheorghe Craioveanu,0,113.0,0,0,1,2,3,Romania
Gheorghe Grozav,0,45.0,0,0,0,1,1,Turkey
Gheorghe Hagi,3,1108.0,0,4,17,10,27,Northern Ireland
Gheorghe Mulţescu,0,40.0,0,0,1,0,1,Romania
Gheorghe Ovseannicov,0,25.0,0,0,0,1,1,Latvia
Gheorghe Popescu,0,612.0,0,1,8,5,13,Romania
Ghislain Akassou,0,45.0,0,0,0,1,1,Rwanda
Gholam Ali,0,20.0,0,0,1,0,1,United Arab Emirates
Gholam Hossein Farzami,0,57.0,0,0,1,0,1,Iran
Gholam Hossein Mazloumi,0,311.0,0,0,3,2,5,Iran
Gholam Vafakhah,0,23.0,0,0,1,0,1,Iran
Gholamreza Rezaei,1,304.0,0,0,2,3,5,Syria
Giacinto Facchetti,0,162.0,0,0,2,1,3,Italy
Giacomo Bulgarelli,2,181.0,0,0,3,0,3,Italy
Giacomo Raspadori,0,24.0,0,0,1,0,1,Italy
Giampaolo Pazzini,0,226.0,0,0,2,1,3,Montenegro
Giampiero Boniperti,0,195.0,0,0,2,1,3,Italy
Giancarlo Antognoni,0,96.0,0,0,1,2,3,Luxembourg
Giancarlo De Sisti,0,124.0,0,1,2,1,3,Austria
Giancarlo Maldonado,0,511.0,0,0,8,2,10,Bolivia
Gianfranco Zola,0,454.0,0,0,6,3,9,Italy
Gianluca Lapadula,3,203.0,0,0,4,2,6,Ecuador
Gianluca Vialli,1,343.0,0,0,7,1,8,Italy
Gianluca Zambrotta,1,6.0,0,0,1,0,1,Italy
Gianni Rivera,2,573.0,0,1,8,2,10,Italy
Giannis Gianniotas,0,78.0,0,0,1,0,1,Greece
Gianpetro Zappa,0,121.0,0,0,1,1,2,Switzerland
Gibby Mbasela,0,11.0,0,0,1,0,1,Zambia
Gideon Omokirio,3,216.0,1,1,3,2,5,Solomon Islands
Gideon Tish,0,38.0,0,0,1,0,1,Israel
Gidi Damti,0,94.0,0,0,1,1,2,Sweden
Giedrius Arlauskis,0,101.0,2,0,1,1,2,Switzerland
Gift Kampamba,1,112.0,0,0,0,3,3,Egypt
Gigi Riva,1,1085.0,0,2,12,8,20,Italy
Gijsberta Gersley,0,40.0,0,0,0,1,1,Dominican Republic
Gil Guiambe,0,73.0,0,0,0,2,2,DR Congo
Gil Reece,0,113.0,0,0,1,1,2,Wales
Gil Vermouth,0,36.0,0,0,1,0,1,Israel
Gilbert Agius,0,103.0,0,0,0,2,2,Faroe Islands
Gilbert Chirwa,0,3.0,0,0,1,0,1,Malawi
Gilbert Dussier,0,245.0,0,1,3,2,5,German DR
Gilbert Mushangazhike,0,95.0,0,0,2,0,2,Zimbabwe
Gilbert Nyhime,0,90.0,0,0,0,1,1,Turks and Caicos Islands
Gilbert Van Binst,0,15.0,0,0,1,0,1,Belgium
Gilbert Zender,0,52.0,0,0,0,1,1,Finland
Gilbert Álvarez,0,72.0,0,0,0,1,1,Peru
Gilberto,1,59.0,0,0,0,1,1,Japan
Gilberto Alves,2,107.0,0,0,1,1,2,Peru
Gilberto Murgas,1,34.0,0,1,0,1,1,Costa Rica
Gilberto Silva,0,78.0,1,0,0,1,1,Brazil
Gilberto Yearwood,1,89.0,0,0,0,1,1,Jamaica
Gilberto dos Santos,2,185.0,0,1,1,2,3,Lebanon
Giles Barnes,1,41.0,0,0,0,2,2,Haiti
Gill Swerts,0,88.0,0,0,0,1,1,Bosnia and Herzegovina
Gilles Bettmer,0,27.0,0,0,1,0,1,Luxembourg
Gilles De Bilde,0,86.0,0,0,1,1,2,Belgium
Gilles Malinowski,1,90.0,0,0,0,1,1,Fiji
Gilles Rampillon,0,75.0,0,0,1,0,1,France
Gilles Sunu,0,71.0,0,0,1,0,1,Togo
Gilles Yapi Yapo,0,96.0,0,0,2,0,2,Ivory Coast
Gilli Rólantsson,0,32.0,0,0,1,0,1,Faroe Islands
Gino Brandon,0,82.0,0,0,0,1,1,Guatemala
Gino Colaussi,3,101.0,0,0,0,4,4,France
Gino Iorgulescu,0,49.0,1,0,1,1,2,Northern Ireland
Gino Pariani,1,17.0,0,0,0,1,1,Spain
Gino Pivatelli,0,84.0,0,0,1,0,1,Italy
Ginter Gawlik,0,2.0,0,0,1,0,1,Poland
Gints Freimanis,0,40.0,0,0,0,1,1,Hungary
Giora Spiegel,3,331.0,0,0,3,3,6,Hong Kong
Giorgi Demetradze,0,352.0,0,0,2,4,6,Georgia
Giorgi Gakhokidze,0,169.0,0,0,2,0,2,Georgia
Giorgi Kharaishvili,0,10.0,0,0,0,1,1,Gibraltar
Giorgi Kvilitaia,0,84.0,0,0,0,1,1,Gibraltar
Giorgi Merebashvili,0,66.0,0,0,0,1,1,Moldova
Giorgi Papunashvili,0,59.0,0,0,1,0,1,Georgia
Giorgi Shashiashvili,0,26.0,0,0,1,0,1,Georgia
Giorgian de Arrascaeta,2,234.0,0,1,4,3,7,Peru
Giorgio Chiellini,1,438.0,1,0,6,2,8,Italy
Giorgio Chinaglia,0,29.0,0,1,0,2,2,Luxembourg
Giorgos Dedes,0,93.0,0,0,2,0,2,Greece
Giorgos Donis,0,191.0,0,0,1,2,3,San Marino
Giorgos Karagounis,1,280.0,0,1,4,1,5,Portugal
Giorgos Koudas,0,89.0,0,0,2,0,2,Greece
Giorgos Masouras,0,77.0,0,0,2,0,2,Greece
Giorgos Merkis,0,9.0,0,0,1,0,1,Cyprus
Giorgos Savvidis,0,41.0,0,0,1,0,1,Cyprus
Giorgos Sideris,0,471.0,0,1,8,2,10,Greece
Giorgos Skartados,0,54.0,0,0,0,1,1,Albania
Giourkas Seitaridis,0,29.0,0,0,1,0,1,Greece
Giovane Élber,2,177.0,0,0,0,2,2,El Salvador
Giovani Lo Celso,1,74.0,0,0,0,1,1,Venezuela
Giovani dos Santos,5,494.0,0,0,3,6,9,Mexico
Giovanni Di Lorenzo,0,90.0,0,0,2,0,2,Italy
Giovanni Drenthe,0,57.0,0,0,0,1,1,Cayman Islands
Giovanni Ferrari,0,176.0,0,0,3,0,3,Italy
Giovanni Gayle,1,25.0,0,0,1,0,1,Honduras
Giovanni Hernández,3,282.0,0,0,3,1,4,Colombia
Giovanni Moreno,0,63.0,0,0,1,0,1,Colombia
Giovanni Regales,1,38.0,0,0,1,0,1,Curaçao
Giovanni Savarese,0,138.0,0,0,3,0,3,Venezuela
Giovanni Sio,0,51.0,0,0,2,0,2,Ivory Coast
Giovanni Trigueros,0,88.0,0,0,1,0,1,El Salvador
Giovanni van Bronckhorst,2,267.0,0,0,2,2,4,Netherlands
Giovanny Espinoza,0,5.0,0,0,1,0,1,Ecuador
Girma Tekle,1,290.0,0,0,4,0,4,Ethiopia
Girma Tesfaye,1,90.0,0,0,1,0,1,Ethiopia
Giuseppe Bergomi,0,9.0,0,0,1,0,1,Italy
Giuseppe Giannini,0,98.0,0,0,2,0,2,Italy
Giuseppe Meazza,1,276.0,0,1,4,1,5,Italy
Giuseppe Rossi,2,169.0,0,0,1,2,3,United States
Giuseppe Signori,0,187.0,0,0,2,1,3,Malta
Given Singuluma,1,2.0,0,0,1,0,1,Zambia
Givi Nodia,2,86.0,0,0,2,0,2,Russia
Gjergji Muzaka,0,87.0,0,0,0,1,1,Romania
Gjorgji Hristov,0,391.0,0,0,6,3,9,Armenia
Gladys Bokese,0,72.0,0,0,0,1,1,Eswatini
Glen Johnson,1,49.0,1,0,1,0,1,Sweden
Glenn Hoddle,0,193.0,0,0,3,1,4,England
Glenn Hysén,0,100.0,0,0,1,1,2,Sweden
Glenn Strömberg,1,316.0,0,0,2,4,6,Sweden
Glenn Whelan,1,78.0,0,0,1,1,2,Georgia
Glensworth Elizee,0,45.0,0,0,1,0,1,Dominica
Gleofilo Vlijter,2,142.0,0,0,3,0,3,Suriname
Glyn Hodges,0,28.0,0,0,1,0,1,Wales
Goce Sedloski,0,192.0,0,1,2,2,4,North Macedonia
Gocha Gogrichiani,0,59.0,0,0,1,0,1,Georgia
Gocha Jamarauli,0,53.0,0,0,1,0,1,Georgia
Godfred Karikari,0,156.0,0,0,2,0,2,Hong Kong
Godfrey Chitalu,0,443.0,0,0,6,2,8,Sudan
Godfrey Katerega,0,73.0,0,0,1,0,1,Uganda
Godfrey Kisitu,2,94.0,0,0,0,2,2,Congo
Godfrey Oboabona,0,82.0,0,0,0,1,1,Namibia
Godfrey Walusimbi,0,87.0,0,1,1,0,1,Uganda
Godwin Attram,0,87.0,0,0,0,1,1,Cape Verde
Godwin Emenako,0,28.0,0,0,1,0,1,Nigeria
Godwin Iwelumo,0,93.0,0,0,1,1,2,Nigeria
Godwin Odiye,0,61.0,1,0,0,1,1,Nigeria
Gogie Stewart,0,82.0,0,0,1,1,2,Canada
Gohar Zaman,3,210.0,0,0,3,0,3,Pakistan
Gohi Bi Zoro Cyriac,0,44.0,0,0,0,1,1,Liberia
Golman Pierre,1,773.0,0,0,8,7,15,Haiti
Gonzalo Castañeda,0,78.0,0,0,1,1,2,Ecuador
Gonzalo Farfán,1,9.0,0,0,1,0,1,Mexico
Gonzalo Galindo,1,122.0,0,0,1,2,3,Bolivia
Gonzalo Higuaín,9,973.0,0,0,18,5,23,Argentina
Gonzalo Jara,0,98.0,0,0,1,1,2,Venezuela
Gonzalo Martínez,1,15.0,0,0,1,0,1,Colombia
Gonzalo Pineda,1,65.0,0,0,1,0,1,Mexico
Gonzalo Plata,1,314.0,0,0,3,1,4,Ecuador
Gonzalo Romero,3,255.0,0,0,2,3,5,Guatemala
Gonzalo de los Santos,0,29.0,0,0,1,0,1,Uruguay
Gonçalo Guedes,0,147.0,0,0,1,1,2,Serbia
Gonçalo Paciência,0,56.0,0,0,1,0,1,Portugal
Gonçalo Ramos,3,135.0,0,0,3,0,3,Portugal
Goran Maznov,0,180.0,0,0,3,1,4,North Macedonia
Goran Pandev,1,504.0,0,2,4,9,13,North Macedonia
Goran Stavrevski,0,93.0,1,0,2,0,2,North Macedonia
Goran Vlaović,3,250.0,0,0,2,3,5,Turkey
Gordon Braun,0,11.0,0,0,1,0,1,Luxembourg
Gordon Durie,0,269.0,0,0,2,3,5,Yugoslavia
Gordon Kinsaini,0,55.0,0,0,2,0,2,Suriname
Gordon McQueen,0,207.0,0,0,0,3,3,Romania
Gordon Schildenfeld,0,87.0,0,0,1,0,1,Croatia
Gordon Smith,0,79.0,0,0,0,1,1,Spain
Gordon Strachan,1,153.0,0,1,0,3,3,Sweden
Gorgonio Ibarrola,1,62.0,0,0,0,1,1,Ecuador
Gouramangi Singh,1,99.0,0,0,1,1,2,Bahrain
Goçguly Goçgulyýew,1,5.0,0,1,0,1,1,Taiwan
Graeme Rutjes,0,13.0,0,0,0,1,1,Wales
Graeme Souness,1,86.0,0,0,0,1,1,Russia
Graham Arnold,0,422.0,0,0,7,1,8,Australia
Graham Williams,1,48.0,1,0,1,0,1,Russia
Graham Zusi,0,300.0,0,0,3,1,4,United States
Granit Xhaka,2,466.0,0,0,5,4,9,Slovenia
Grant Hanley,0,116.0,0,0,2,0,2,Scotland
Grant McCann,0,166.0,0,0,1,2,3,Liechtenstein
Grant Turner,0,528.0,0,0,8,2,10,New Zealand
Graziano Pellè,2,369.0,0,0,3,3,6,Malta
Grațian Sepi,0,18.0,0,0,0,1,1,Switzerland
Greg Brown,0,85.0,0,0,1,0,1,Australia
Greg Vanney,0,90.0,0,0,1,0,1,United States
Gregorio Benito,0,5.0,1,0,1,0,1,Romania
Gregorio Gómez,0,27.0,0,0,1,0,1,Mexico
Gregory Goodridge,0,161.0,0,0,2,2,4,Barbados
Gregory Richardson,0,1.0,0,0,1,0,1,Guyana
Grenddy Perozo,1,90.0,0,0,0,1,1,Paraguay
Grover Harmon,1,35.0,0,0,0,1,1,Tonga
Grzegorz Krychowiak,1,228.0,0,0,3,2,5,Georgia
Grzegorz Lato,10,926.0,0,0,9,10,19,Poland
Grégoire M'Bida,2,220.0,0,0,3,1,4,Cameroon
Grétar Steinsson,0,9.0,0,0,0,1,1,Bulgaria
Gu Guangming,5,359.0,0,0,3,3,6,China PR
Gu Sang-Bum,0,85.0,0,0,1,0,1,South Korea
Gualberto Mojica,0,26.0,0,0,1,0,1,Bolivia
Gudmundur Thorbjornsson,0,35.0,0,0,0,1,1,Spain
Guedes Lupapa,0,2.0,0,0,1,0,1,Angola
Guido Alvarenga,1,75.0,0,1,0,2,2,Uruguay
Guido Andrade,1,49.0,0,0,0,1,1,Colombia
Guido Buchwald,0,44.0,0,0,1,0,1,Germany
Guido Burgstaller,0,99.0,0,0,2,0,2,Austria
Guido Gratton,0,108.0,0,0,2,0,2,Italy
Guido Rodríguez,1,13.0,0,0,1,0,1,Argentina
Guilherme Afonso,0,112.0,0,0,2,0,2,Angola
Guilherme de Cássio Alves,1,9.0,0,0,1,0,1,Brazil
Guilherme de Paula Lucrécio,1,72.0,0,1,1,0,1,Malaysia
Guillaume Gillet,0,45.0,0,0,1,0,1,Belgium
Guillermo Albornoz,1,49.0,0,0,0,1,1,Brazil
Guillermo Amor,1,228.0,0,0,2,2,4,Spain
Guillermo Barbadillo,0,62.0,0,0,0,1,1,Chile
Guillermo Cantu,0,79.0,0,0,1,0,1,Mexico
Guillermo Clavero,0,149.0,0,0,4,0,4,Chile
Guillermo Díaz,0,128.0,0,0,3,0,3,Chile
Guillermo Díaz Carmona,1,52.0,0,0,0,1,1,Bolivia
Guillermo Escalada,3,263.0,0,0,4,4,8,Uruguay
Guillermo Franco,1,261.0,0,0,2,3,5,Mexico
Guillermo La Rosa,1,208.0,0,0,0,3,3,Colombia
Guillermo Ochoa,0,53.0,1,0,1,0,1,Honduras
Guillermo Ramírez,1,249.0,0,0,2,4,6,Trinidad and Tobago
Guillermo Rivera,0,311.0,0,0,5,1,6,El Salvador
Guillermo Riveros,1,40.0,0,0,0,1,1,Brazil
Guillermo Saavedra,0,25.0,0,0,1,0,1,Chile
Guillermo Stábile,7,323.0,0,0,7,1,8,Argentina
Guillermo Subiabre,2,161.0,0,1,3,1,4,Chile
Guillermo Torres,1,16.0,0,0,1,0,1,Chile
Gulzhigit Alykulov,1,68.0,0,0,1,2,3,Kyrgyzstan
Gunnar Aase,0,77.0,0,0,0,1,1,Luxembourg
Gunnar Gren,0,81.0,0,0,1,0,1,Sweden
Gunnar Halle,0,129.0,0,0,3,0,3,Norway
Gunnar Heiðar Þorvaldsson,0,40.0,0,0,1,1,2,Iceland
Gunnar Thoresen,0,3.0,0,0,1,0,1,Norway
Gunther Schepens,0,74.0,0,0,1,1,2,Belgium
Guram Kashia,0,56.0,0,0,0,1,1,Finland
Gurban Gurbanov,2,298.0,0,1,2,3,5,Liechtenstein
Gurbangeldi Durdyýew,0,110.0,0,0,0,2,2,Jordan
Gustav Josefsson,0,48.0,0,0,2,0,2,Sweden
Gustav Wetterström,3,337.0,0,0,3,3,6,Sweden
Gustave Bebbe,0,87.0,0,0,0,1,1,Mauritius
Gustave Kemp,0,33.0,0,0,1,0,1,Luxembourg
Gustavo Adolfo Cabrera,0,49.0,1,0,0,2,2,Guatemala
Gustavo Adrián López,0,83.0,0,0,1,0,1,Argentina
Gustavo Cuéllar,1,31.0,0,0,1,0,1,Colombia
Gustavo Gómez,2,272.0,3,0,3,2,5,Paraguay
Gustavo Morínigo,0,107.0,0,0,2,0,2,Paraguay
Gustavo Moscoso,1,90.0,0,0,0,1,1,Germany
Gustavo Neffa,3,134.0,0,0,3,1,4,Paraguay
Gustavo Peña,0,14.0,0,1,1,0,1,Mexico
Gustavo Poyet,0,161.0,0,0,1,1,2,Uruguay
Gustavo Sangaré,0,24.0,0,0,0,1,1,Cameroon
Gustavo Vassallo,0,11.0,0,0,1,0,1,Peru
Guti,0,120.0,0,0,2,0,2,Spain
Guus Til,0,80.0,0,0,1,0,1,Netherlands
Guvanch Ovekov,0,77.0,0,1,1,0,1,Turkmenistan
Guwanç Abylow,0,24.0,0,0,2,0,2,Turkmenistan
Guwançmuhammet Öwekow,0,81.0,0,0,3,0,3,Turkmenistan
Guy Feutchine,0,82.0,0,0,1,0,1,Cameroon
Guy François,0,216.0,0,0,2,1,3,Haiti
Guy Hellers,0,179.0,1,0,1,2,3,Luxembourg
Guy Mamihasindrahona,0,90.0,0,0,1,0,1,Madagascar
Guy Mbenza,0,125.0,0,0,2,0,2,Congo
Guy Nzeng,1,59.0,0,0,1,0,1,Gabon
Guy Roger Nzamba,0,214.0,0,0,3,2,5,Cameroon
Guy Saint-Vil,0,188.0,0,0,3,1,4,Haiti
Guðmundur Torfason,0,62.0,0,0,0,1,1,Turkey
Guðni Bergsson,0,61.0,0,0,1,0,1,Iceland
Gyasi Zardes,0,484.0,0,0,8,0,8,United States
Gylfi Sigurðsson,3,1129.0,0,6,12,10,22,Portugal
Gyula Hajszán,0,109.0,0,0,2,0,2,Hungary
Gyula Rákosi,0,129.0,0,0,1,1,2,German DR
Gyula Zsengellér,5,533.0,0,1,10,0,10,Hungary
György Bognár,0,131.0,0,1,1,3,4,Poland
György Garics,0,82.0,0,0,1,0,1,Austria
György Sárosi,6,381.0,0,1,5,2,7,Bulgaria
György Tatar,0,90.0,0,0,1,1,2,Russia
Győző Burcsa,0,65.0,0,0,1,0,1,Hungary
Gábor Egressy,0,51.0,0,0,1,0,1,Hungary
Gábor Gyepes,0,80.0,1,0,1,0,1,Croatia
Gábor Halmai,0,89.0,0,0,3,0,3,Hungary
Gábor P. Szabó,0,128.0,0,1,2,1,3,Bulgaria
Gábor Pölöskei,2,137.0,0,0,1,2,3,Hungary
Gérard Hausser,1,62.0,0,0,1,0,1,France
Gérard Soler,1,69.0,0,0,2,1,3,France
Gérson,1,65.0,0,0,1,0,1,Brazil
Géza Toldi,3,195.0,0,0,1,3,4,Bulgaria
Gökdeniz Karadeniz,1,240.0,0,0,2,3,5,Turkey
Gökhan Gönül,0,78.0,0,0,1,0,1,Turkey
Gökhan Inler,0,256.0,0,3,3,1,4,Switzerland
Gökhan Ünal,0,123.0,0,0,1,1,2,Greece
Gösta Dunker,1,82.0,0,0,0,1,1,Germany
Gösta Sandberg,0,22.0,0,0,1,0,1,Sweden
Gøran Sørloth,0,413.0,0,0,5,3,8,Cyprus
Gündüz Kılıç,0,72.0,0,0,1,0,1,Turkey
Günter Netzer,0,101.0,0,1,1,1,2,Germany
Günther Wirth,0,39.0,0,0,1,1,2,German DR
Güýçmyrat Annagulyýew,1,85.0,0,0,1,0,1,Turkmenistan
Ha Seok-ju,5,570.0,0,0,6,5,11,Lebanon
Habib Bamogo,1,59.0,0,0,0,1,1,Guinea
Habib Beye,1,45.0,0,0,1,0,1,Senegal
Habib Diallo,0,90.0,0,0,0,1,1,Togo
Habib Fardan,0,25.0,0,0,1,0,1,United Arab Emirates
Habib Jafar,1,167.0,0,0,2,1,3,Jordan
Habib Khabiri,0,59.0,0,0,0,1,1,Kuwait
Habib Shareefi,0,84.0,0,0,1,0,1,Iran
Hacène Lalmas,3,110.0,0,0,3,0,3,Algeria
Hadi Aghily,0,88.0,0,0,1,1,2,Qatar
Hadi Ahmed,1,26.0,0,0,1,0,1,Iraq
Hadi Ismanto,0,75.0,0,0,1,0,1,Indonesia
Hady Khashaba,0,100.0,0,2,1,1,2,Namibia
Hafiz Nor,1,52.0,0,0,0,1,1,Yemen
Haidar Abdullah,0,56.0,0,0,0,1,1,Kazakhstan
Haidar Mahmoud,3,169.0,0,0,3,1,4,Iraq
Haidar Najim,0,36.0,0,0,1,0,1,Iraq
Haidar Obeid,2,115.0,0,0,1,1,2,Macau
Haim Bar,0,57.0,0,0,1,0,1,Israel
Haim Revivo,1,376.0,0,0,5,5,10,Poland
Hairuddin Omar,2,139.0,0,0,1,1,2,Hong Kong
Haitham Al-Shboul,0,83.0,0,0,0,1,1,Iran
Haitham Elrasheed,0,30.0,0,0,1,0,1,Sudan
Haitham Thabit,0,80.0,0,0,1,0,1,Yemen
Haitham Zein,1,211.0,0,0,4,1,5,Lebanon
Haji Wright,1,76.0,0,0,0,1,1,Netherlands
Hajime Hosogai,1,97.0,0,0,1,0,1,Japan
Hakan Balta,0,79.0,0,0,1,0,1,Turkey
Hakan Yakin,0,385.0,0,1,7,2,9,Switzerland
Hakan Çalhanoğlu,0,404.0,0,1,3,4,7,Czech Republic
Hakan Şükür,4,1892.0,0,2,26,13,39,Turkey
Hakim Abdallah,0,74.0,0,0,1,0,1,Madagascar
Hakim Braham,0,24.0,0,0,1,0,1,Tunisia
Hakim Ziyech,1,83.0,0,1,2,1,3,Morocco
Hakob Ter-Petrosyan,0,90.0,0,0,0,1,1,Albania
Hal Robson-Kanu,2,313.0,0,0,3,2,5,Scotland
Halil Altıntop,0,239.0,0,0,2,2,4,Kazakhstan
Halil Dervişoğlu,0,133.0,0,0,2,1,3,Gibraltar
Hallgrímur Jónasson,0,116.0,0,0,0,2,2,Portugal
Hallur Hansson,0,73.0,0,0,2,0,2,Faroe Islands
Hallvar Thoresen,0,258.0,0,2,3,2,5,Norway
Hamad Al Harbi,0,87.0,0,0,0,1,1,Malaysia
Hamad Al-Montashari,1,147.0,0,0,2,0,2,Saudi Arabia
Hamad Khalid Bo Hamad,2,214.0,0,0,0,4,4,North Korea
Hamada Sedki,0,9.0,1,0,1,0,1,Zimbabwe
Hamdan Abdulla Al-Moamari,0,57.0,0,0,0,1,1,Syria
Hamdan Al-Kamali,0,85.0,1,1,2,0,2,United Arab Emirates
Hamdi Al Masri,0,17.0,1,0,1,0,1,Japan
Hamdi Salihi,0,334.0,0,1,4,2,6,Sweden
Hamdou Elhouni,1,36.0,0,0,1,0,1,Libya
Hamed Al-Saleh,3,286.0,0,0,1,4,5,Macau
Hamed Snousi,1,90.0,0,0,1,0,1,Libya
Hameed Darwish,0,84.0,0,0,1,0,1,Bahrain
Hameur Bouazza,1,92.0,0,0,0,1,1,Ivory Coast
Hami Mandıralı,0,168.0,0,0,1,1,2,Turkey
Hamid Alidousti,3,89.0,0,0,2,1,3,China PR
Hamid Derakhshan,2,59.0,0,0,0,3,3,Oman
Hamid Estili,5,425.0,0,0,1,7,8,Iran
Hamid Ismail,0,90.0,0,0,0,1,1,United Arab Emirates
Hamilton Cuvi,1,126.0,0,0,0,2,2,Uruguay
Hamilton Ricard,2,196.0,0,0,1,3,4,Uruguay
Haminu Draman,1,106.0,0,0,2,0,2,Ghana
Hamit Altıntop,2,236.0,0,0,3,1,4,Turkey
Hamlet Mkhitaryan,0,66.0,0,0,1,0,1,Armenia
Hammadi Ahmed,1,86.0,0,0,1,0,1,Iraq
Hamoud Al-Shemmari,1,84.0,0,0,1,0,1,Kuwait
Hamza Abourazzouk,0,89.0,0,0,1,0,1,Morocco
Hamza Al-Dardour,4,604.0,0,0,7,4,11,Palestine
Hamza El-Gamal,1,22.0,0,0,1,0,1,Egypt
Hamza Mathlouthi,1,4.0,0,0,1,0,1,Tunisia
Hamza Yacef,0,48.0,0,0,1,0,1,Algeria
Hamzah Idris,1,64.0,0,0,1,0,1,Saudi Arabia
Hamzah Idris Falatah,0,118.0,0,0,3,0,3,Saudi Arabia
Han Bong-Zin,2,153.0,0,0,2,0,2,North Korea
Han Hyong-Il,0,148.0,0,0,3,0,3,North Korea
Han Kwang-song,0,90.0,0,0,0,1,1,Turkmenistan
Han Peng,0,70.0,0,0,0,2,2,Malaysia
Hani Al Saqer,1,102.0,0,0,0,2,2,Indonesia
Hani Al-Dhabit,0,463.0,0,2,9,2,11,Oman
Hannes Löhr,0,165.0,0,0,3,0,3,Germany
Hannes Reinmayr,0,96.0,0,0,1,2,3,Israel
Hannu Tihinen,0,185.0,0,0,3,1,4,Finland
Hannu Turunen,0,41.0,0,0,0,1,1,Germany
Hans Buzek,0,127.0,0,0,1,1,2,Austria
Hans Cieslarczyk,1,18.0,0,0,0,1,1,France
Hans Fróði Hansen,0,86.0,0,0,1,0,1,Faroe Islands
Hans Gillhaus,0,157.0,0,0,0,2,2,Greece
Hans Holmqvist,0,68.0,0,0,0,1,1,Albania
Hans Krankl,5,938.0,0,2,14,5,19,Malta
Hans Maldonado,0,133.0,0,1,1,1,2,Argentina
Hans Nordahl,0,26.0,0,0,0,1,1,Germany
Hans Persson,0,23.0,0,0,0,1,1,Finland
Hans Pirkner,0,106.0,0,1,2,0,2,Austria
Hans Richter,0,45.0,0,0,1,0,1,German DR
Hans Schäfer,6,388.0,0,0,3,5,8,Saarland
Hans Vanaken,0,128.0,0,0,2,1,3,Belgium
Hans-Jörg Pfister,0,148.0,0,0,0,2,2,German DR
Hans-Jürgen Kreische,0,454.0,0,0,3,6,9,German DR
Hans-Jürgen Riediger,0,29.0,0,0,1,0,1,German DR
Hans-Peter Briegel,0,26.0,0,0,0,1,1,Finland
Hans-Peter Friedländer,0,59.0,0,0,0,1,1,Luxembourg
Hans-Peter Schild,0,18.0,0,0,0,1,1,Turkey
Hans-Peter Zwicker,0,2.0,0,0,0,1,1,Malta
Hansi Müller,1,30.0,0,0,1,0,1,Germany
Hany Ramzy,1,169.0,0,0,1,1,2,Togo
Hao Haidong,2,709.0,0,0,9,7,16,China PR
Hao Junmin,1,473.0,0,1,5,2,7,China PR
Harald Berg,0,183.0,0,0,2,1,3,Luxembourg
Harald Brattbakk,0,24.0,0,0,1,0,1,Norway
Harald Cerny,0,186.0,0,0,1,2,3,Cyprus
Harald Hennum,0,98.0,0,0,3,0,3,Norway
Harald Sunde,0,119.0,0,0,1,1,2,Norway
Haraldur Ingólfsson,0,61.0,0,0,1,0,1,Iceland
Hardy Binguila,0,81.0,0,0,0,1,1,Ethiopia
Hared Robleh,0,29.0,0,0,0,1,1,DR Congo
Hari Khadka,3,134.0,0,1,2,1,3,Nepal
Harib Al-Maazmi,0,54.0,0,0,1,0,1,United Arab Emirates
Haris Medunjanin,0,363.0,0,0,4,4,8,Bosnia and Herzegovina
Haris Mohammed,0,81.0,0,0,0,1,1,United Arab Emirates
Haris Seferovic,4,587.0,0,0,7,7,14,Switzerland
Haris Škoro,0,83.0,0,0,1,0,1,Yugoslavia
Harold Amaru,3,214.0,0,0,2,1,3,Tahiti
Harold Hassall,0,70.0,0,0,2,0,2,England
Harold Legodi,0,86.0,0,0,0,1,1,Congo
Harold Lozano,1,90.0,0,0,0,1,1,Switzerland
Harold Ng Fok,1,90.0,0,0,0,1,1,Fiji
Harold Wallace,1,54.0,0,0,1,0,1,Costa Rica
Haroldo Domingues,2,164.0,0,0,3,0,3,Brazil
Haron Shakava,0,49.0,0,0,0,1,1,Mauritius
Harouna Traoré,0,76.0,0,0,1,0,1,Burkina Faso
Harris Tchilimbou,0,69.0,0,0,0,1,1,São Tomé and Príncipe
Harrison Róchez,2,125.0,0,0,2,2,4,Belize
Harry Andersson,3,179.0,0,0,0,3,3,Cuba
Harry Bild,0,72.0,0,0,1,0,1,Sweden
Harry Duggan,1,88.0,0,0,1,0,1,Republic of Ireland
Harry Elyse Randrianaivo,0,102.0,0,0,2,0,2,Madagascar
Harry Hestad,0,160.0,0,0,2,0,2,Norway
Harry Kane,10,2228.0,0,13,23,21,44,England
Harry Keough,0,35.0,0,1,0,1,1,Canada
Harry Kewell,5,735.0,0,1,6,7,13,Iran
Harry Lubse,0,48.0,0,0,1,0,1,Netherlands
Harry Maguire,2,245.0,0,0,2,4,6,Sweden
Harry Milanzi,0,193.0,0,0,3,2,5,Zambia
Harry Panayiotou,0,148.0,0,1,0,3,3,Turks and Caicos Islands
Harry Randrianaivo,0,185.0,0,0,3,0,3,Madagascar
Harry Souttar,2,333.0,0,0,4,2,6,Australia
Harry Waya,1,91.0,0,1,2,0,2,Malawi
Harry Wilson,0,45.0,0,0,0,2,2,Azerbaijan
Harry Winks,0,32.0,0,0,0,1,1,Kosovo
Harry Zech,0,53.0,0,0,0,1,1,Lithuania
Hartmut Schade,0,68.0,0,0,1,1,2,German DR
Haruhisa Hasegawa,1,88.0,0,0,1,0,1,Japan
Harun Jusoh,1,89.0,0,0,0,1,1,Thailand
Haruna Ilerika,2,97.0,0,0,0,2,2,Egypt
Harutyun Vardanyan,0,56.0,0,0,1,0,1,Armenia
Hasabu El Sagheir,0,9.0,0,0,0,1,1,Ethiopia
Hasan Ali Kaldırım,0,24.0,0,0,1,0,1,Turkey
Hasan Salihamidžić,1,135.0,0,0,1,3,4,Bosnia and Herzegovina
Hasan Şaş,2,51.0,0,0,1,1,2,Brazil
Hasan Şengün,0,124.0,0,0,0,2,2,Northern Ireland
Hashim Saleh,0,29.0,0,0,0,1,1,Nepal
Hashim Sayed Isa,0,124.0,0,1,2,0,2,Bahrain
Hassan Abbas,1,85.0,1,0,1,0,1,Japan
Hassan Abdel-Fattah,1,987.0,0,2,10,7,17,South Korea
Hassan Akesbi,0,14.0,0,0,0,1,1,Senegal
Hassan Al-Haydos,2,674.0,0,4,10,4,14,Qatar
Hassan Amcharrat,2,87.0,0,0,1,2,3,Ivory Coast
Hassan Ayoub,1,41.0,0,0,0,1,1,India
Hassan Bashir,2,84.0,0,2,1,1,2,Yemen
Hassan Chaito,0,126.0,0,0,2,0,2,Lebanon
Hassan El-Shazly,10,412.0,0,1,11,1,12,Egypt
Hassan Fallatah,0,34.0,0,0,0,1,1,Hong Kong
Hassan Korongo,0,45.0,0,1,1,0,1,Sudan
Hassan Maatouk,2,356.0,0,3,6,3,9,Lebanon
Hassan Mili,0,46.0,0,0,1,0,1,Rwanda
Hassan Mohamed,0,35.0,0,0,0,1,1,Qatar
Hassan Mostafa,0,80.0,0,0,0,1,1,Benin
Hassan Mubarak,1,42.0,0,0,1,1,2,Japan
Hassan Mubiru,0,94.0,0,0,2,0,2,Uganda
Hassan Mudhafar,0,21.0,0,1,1,0,1,Oman
Hassan Myuter Saied Al Suwaidi,0,62.0,0,0,1,0,1,Qatar
Hassan Nader,1,114.0,0,0,2,0,2,Morocco
Hassan Rowshan,2,491.0,0,0,5,3,8,Iran
Hassan Saeed Ahmed,0,137.0,0,0,3,0,3,United Arab Emirates
Hassan Shehata,1,156.0,0,0,3,1,4,Egypt
Hassane Bandé,1,39.0,0,0,0,1,1,Cape Verde
Hasse Borg,0,119.0,0,3,3,0,3,Sweden
Hasse Jeppson,2,130.0,0,0,1,2,3,Sweden
Hassen Gabsi,1,245.0,0,0,1,2,3,Tunisia
Hassouneh Al-Sheikh,1,33.0,0,0,1,0,1,Jordan
Hatem Aqel,0,91.0,0,1,2,0,2,Jordan
Hatem Ben Arfa,0,90.0,0,0,0,1,1,Faroe Islands
Hattan Bahebri,2,51.0,0,0,1,1,2,Saudi Arabia
Hawar Mulla Mohammed,4,155.0,0,2,4,1,5,Turkmenistan
Hayao Kawabe,0,71.0,0,0,1,0,1,Japan
Hayden Foxe,0,125.0,0,0,2,0,2,Australia
Hayden Tinto,0,45.0,0,0,0,1,1,Mexico
Hayk Hakobyan,0,72.0,0,0,1,0,1,Armenia
Haykel Guemamdia,1,79.0,0,1,2,2,4,Tunisia
Haytham Tambal,1,400.0,0,0,5,2,7,Sudan
Hazem Emam,2,153.0,0,0,3,0,3,Egypt
He Jia,1,61.0,0,0,1,0,1,China PR
Heath Dickinson,1,18.0,1,0,1,0,1,Fiji
Hector Sam,0,84.0,0,0,1,0,1,Trinidad and Tobago
Hector Wright,1,248.0,0,1,4,2,6,Jamaica
Hedgardo Marín,1,8.0,0,0,1,0,1,Mexico
Heiko Herrlich,0,42.0,0,0,1,0,1,Germany
Heiko Westermann,0,114.0,0,0,1,1,2,Liechtenstein
Heimana Paama,1,13.0,1,0,1,0,1,New Zealand
Heimano Bourebare,1,25.0,0,0,1,0,1,Tahiti
Heimo Pfeifenberger,0,199.0,0,0,5,1,6,Austria
Heiner Mora,1,47.0,0,0,1,0,1,Costa Rica
Heini Vatnsdal,0,72.0,0,0,1,0,1,Faroe Islands
Heinrich Isaacks,0,17.0,0,0,1,0,1,Namibia
Heinrich Schmidtgal,0,46.0,0,0,0,1,1,Germany
Heinrich Uukkivi,0,3.0,0,0,0,1,1,Sweden
Heinz Flohe,2,197.0,0,0,2,1,3,Yugoslavia
Heinz Hermann,0,211.0,0,0,2,2,4,Iceland
Heinz Lüdi,0,2.0,1,0,1,0,1,Belgium
Heinz Schneiter,2,179.0,0,0,1,2,3,Belgium
Heinz Strehl,0,69.0,0,0,1,0,1,Germany
Heitor,0,22.0,0,0,1,0,1,Brazil
Heiðar Helguson,0,144.0,0,0,3,1,4,Iceland
Heleno de Freitas,8,289.0,0,0,6,3,9,Brazil
Helgi Sigurðsson,0,142.0,0,0,2,1,3,Iceland
Helman Mkhalele,3,171.0,0,1,3,1,4,South Africa
Helmut Bicek,0,90.0,0,1,2,0,2,United States
Helmut Haller,5,352.0,0,1,7,2,9,Greece
Helmut Köglberger,0,106.0,0,0,0,2,2,Malta
Helmut Müller,0,35.0,0,0,1,0,1,German DR
Helmut Rahn,10,618.0,0,0,7,4,11,Germany
Helmut Redl,0,147.0,0,0,3,1,4,Austria
Helmut Schön,0,111.0,0,0,2,0,2,Germany
Helmut Senekowitsch,0,66.0,0,0,0,1,1,Luxembourg
Helmut Siber,0,175.0,0,0,2,1,3,Russia
Hendrik Isemborghs,0,91.0,0,0,1,1,2,Belgium
Hendrik Somaeb,0,64.0,0,0,1,0,1,Namibia
Hendry Thomas,0,90.0,0,0,1,0,1,Honduras
Henk Groot,0,195.0,0,0,1,2,3,German DR
Henk Wery,0,20.0,0,0,0,1,1,Poland
Henk van Spaandonck,0,37.0,0,0,0,1,1,Belgium
Hennadiy Lytovchenko,2,327.0,0,0,3,3,6,Norway
Hennadiy Zubov,0,95.0,0,0,2,1,3,Ukraine
Hennie van Nee,0,8.0,0,0,0,2,2,Albania
Henning Berg,0,278.0,1,0,4,1,5,Belarus
Henning Enoksen,0,120.0,0,0,2,0,2,Denmark
Henning Frenzel,0,484.0,0,0,5,2,7,German DR
Henning Jarnskor,0,12.0,0,0,1,0,1,Faroe Islands
Henning Jensen,0,83.0,0,0,1,1,2,Denmark
Henning Munk Jensen,0,124.0,0,1,2,0,2,Denmark
Henok Goitom,0,9.0,0,0,0,1,1,Botswana
Henri Anier,1,246.0,0,0,2,3,5,Estonia
Henri Baillot,0,63.0,0,0,1,1,2,Yugoslavia
Henri Camara,7,859.0,0,0,7,9,16,Burkina Faso
Henri Coppens,1,289.0,0,1,4,3,7,Finland
Henri Klein,0,74.0,0,0,2,0,2,Luxembourg
Henri Konan,1,90.0,0,1,0,1,1,Ghana
Henri Mbazumutima,0,72.0,0,0,0,2,2,Tunisia
Henri Saivet,1,13.0,0,0,1,0,1,Senegal
Henrico Botes,0,75.0,0,0,1,0,1,Namibia
Henrik Andersen,0,85.0,0,0,1,0,1,Denmark
Henrik Dalsgaard,0,90.0,0,0,0,1,1,Switzerland
Henrik Larsen,3,97.0,0,0,0,4,4,France
Henrik Larsson,9,1558.0,0,6,19,8,27,Sweden
Henrikh Mkhitaryan,0,986.0,0,4,10,8,18,Armenia
Henrique Tembe,0,44.0,0,0,0,1,1,Senegal
Henry Fa'arodo,1,482.0,0,4,6,5,11,New Zealand
Henry Koto,1,88.0,0,0,1,0,1,Solomon Islands
Henry Martín,1,218.0,0,0,1,2,3,Mexico
Henry McKop,0,62.0,0,0,0,1,1,Togo
Henry Morris,0,160.0,0,0,0,3,3,Northern Ireland
Henry Motego,0,73.0,0,1,2,0,2,Kenya
Henry Nwosu,1,103.0,0,0,1,1,2,Nigeria
Henryk Bałuszyński,0,4.0,0,0,1,0,1,Poland
Henryk Kasperczak,0,12.0,0,0,1,0,1,Poland
Henryk Martyna,0,52.0,0,0,1,0,1,Poland
Henryk Wieczorek,0,77.0,0,0,1,0,1,Poland
Herbert Binkert,0,16.0,0,0,0,1,1,Norway
Herbert Hermann,0,27.0,0,0,1,0,1,Switzerland
Herbert Marquez,0,58.0,0,0,1,0,1,Venezuela
Herbert Martin,0,68.0,0,1,1,0,1,Saarland
Herbert Pankau,0,132.0,0,0,2,0,2,German DR
Herbert Prohaska,0,345.0,0,2,5,2,7,Austria
Herbert Sandin,0,56.0,0,0,1,0,1,Sweden
Herbert Sosa,0,88.0,0,1,1,0,1,El Salvador
Herbert Wimmer,1,135.0,0,0,1,1,2,Germany
Herbert Zimmermann,0,119.0,0,0,1,1,2,Wales
Herculez Gomez,0,127.0,0,0,2,0,2,United States
Herfried Sabitzer,0,80.0,0,0,1,0,1,Austria
Heribert Weber,0,66.0,0,0,1,0,1,Austria
Heriberto Morales,0,11.0,1,0,1,0,1,Jamaica
Herilia Rafanodina,0,57.0,0,0,1,0,1,Madagascar
Herman Soliz,0,27.0,1,0,1,0,1,Ecuador
Hermann Hreiðarsson,0,183.0,0,0,1,4,5,Iceland
Hermenegildo Segrera,0,269.0,0,0,1,3,4,Chile
Herminio Masantonio,8,584.0,0,0,8,3,11,Argentina
Hernando Bolados,0,30.0,0,0,1,0,1,Chile
Hernando Salazar,1,85.0,0,0,0,1,1,Brazil
Hernán Crespo,7,1111.0,0,2,17,9,26,Argentina
Hernán Darío Herrera,0,223.0,0,1,3,2,5,Colombia
Hernán Gaviria,1,101.0,0,0,0,2,2,Switzerland
Hernán Medford,5,688.0,0,1,5,7,12,Sweden
Hernán Rengifo,0,175.0,0,0,1,1,2,Peru
Hernâni Ferreira da Silva,0,30.0,0,0,2,0,2,Portugal
Herry Kiswanto,0,188.0,0,0,2,1,3,Thailand
Herry Risdianto,0,178.0,0,0,2,0,2,Indonesia
Hervé Bazile,1,70.0,0,1,1,0,1,Haiti
Hervé Revelli,0,238.0,0,0,0,5,5,Luxembourg
Hesham Hanafy,0,24.0,0,0,1,0,1,Egypt
Hesham Mohammed,0,369.0,0,0,9,0,9,Iraq
Hesham Shaban,0,81.0,0,0,1,0,1,Libya
Heston Munthali,0,76.0,0,0,1,1,2,Malawi
Hicham Aboucherouane,1,72.0,0,0,1,1,2,Guinea
Hicham Mahdoufi,0,43.0,1,0,1,0,1,Gabon
Hicham Zerouali,2,108.0,0,0,0,2,2,Burkina Faso
Hichem Essifi,0,73.0,0,0,2,0,2,Tunisia
Hideaki Kitajima,1,79.0,0,0,1,0,1,Japan
Hideki Maeda,1,80.0,0,1,1,0,1,Japan
Hidemasa Morita,0,90.0,0,0,2,0,2,Japan
Hidetoshi Nakata,1,320.0,0,0,7,1,8,Japan
Hilaire Kédigui,0,83.0,0,0,2,0,2,Chad
Hilal El-Helwe,2,367.0,0,1,4,2,6,Lebanon
Hillal Soudani,2,291.0,0,0,5,1,6,Algeria
Hillary Makasa,1,90.0,0,0,1,0,1,Zambia
Himson Teleda,0,108.0,0,0,2,0,2,Solomon Islands
Hipólito Rincón,0,382.0,0,0,7,0,7,Spain
Hiro Labaste,0,55.0,0,0,0,1,1,Australia
Hiroaki Morishima,4,329.0,0,0,3,3,6,Macau
Hiromi Hara,0,200.0,0,0,3,1,4,Japan
Hiroshi Kiyotake,0,123.0,0,1,2,1,3,Oman
Hiroshi Nanami,5,228.0,0,0,4,3,7,Japan
Hirving Lozano,1,407.0,0,0,4,3,7,Canada
Hisashi Kato,0,84.0,0,0,0,1,1,Singapore
Hisashi Kurosaki,0,69.0,0,0,1,0,1,Japan
Hisham Abdul-Munam,0,90.0,0,0,1,0,1,Jordan
Hla Htay,1,64.0,0,0,1,1,2,Myanmar
Hlaing Bo Bo,1,86.0,0,0,2,0,2,Myanmar
Hlynur Birgisson,0,70.0,1,0,1,0,1,Luxembourg
Hocine Achiou,2,159.0,0,0,2,0,2,Algeria
Hocine Benmiloudi,1,62.0,0,0,1,0,1,Algeria
Hocine Yahi,1,168.0,0,0,2,0,2,Algeria
Hok Sochetra,0,77.0,0,0,2,0,2,Cambodia
Holger Badstuber,0,86.0,0,0,1,0,1,Germany
Hollies Vato,1,143.0,0,0,1,1,2,Solomon Islands
Homam Ahmed,1,25.0,0,0,0,1,1,Honduras
Homayoun Behzadi,0,249.0,0,0,4,0,4,Iran
Homos,1,39.0,0,0,1,0,1,Egypt
Hong Jeong-ho,0,4.0,0,0,1,0,1,South Korea
Hong Myung-bo,4,234.0,0,2,0,4,4,India
Hong Sung-Ho,1,33.0,0,0,1,0,1,South Korea
Hong Yong-jo,1,495.0,0,1,5,3,8,Yemen
Honorato Gonzabay,2,117.0,2,0,0,2,2,Ecuador
Horacio Casarín,1,286.0,0,0,5,0,5,Mexico
Horst Hrubesch,3,108.0,0,0,1,2,3,Belgium
Horst Kohle,0,72.0,0,0,0,1,1,Portugal
Horst Köppel,0,73.0,0,0,0,1,1,Turkey
Horst Nemec,0,120.0,0,0,3,0,3,Austria
Horst Schade,0,70.0,0,0,1,0,1,Germany
Horst Siegl,1,330.0,0,0,5,0,5,Czech Republic
Horst Szymaniak,0,78.0,0,1,0,2,2,Chile
Horst-Dieter Höttges,0,51.0,0,0,1,0,1,Germany
Hosny Abd Rabo,5,440.0,0,6,6,3,9,Egypt
Hossam Ghaly,0,38.0,0,0,1,0,1,Egypt
Hossam Hassan,8,1101.0,0,2,11,9,20,Egypt
Hossein Faraki,2,232.0,0,0,2,1,3,Kuwait
Hossein Kalani,5,372.0,0,0,7,0,7,Iran
Hossein Kanaanizadegan,0,18.0,0,0,1,0,1,Iran
Hossein Kazerani,0,41.0,0,0,1,1,2,Hong Kong
Hossein Zamani,1,81.0,0,0,0,1,1,India
Hotaru Yamaguchi,0,90.0,0,0,1,0,1,Japan
Houmane Jarir,2,236.0,0,0,2,2,4,Tunisia
Housain Al-Mogahwi,1,67.0,0,0,0,1,1,Lebanon
Houssam Wadi,0,12.0,0,0,1,0,1,Palestine
Houssine Kharja,1,555.0,0,2,4,4,8,Morocco
Hovhannes Goharyan,0,23.0,0,0,1,0,1,Armenia
Hovhannes Hambardzumyan,0,116.0,0,0,2,0,2,Armenia
Hrayr Mkoyan,0,120.0,1,0,2,0,2,Armenia
Hristo Bonev,2,952.0,0,6,10,9,19,Bulgaria
Hristo Iliev,0,345.0,0,0,4,2,6,Bulgaria
Hristo Kolev,0,169.0,0,0,2,1,3,Luxembourg
Hristo Stoichkov,9,1244.0,0,13,17,11,28,Bulgaria
Hristo Yanev,0,109.0,0,0,1,1,2,Iceland
Hsu Te Ming,1,90.0,0,0,1,0,1,Taiwan
Huang Bowen,0,57.0,0,0,1,0,1,China PR
Huang Che-ming,1,62.0,0,0,0,1,1,Bangladesh
Huang Wei-yi,1,203.0,0,0,1,2,3,Iraq
Huang Xiangdong,5,341.0,0,0,2,3,5,North Korea
Hubert Hien,1,50.0,0,0,0,1,1,Nigeria
Hubert Robson,0,74.0,0,0,0,1,1,Comoros
Hubert Sambo,1,21.0,0,0,1,0,1,Curaçao
Hubert Suda,0,66.0,0,1,2,0,2,Malta
Hughton Hector,0,90.0,0,0,1,0,1,Trinidad and Tobago
Hugo Almeida,1,402.0,0,0,3,5,8,Azerbaijan
Hugo Brizuela,0,166.0,0,0,2,1,3,Chile
Hugo Coscia,0,29.0,0,0,0,1,1,Brazil
Hugo Eduardo Rubio,0,99.0,0,0,6,0,6,Chile
Hugo Galeano,0,30.0,1,0,1,0,1,Paraguay
Hugo González,0,56.0,1,0,0,1,1,Chile
Hugo Hovenkamp,1,49.0,0,0,1,1,2,Netherlands
Hugo Kiesse,0,103.0,0,0,0,2,2,Ecuador
Hugo Morales,0,86.0,0,0,0,1,1,Venezuela
Hugo Pérez,0,49.0,0,1,1,0,1,United States
Hugo Rodallega,0,88.0,0,0,0,2,2,Peru
Hugo Sotil,1,179.0,0,0,3,1,4,Peru
Hugo Sánchez,0,174.0,0,1,2,2,4,Mexico
Hugo Talavera,0,57.0,0,0,1,1,2,Ecuador
Hugo Viana,0,86.0,0,0,1,0,1,Portugal
Hugues Guillaume,0,113.0,0,0,2,0,2,Haiti
Huh Jung-Moo,1,294.0,0,0,5,1,6,South Korea
Humam Tariq,1,60.0,0,0,1,0,1,Iraq
Humberto Coelho,0,112.0,0,0,3,0,3,Portugal
Humberto Francisco Scovino,0,46.0,0,0,1,0,1,Venezuela
Humberto Maschio,9,471.0,0,2,9,0,9,Argentina
Humberto Moreno,0,47.0,0,0,1,0,1,Chile
Humberto Recanatini,2,80.0,0,2,2,0,2,Argentina
Humberto Scovino,1,59.0,0,0,0,1,1,Bolivia
Humberto Suazo,4,779.0,0,4,6,9,15,Ecuador
Humberto Álvarez,1,19.0,0,1,1,0,1,Colombia
Humphrey Edobor,1,35.0,0,0,2,1,3,Nigeria
Hung Kai-chun,0,65.0,0,0,0,1,1,Thailand
Husain Ali,1,475.0,0,0,4,5,9,Thailand
Hussain Al-Hadhri,0,8.0,0,0,1,0,1,Oman
Hussain Al-Musawi,0,90.0,0,0,1,0,1,Kuwait
Hussain Ali Baba,1,31.0,0,1,0,1,1,Yemen
Hussain Fadhel,0,62.0,0,0,1,1,2,Kuwait
Hussain Seraj,0,12.0,0,0,1,0,1,Kuwait
Hussam Fawzi,2,263.0,0,0,3,3,6,Iran
Hussein Abdulghani,0,102.0,0,0,2,1,3,Saudi Arabia
Hussein Ahmad Satter,2,81.0,0,0,2,0,2,Singapore
Hussein Ali Al-Saedi,1,53.0,0,0,1,0,1,Iraq
Hussein Hamdan,0,90.0,0,0,1,0,1,Lebanon
Hussein Saeed,2,452.0,0,0,3,4,7,Qatar
Hussein Yassin,0,84.0,0,0,1,0,1,Djibouti
Hutson Charles,0,146.0,0,0,1,1,2,Barbados
Huub Stevens,0,65.0,0,0,1,0,1,Netherlands
Huỳnh Quang Thanh,0,152.0,0,0,1,2,3,Vietnam
Hwang Hee-chan,2,312.0,0,1,5,1,6,Qatar
Hwang In-beom,0,47.0,0,0,1,0,1,South Korea
Hwang Jae-won,1,120.0,0,0,0,1,1,Japan
Hwang Sang-hoi,2,158.0,0,0,1,1,2,North Korea
Hwang Seok-keun,0,47.0,0,0,0,1,1,Kuwait
Hwang Sun-hong,9,632.0,0,0,13,4,17,South Korea
Hwang Ui-jo,2,162.0,0,1,4,0,4,South Korea
Hwangbo Kwan,4,236.0,0,0,2,3,5,Malaysia
Hysen Zmijani,0,173.0,1,0,2,1,3,France
Hà Vương Ngầu Nại,1,61.0,0,0,1,0,1,Vietnam
Håkan Mild,1,97.0,0,0,1,1,2,Austria
Håkan Sandberg,0,31.0,0,0,1,0,1,Sweden
Håvard Flo,1,46.0,0,0,0,1,1,Scotland
Håvard Nielsen,0,72.0,0,0,1,0,1,Norway
Håvard Nordtveit,0,111.0,1,0,0,2,2,Azerbaijan
Héctor Altamirano,2,140.0,0,2,3,1,4,Mexico
Héctor Bailetti,1,40.0,0,0,0,1,1,Chile
Héctor Castro,7,643.0,0,0,2,10,12,Chile
Héctor Chumpitaz,1,135.0,1,0,1,1,2,Bolivia
Héctor De Bourgoing,1,15.0,0,1,1,0,1,France
Héctor Demarco,2,89.0,0,0,0,3,3,Peru
Héctor Facundo,1,4.0,0,0,1,0,1,Argentina
Héctor González,1,250.0,0,0,2,2,4,Peru
Héctor Hernández,1,305.0,0,1,1,3,4,Mexico
Héctor Herrera,2,402.0,0,0,4,1,5,Mexico
Héctor Hurtado,1,79.0,0,0,1,0,1,Colombia
Héctor Magliano,4,189.0,0,0,0,4,4,Chile
Héctor Marchena,0,59.0,1,0,1,0,1,United States
Héctor Moreno,1,316.0,1,0,0,5,5,Mexico
Héctor Ortiz,1,103.0,0,1,2,0,2,Mexico
Héctor Puebla,0,21.0,0,0,1,0,1,Chile
Héctor Ramos,0,158.0,0,0,4,0,4,Puerto Rico
Héctor Scarone,9,552.0,0,0,4,10,14,Uruguay
Héctor Silva,0,216.0,0,0,4,1,5,Uruguay
Héctor Socorro,3,264.0,0,0,3,2,5,Haiti
Héctor Tapia,0,70.0,0,0,0,1,1,Venezuela
Héctor Yazalde,2,83.0,0,0,2,0,2,Argentina
Héctor Zelaya,0,8.0,0,0,0,1,1,Spain
Hédi Berkhissa,1,41.0,0,0,2,0,2,Tunisia
Hélder,0,74.0,0,0,1,0,1,Portugal
Hélder Costa,0,25.0,0,0,1,0,1,Angola
Hélder Cristóvão,0,75.0,0,0,0,1,1,Albania
Hélder Pelembe,0,54.0,0,0,1,0,1,Mozambique
Hélder Postiga,2,1206.0,0,0,12,6,18,Portugal
Hélder Vicente,0,18.0,0,0,1,0,1,Angola
Hélder Vicente de Jesus Serafin,1,90.0,1,0,0,1,1,Angola
Héldon Ramos,2,278.0,0,1,4,1,5,Cape Verde
Hérita Ilunga,0,44.0,0,0,0,1,1,Egypt
Hörður Björgvin Magnússon,0,163.0,0,0,1,1,2,Hungary
Hồ Tấn Tài,1,89.0,0,0,1,1,2,China PR
I Kadek Agung Widnyana,1,39.0,0,0,0,1,1,Thailand
I. M. Vijayan,2,157.0,0,0,1,3,4,Hong Kong
Iago Aspas,1,204.0,0,0,1,2,3,Liechtenstein
Iain Dowie,0,388.0,0,3,7,4,11,Northern Ireland
Iain Hume,0,353.0,0,0,0,5,5,United States
Iain Ramsay,1,216.0,0,0,1,2,3,Yemen
Iamel Kabeu,0,30.0,0,0,1,0,1,New Caledonia
Ian Azzopardi,0,82.0,1,0,0,1,1,Malta
Ian Edwards,0,164.0,0,0,4,0,4,Wales
Ian Evans,0,53.0,1,0,2,0,2,Wales
Ian Gaynair,0,40.0,0,0,0,1,1,United States
Ian Goodison,0,206.0,0,0,3,0,3,Jamaica
Ian Gray,0,149.0,0,0,2,0,2,Australia
Ian Harte,1,198.0,0,3,3,4,7,Liechtenstein
Ian Hunter,3,450.0,0,0,3,2,5,New Caledonia
Ian Lake,0,488.0,0,0,6,4,10,United States Virgin Islands
Ian Rush,0,871.0,0,0,13,5,18,Wales
Ian St. John,2,129.0,0,0,1,2,3,Scotland
Ian Stewart,0,72.0,0,0,2,0,2,Northern Ireland
Ian Walsh,0,199.0,0,0,1,2,3,Iceland
Ian Wright,4,468.0,0,0,2,5,7,Poland
Ianis Hagi,0,95.0,0,0,1,1,2,Romania
Ianis Zicu,0,78.0,0,0,1,0,1,Romania
Iau Tuan Naukoot,1,37.0,0,0,0,1,1,Solomon Islands
Iban Iyanga,0,169.0,0,0,2,1,3,Equatorial Guinea
Iban Salvador,0,144.0,0,1,2,0,2,Equatorial Guinea
Ibrahim Afellay,0,223.0,0,0,3,1,4,Netherlands
Ibrahim Al Duraihem,3,186.0,0,1,0,3,3,South Korea
Ibrahim Al Farhan,0,73.0,0,1,0,1,1,Qatar
Ibrahim Al-Harbi,0,73.0,0,0,1,0,1,Saudi Arabia
Ibrahim Al-Hardan,0,65.0,0,0,1,1,2,Yemen DPR
Ibrahim Al-Maadani,0,61.0,0,0,1,0,1,Libya
Ibrahim Al-Rumaihi,1,52.0,1,0,1,0,1,Kuwait
Ibrahim Al-Shahrani,3,256.0,0,0,1,3,4,Taiwan
Ibrahim Amada,1,9.0,0,0,1,0,1,Madagascar
Ibrahim Aoudou,1,60.0,0,1,2,0,2,Cameroon
Ibrahim Bayesh,0,22.0,0,0,0,1,1,Cambodia
Ibrahim Din,2,113.0,0,0,2,0,2,Malaysia
Ibrahim Farhan,0,59.0,0,0,0,2,2,Yemen DPR
Ibrahim Fazeel,0,169.0,0,0,3,0,3,Maldives
Ibrahim Hassan,0,96.0,0,0,2,0,2,Egypt
Ibrahim Kargbo,0,38.0,0,1,1,0,1,Sierra Leone
Ibrahim Kassum,0,57.0,0,0,1,0,1,Ghana
Ibrahim Koroma,0,58.0,0,0,1,0,1,Sierra Leone
Ibrahim Mahudhee,0,27.0,0,0,0,1,1,Guam
Ibrahim Said,0,89.0,0,0,0,1,1,Namibia
Ibrahim Sangaré,2,124.0,0,0,1,1,2,Malawi
Ibrahim Sekagya,0,131.0,0,0,2,0,2,Uganda
Ibrahim Sowed,0,94.0,0,0,2,1,3,Saudi Arabia
Ibrahim Sunday,4,256.0,0,0,3,2,5,Ghana
Ibrahim Suwayed,0,93.0,0,0,0,2,2,Iran
Ibrahim Yahia El-Kawarty,1,90.0,0,0,0,1,1,Nigeria
Ibrahima Bakayoko,2,632.0,0,1,9,4,13,Ivory Coast
Ibrahima Baldé,0,33.0,0,0,1,0,1,Senegal
Ibrahima Diawara,1,82.0,0,0,0,1,1,Algeria
Ibrahima Koné,6,355.0,0,4,4,4,8,Mali
Ibrahima Sonko,0,8.0,0,0,1,0,1,Senegal
Ibrahima Sory Touré,0,66.0,0,1,1,0,1,Guinea
Ibrahima Tallé,0,86.0,0,0,1,0,1,Burkina Faso
Ibrahima Traoré,2,190.0,0,0,1,3,4,Botswana
Ibraime Cassamá,0,45.0,0,0,1,0,1,Guinea-Bissau
Ibroihim Djoudja,0,49.0,0,0,1,0,1,Comoros
Ich Narding,0,96.0,0,0,2,0,2,Thailand
Idan Tal,0,26.0,0,0,1,1,2,Liechtenstein
Idris Abdul Karim,0,87.0,0,0,1,0,1,Malaysia
Idrissa Gueye,2,156.0,0,0,2,1,3,Senegal
Idrissa Sylla,1,43.0,0,0,1,0,1,Guinea
Ifeanyi Onyedika,0,35.0,0,0,1,0,1,Nigeria
Igli Tare,0,345.0,0,0,5,2,7,Germany
Ignace Muwawa,1,19.0,0,0,0,1,1,Congo
Ignacio Ambríz,0,157.0,0,0,4,0,4,Mexico
Ignacio Jáuregui,0,81.0,0,0,0,1,1,Jamaica
Ignacio Prieto,0,204.0,0,1,3,1,4,Chile
Ignatius Lwipa,0,132.0,0,0,0,2,2,Liberia
Igor Armaș,0,141.0,1,0,2,1,3,Finland
Igor Avdeyev,1,217.0,1,0,4,0,4,Kazakhstan
Igor Belanov,4,391.0,0,3,7,1,8,Russia
Igor Bugaiov,0,165.0,0,1,3,2,5,Bosnia and Herzegovina
Igor Chislenko,3,346.0,0,0,4,4,8,Colombia
Igor Demo,0,297.0,0,0,4,0,4,Slovakia
Igor Diveyev,0,28.0,0,0,0,1,1,Slovenia
Igor Dobrovolski,4,285.0,0,3,4,2,6,Russia
Igor Kolyvanov,0,545.0,0,0,4,5,9,Russia
Igor Korneev,0,87.0,0,0,1,0,1,Russia
Igor Mitreski,0,68.0,1,0,0,1,1,North Macedonia
Igor Netto,1,68.0,0,0,1,1,2,Russia
Igor Nikolovski,0,111.0,0,0,0,2,2,Malta
Igor Oprea,0,62.0,0,0,0,3,3,Georgia
Igor Picușceac,0,1.0,0,0,1,0,1,Moldova
Igor Semshov,0,77.0,0,0,1,1,2,Wales
Igor Sergeyev,1,335.0,0,0,3,3,6,Uzbekistan
Igor Shalimov,0,229.0,0,1,1,3,4,Russia
Igor Shitov,0,57.0,1,0,1,0,1,Finland
Igor Shkvyrin,1,201.0,0,0,4,1,5,China PR
Igor Simutenkov,0,90.0,0,0,1,1,2,Cyprus
Igor Tudor,2,231.0,1,0,2,2,4,Croatia
Igor Yanovsky,0,45.0,0,0,1,0,1,Russia
Igor Štimac,0,56.0,0,0,1,0,1,Croatia
Igoris Morinas,0,79.0,0,0,0,2,2,Faroe Islands
Igors Stepanovs,0,90.0,0,0,0,1,1,Georgia
Igors Tarasovs,0,116.0,1,0,2,0,2,Latvia
Ihaab Boussefi,2,89.0,0,0,2,0,2,Libya
Ihar Hurynovich,0,88.0,0,0,0,1,1,Czech Republic
Ihar Stasevich,0,90.0,0,0,0,2,2,Kazakhstan
Ikechi Anya,0,126.0,0,0,0,2,2,North Macedonia
Ikechukwu Uche,0,247.0,0,0,4,1,5,Nigeria
Ikhsan Fandi,1,91.0,0,0,2,1,3,Singapore
Ildar Amirov,0,158.0,1,0,2,0,2,Kyrgyzstan
Ildefons Lima,0,390.0,2,4,5,3,8,Andorra
Ildefonso López,7,386.0,0,0,1,6,7,Paraguay
Ildefonso Sanabria,1,11.0,0,0,0,1,1,Bolivia
Ildemaro Fernández,0,65.0,0,0,1,0,1,Venezuela
Ildo Maneiro,1,23.0,0,0,0,1,1,Israel
Ilham Jaya Kesuma,0,184.0,0,0,4,1,5,Sri Lanka
Ilhomjon Suyunov,0,89.0,0,0,0,1,1,Taiwan
Ilia Gruev,0,68.0,0,0,0,1,1,Russia
Ilia Kovalenko,1,160.0,0,0,1,1,2,Singapore
Ilian Iliev,0,70.0,0,0,0,1,1,Cyprus
Ilias Chair,0,49.0,0,0,1,0,1,Morocco
Ilias Yfantis,0,48.0,0,0,0,1,1,France
Ilie Balaci,0,56.0,0,0,1,0,1,Romania
Ilie Dumitrescu,3,356.0,0,0,7,1,8,Romania
Ilija Najdoski,0,21.0,0,0,1,0,1,Yugoslavia
Ilija Nestorovski,0,343.0,0,1,3,2,5,North Macedonia
Ilija Petković,1,100.0,0,0,3,0,3,Yugoslavia
Ilija Vukotić,0,82.0,0,0,1,0,1,Montenegro
Ilir Kepa,0,67.0,0,0,1,0,1,Albania
Ilir Përnaska,0,144.0,0,0,2,1,3,Albania
Iliyan Mitsanski,0,31.0,0,0,1,1,2,Azerbaijan
Ilja Antonov,0,75.0,0,0,1,0,1,Estonia
Ilya Tsymbalar,1,154.0,0,0,1,2,3,Faroe Islands
Ilčo Naumoski,0,281.0,0,1,4,2,6,Andorra
Im Seung-Hwi,1,58.0,0,0,1,0,1,North Korea
Imad Zatara,1,71.0,0,0,0,1,1,Iraq
Iman Mobali,1,84.0,0,0,0,1,1,Iraq
Imants Bleidelis,0,249.0,0,0,5,1,6,Georgia
Imed Ben Younes,3,142.0,0,0,2,1,3,Ghana
Imed Mhedhebi,0,210.0,0,0,2,2,4,Tunisia
Imowa Malgbanga,0,149.0,0,0,1,1,2,Madagascar
Imran Louza,0,135.0,0,1,2,0,2,Morocco
Imre Boda,0,171.0,0,1,1,2,3,Greece
Imre Garaba,0,44.0,0,0,1,0,1,Hungary
Imre Markos,0,89.0,0,0,0,1,1,Bulgaria
Imre Szabics,0,405.0,0,0,5,2,7,Hungary
Imrich Stacho,0,4.0,0,1,1,0,1,Czechoslovakia
Imthyas Raheem,3,115.0,0,0,0,3,3,Thailand
Imtiaz Ahmed Nakib,1,90.0,0,0,0,1,1,Taiwan
Inder Singh,2,102.0,0,0,1,1,2,India
Indra Putra Mahayuddin,0,74.0,0,0,1,0,1,Malaysia
Indra Sahdan Daud,0,135.0,0,0,2,0,2,Singapore
Indrek Zelinski,0,322.0,0,0,4,2,6,Estonia
Indriði Sigurðsson,0,132.0,0,0,0,2,2,Hungary
Inge Danielsson,0,156.0,0,0,1,2,3,Portugal
Ingemar Erlandsson,0,70.0,0,1,1,0,1,Sweden
Ingemar Teever,0,86.0,0,0,1,1,2,Estonia
Ingi Björn Albertsson,0,33.0,0,0,1,0,1,Iceland
Ingvar Svensson,0,90.0,0,0,1,0,1,Sweden
Iniesta,0,12.0,0,0,0,1,1,Guinea-Bissau
Inoel Navarro,0,77.0,0,0,3,0,3,Dominican Republic
Inyong Lolumbuman,0,73.0,0,0,0,1,1,North Korea
Ioan Andone,0,25.0,0,0,1,0,1,Romania
Ioan Lupescu,0,131.0,0,0,4,0,4,Romania
Ioan Sabău,0,124.0,0,0,3,0,3,Romania
Ioannis Amanatidis,0,140.0,0,0,1,1,2,Turkey
Ioannis Fetfatzidis,0,72.0,0,0,2,0,2,Greece
Ioannis Kousoulos,0,188.0,0,0,1,3,4,Cyprus
Ioannis Okkas,0,895.0,0,0,11,6,17,Bulgaria
Ioannis Pittas,0,42.0,0,0,1,0,1,Cyprus
Ion Dumitru,0,18.0,0,0,1,1,2,Albania
Ion Geolgău,0,148.0,0,0,0,2,2,Czechoslovakia
Ion Ionescu,0,133.0,0,0,2,0,2,Romania
Ion Nicolaescu,0,159.0,0,0,1,2,3,Moldova
Ion Nunweiller,0,81.0,1,0,1,0,1,Spain
Ion Pârcălab,0,1.0,0,0,1,0,1,Romania
Ion Testemițanu,0,61.0,0,1,1,1,2,Moldova
Ion Vlădoiu,0,50.0,0,0,1,0,1,Romania
Ionel Augustin,0,30.0,0,0,0,1,1,Cyprus
Ionel Ganea,1,573.0,0,1,4,5,9,Romania
Ionuţ Mazilu,0,87.0,0,0,1,0,1,Romania
Iosif Petschovsky,0,51.0,0,1,1,0,1,Romania
Iosif Vigu,0,2.0,0,0,1,0,1,Romania
Ipojucan Lins de Araújo,1,87.0,0,0,1,0,1,Brazil
Iraj Danaeifard,2,117.0,0,0,2,0,2,Iran
Ireneo Hermosilla,0,70.0,0,0,1,0,1,Paraguay
Ireneusz Jeleń,0,78.0,0,0,1,1,2,Northern Ireland
Irfan Bachdim,0,84.0,0,0,1,0,1,Indonesia
Irfan Fandi,1,88.0,1,0,1,0,1,Uzbekistan
Irvin Herrera,0,41.0,0,0,0,1,1,Saint Kitts and Nevis
Irwan Fadzli Idrus,1,56.0,0,0,1,0,1,Malaysia
Isa Bakar,2,36.0,0,0,2,0,2,Malaysia
Isa Halim,1,27.0,0,0,0,1,1,Iraq
Isaac Andrade,1,61.0,0,0,0,1,1,Paraguay
Isaac Angking,1,56.0,0,1,1,1,2,Puerto Rico
Isaac Boakye,2,396.0,0,0,2,3,5,Liberia
Isaac Boelua Lokuli,0,123.0,0,0,2,0,2,Angola
Isaac Chauvet,0,220.0,0,0,4,0,4,Haiti
Isaac Kiese Thelin,0,78.0,0,0,1,0,1,Sweden
Isaac Mina,0,12.0,0,0,0,1,1,Venezuela
Isaac Ngoma,1,72.0,0,0,0,2,2,Cape Verde
Isaac Terrazas,1,74.0,0,0,0,1,1,Brazil
Isaac Tondo,0,245.0,0,0,2,1,3,Liberia
Isabelino Gradín,4,281.0,0,0,0,5,5,Chile
Isco,1,219.0,0,0,6,1,7,Spain
Ishmael Addo,0,89.0,0,0,1,0,1,Ghana
Ishmael Wadi,1,38.0,0,0,0,1,1,Malawi
Isiah Lagutang,0,23.0,0,0,1,0,1,Guam
Isidoro Díaz,1,284.0,0,0,5,2,7,Mexico
Isidro Gutiérrez,0,26.0,0,0,1,1,2,Costa Rica
Isidro Lángara,1,295.0,0,1,5,3,8,Spain
Isidro Matute,3,131.0,0,0,3,0,3,Ecuador
Islam Batran,0,85.0,0,0,1,0,1,Palestine
Islam Slimani,8,1212.0,0,2,12,11,23,Algeria
Islambek Kuat,0,328.0,0,0,3,2,5,Kazakhstan
Islom Inomov,0,79.0,0,0,0,1,1,Taiwan
Islom Tukhtakhujaev,0,72.0,0,0,1,0,1,Uzbekistan
Ismaeel Mohammad,0,75.0,0,0,1,0,1,Qatar
Ismaeil Bakhit,0,157.0,0,0,2,0,2,Sudan
Ismael Alassane,0,3.0,0,0,1,0,1,Niger
Ismael Alvariza,0,53.0,0,0,0,1,1,Chile
Ismael Dyfan,0,134.0,0,0,1,1,2,Nigeria
Ismael Díaz,1,49.0,0,0,1,0,1,Panama
Ismael Fuentes,0,48.0,0,0,1,0,1,Chile
Ismael Rivero,3,119.0,0,0,0,3,3,Ecuador
Ismael Sylla,0,77.0,0,0,1,0,1,Guinea
Ismael Urzaiz,0,206.0,0,0,5,1,6,Spain
Ismail Abdullatif,5,917.0,0,3,13,3,16,Bahrain
Ismail Al Hammadi,0,270.0,0,0,3,1,4,South Korea
Ismail Al-Ajmi,0,197.0,0,0,2,2,4,Thailand
Ismail Al-Amour,1,88.0,0,0,0,1,1,Afghanistan
Ismail Isa,0,3.0,0,0,0,1,1,Czech Republic
Ismail Matar,0,524.0,0,1,4,6,10,United Arab Emirates
Ismail Mohammed Sharif,0,108.0,0,0,1,1,2,Somalia
Ismail Naseem,0,67.0,0,0,0,1,1,Cambodia
Ismail Rashid Ismail,0,89.0,0,0,1,0,1,United Arab Emirates
Ismaël Bangoura,1,263.0,0,0,5,1,6,Guinea
Ismaël Bennacer,0,48.0,0,0,0,1,1,Niger
Ismaël Diakité,0,90.0,0,0,1,0,1,Mauritania
Ismaël Koudou,1,10.0,0,0,0,1,1,Egypt
Ismaïla Sarr,3,332.0,0,1,3,4,7,Burkina Faso
Ismed Sofyan,0,101.0,0,0,0,2,2,Maldives
Ismo Lius,0,71.0,0,0,1,0,1,Finland
Israel Castro,0,19.0,0,0,1,0,1,Mexico
Issa Ba,1,80.0,0,0,0,1,1,Zimbabwe
Issa Djibrilla,0,172.0,0,0,2,0,2,Niger
Issa Kaboré,1,51.0,0,0,0,1,1,Djibouti
Issah Gabriel Ahmed,1,60.0,1,0,0,1,1,Ghana
Issam Al Sabhi,0,133.0,0,0,1,1,2,Japan
Issam El Adoua,0,10.0,0,0,0,1,1,South Africa
Issam Jemâa,2,414.0,0,0,4,5,9,Kenya
Issam Mahrous,1,66.0,1,0,1,0,1,Kuwait
Issam Said Saleh,0,83.0,0,0,1,0,1,Jordan
Issey Nakajima-Farran,0,32.0,0,0,0,1,1,Saint Vincent and the Grenadines
Issiaga Sylla,1,35.0,0,0,1,0,1,Guinea
Issiaka Ouédraogo,1,90.0,0,0,0,1,1,Sudan
Issouf Traoré,1,53.0,0,0,1,0,1,Burkina Faso
Issoufou Dayo,3,246.0,0,2,3,2,5,Cape Verde
István Halász,0,43.0,0,0,0,1,1,Bolivia
István Juhász,0,75.0,0,0,1,0,1,Hungary
István Pisont,0,88.0,0,0,0,1,1,Azerbaijan
István Szőke,1,94.0,0,0,1,1,2,Romania
István Vincze,0,147.0,0,0,2,2,4,Hungary
Isuru Perera,0,47.0,0,0,1,0,1,Sri Lanka
Iswadi Idris,1,127.0,0,0,0,3,3,Australia
Isâad Bourahli,0,21.0,0,0,1,1,2,Algeria
Italo Vassalo,0,101.0,0,0,1,0,1,Ethiopia
Itamunua Keimuine,1,89.0,1,0,1,0,1,Morocco
Itay Shechter,0,154.0,0,0,2,0,2,Israel
Itumeleng Duiker,0,37.0,0,0,0,1,1,Niger
Itzhak Peretz,0,54.0,0,0,1,0,1,Israel
Itzhak Shum,2,131.0,0,0,2,0,2,Israel
Itzik Zohar,0,290.0,0,0,0,5,5,Austria
Iulian Apostol,0,16.0,0,0,1,0,1,Romania
Iuliu Barátky,1,88.0,0,0,0,1,1,Cuba
Iurie Miterev,0,85.0,0,0,2,0,2,Moldova
Ivan Bek,3,157.0,0,0,0,3,3,Brazil
Ivan Buljan,0,102.0,0,0,0,2,2,Norway
Ivan Davidov,1,43.0,1,0,0,1,1,Bulgaria
Ivan Gudelj,0,37.0,0,0,1,1,2,Spain
Ivan Hašek,1,141.0,0,0,0,5,5,Denmark
Ivan Iliev,0,84.0,0,0,0,1,1,Denmark
Ivan Ivanov,0,86.0,0,0,1,1,2,Switzerland
Ivan Klasnić,2,299.0,0,0,3,2,5,Croatia
Ivan Kolev,0,203.0,0,1,1,3,4,Bulgaria
Ivan Matteoni,0,83.0,1,0,0,1,1,San Marino
Ivan Mráz,0,18.0,0,0,2,0,2,Czechoslovakia
Ivan Obradović,0,24.0,0,0,0,1,1,Austria
Ivan Perišić,10,1201.0,0,0,12,13,25,Belgium
Ivan Rakitić,2,486.0,0,2,5,4,9,Andorra
Ivan Schranz,0,75.0,0,0,1,1,2,Slovakia
Ivan Tričkovski,0,65.0,0,0,1,1,2,Republic of Ireland
Ivan Vicelich,0,227.0,0,0,4,1,5,New Zealand
Ivan Vutsov,2,82.0,2,0,1,1,2,Belgium
Ivan Yaremchuk,1,66.0,0,0,1,0,1,Russia
Ivaylo Chochev,0,229.0,0,0,2,1,3,Bulgaria
Ivaylo Petkov,0,68.0,0,0,1,0,1,Bulgaria
Ivaylo Yordanov,0,104.0,0,0,1,1,2,Bulgaria
Ivelin Popov,0,429.0,0,0,6,4,10,Bulgaria
Iver Fossum,0,8.0,0,0,1,0,1,Norway
Ivica Grlić,0,68.0,0,0,0,1,1,Moldova
Ivica Horvat,1,9.0,1,0,1,0,1,Germany
Ivica Olić,3,502.0,0,0,5,7,12,Italy
Ivica Osim,0,192.0,0,0,3,0,3,Yugoslavia
Ivica Vastić,1,560.0,0,1,6,3,9,Austria
Ivica Šurjak,2,306.0,0,1,2,6,8,Greece
Ivo Basay,4,306.0,0,0,5,0,5,Chile
Ivo Knoflíček,0,149.0,0,0,2,1,3,Czechoslovakia
Ivo Raimundo Traça,0,57.0,0,0,1,0,1,Angola
Ivor Allchurch,2,542.0,0,0,5,5,10,Wales
Ivor Broadis,2,102.0,0,0,0,3,3,Scotland
Iván Córdoba,1,117.0,0,2,2,1,3,Argentina
Iván Guerrero,0,158.0,0,0,1,2,3,Honduras
Iván Helguera,0,89.0,0,0,2,0,2,Spain
Iván Hurtado,1,137.0,1,0,1,1,2,Peru
Iván Kaviedes,3,528.0,0,0,4,5,9,Argentina
Iván Valenciano,0,171.0,0,0,3,1,4,Colombia
Iván Zamorano,3,1338.0,0,5,19,6,25,Venezuela
Izet Hajrović,0,239.0,0,0,1,3,4,Slovakia
Iļja Vestermans,0,123.0,0,0,1,2,3,Latvia
J. P. Rodrigues,0,51.0,1,0,1,0,1,Mexico
Jaap Stam,0,32.0,0,0,1,0,1,Netherlands
Jaba Kankava,1,175.0,0,0,0,5,5,Croatia
Jabarry Chandler,0,90.0,0,0,0,1,1,United States Virgin Islands
Jabra Al-Zarqa,0,70.0,0,0,1,0,1,Syria
Jabu Pule,0,71.0,0,0,0,1,1,Lesotho
Jacek Bąk,0,3.0,0,0,1,0,1,Poland
Jacek Góralski,0,81.0,0,0,1,0,1,Poland
Jacek Krzynówek,0,593.0,0,0,2,6,8,Northern Ireland
Jacek Ziober,0,85.0,0,0,0,1,1,Albania
Jacinto Barquín,1,42.0,0,0,0,1,1,United States
Jacinto João,0,73.0,0,0,1,1,2,Portugal
Jacinto Santos,0,93.0,0,0,2,0,2,Portugal
Jack Chamangwana,0,88.0,1,0,1,0,1,Zambia
Jack Charlton,0,168.0,0,0,2,0,2,England
Jack Froggatt,0,25.0,0,0,1,0,1,England
Jack Grealish,1,176.0,0,0,1,1,2,Andorra
Jack Michael Morillo,0,79.0,0,0,1,0,1,Dominican Republic
Jack Rowley,0,167.0,0,0,4,0,4,England
Jack Samani,2,249.0,0,0,3,1,4,Solomon Islands
Jack Wilshere,0,130.0,0,0,0,2,2,Slovenia
Jackie Henderson,0,89.0,0,0,0,1,1,Northern Ireland
Jackie Milburn,0,129.0,0,0,0,3,3,Wales
Jackie Mudie,1,280.0,0,0,4,2,6,Scotland
Jackner Louis,0,90.0,0,0,0,1,1,Turks and Caicos Islands
Jackson Irvine,1,155.0,0,0,1,4,5,Australia
Jackson Martínez,2,296.0,0,0,2,3,5,Colombia
Jacky Novi,0,43.0,1,0,0,1,1,France
Jacky Valette,1,90.0,0,0,0,1,1,Fiji
Jacob Bruun Larsen,0,63.0,0,0,1,0,1,Denmark
Jacob Ewane,0,90.0,0,0,1,0,1,Cameroon
Jacob Mulenga,3,256.0,0,0,5,2,7,Zambia
Jacob Ngwira,0,64.0,0,0,1,0,1,Malawi
Jacob Xowie,0,62.0,0,0,1,0,1,New Caledonia
Jacobo Kouffati,0,2.0,0,0,1,0,1,Venezuela
Jacques Faivre,0,47.0,0,0,2,0,2,France
Jacques Fatton,0,341.0,0,0,3,3,6,Switzerland
Jacques Foix,0,57.0,0,0,1,0,1,France
Jacques Haeko,6,478.0,0,0,5,2,7,Tahiti
Jacques Mamounoubala,1,80.0,0,0,1,0,1,Congo
Jacques Ndomba,1,65.0,0,0,1,0,1,Congo
Jacques Stockman,0,277.0,0,0,1,4,5,Yugoslavia
Jacques Teugels,0,87.0,0,1,0,1,1,Iceland
Jacques Tuyisenge,0,108.0,0,0,3,0,3,Rwanda
Jacques Vergnes,0,33.0,0,0,0,1,1,Norway
Jacques Zimako,0,164.0,0,0,1,1,2,Cyprus
Jacques-Désiré Périatambée,0,45.0,0,0,0,1,1,Egypt
Jadallah Kheirelseid,0,43.0,0,0,0,1,1,Nigeria
Jaden Servania,0,66.0,0,0,1,0,1,Puerto Rico
Jadon Sancho,0,89.0,0,0,2,0,2,England
Jafar Irismetov,3,489.0,0,0,8,3,11,Uzbekistan
Jafet Soto,4,301.0,0,2,4,2,6,Mexico
Jaffar Omran,1,90.0,0,0,1,0,1,Iraq
Jagajeet Shrestha,0,89.0,0,0,1,0,1,Nepal
Jagdoul,0,80.0,0,0,1,0,1,Sudan
Jahid Hasan Ameli,0,138.0,0,0,3,0,3,Bangladesh
Jahn Ivar Jakobsen,0,46.0,0,0,1,0,1,Norway
Jahongir Ergashev,0,17.0,0,0,0,1,1,Kyrgyzstan
Jaime Alas,0,96.0,0,0,1,1,2,El Salvador
Jaime Arrascaita,0,47.0,0,0,1,0,1,Bolivia
Jaime Ayoví,1,35.0,0,0,2,0,2,Ecuador
Jaime Belmonte,1,166.0,0,0,2,0,2,Mexico
Jaime Castrillón,3,149.0,0,0,1,2,3,Mexico
Jaime Colomé,1,156.0,0,1,1,3,4,Panama
Jaime González,0,90.0,0,0,2,0,2,Colombia
Jaime Graça,0,138.0,0,0,3,0,3,Portugal
Jaime Gutiérrez,1,32.0,0,0,2,0,2,Colombia
Jaime Lozano,2,551.0,0,0,6,5,11,Dominica
Jaime Moreno,1,241.0,0,0,3,3,6,Bolivia
Jaime Morón,0,86.0,0,0,1,0,1,Colombia
Jaime Patricio Ramírez,1,10.0,0,0,0,1,1,Bolivia
Jaime Pizarro,1,68.0,0,1,0,1,1,Bolivia
Jaime Ramírez,4,443.0,0,1,7,2,9,Chile
Jaime Riveros,0,39.0,0,0,0,1,1,Colombia
Jaime Vera,2,260.0,0,0,3,0,3,Chile
Jaime Vladimir Cubías,0,89.0,0,0,0,1,1,Saint Vincent and the Grenadines
Jaime de Almeida,1,38.0,0,0,1,0,1,Brazil
Jaimes McKee,0,76.0,0,0,2,0,2,Hong Kong
Jair,4,556.0,0,1,15,0,15,Brazil
Jair Catuy,1,155.0,0,0,2,0,2,Panama
Jair García,1,31.0,0,0,0,1,1,El Salvador
Jairo Arreola,0,55.0,0,0,1,0,1,Guatemala
Jairo Arrieta,1,71.0,0,0,1,0,1,Costa Rica
Jairo Castillo,0,173.0,0,0,1,2,3,Bolivia
Jairo Henríquez,1,43.0,0,0,0,3,3,Trinidad and Tobago
Jairo Jiménez,1,85.0,0,0,1,0,1,Panama
Jairo Patiño,3,194.0,0,0,2,1,3,Jamaica
Jairo Quinteros,1,40.0,1,0,0,1,1,Bolivia
Jairzinho,9,707.0,0,0,9,3,12,Paraguay
Jaka Ihbeisheh,2,176.0,0,0,3,0,3,Palestine
Jake Gosling,0,87.0,0,0,0,1,1,Poland
Jakkaphan Kaewprom,0,18.0,0,0,1,0,1,Thailand
Jakob Johansson,0,61.0,0,0,1,0,1,Sweden
Jakob Poulsen,0,165.0,0,0,2,0,2,Denmark
Jakub Brabec,0,68.0,0,0,2,0,2,Czech Republic
Jakub Błaszczykowski,2,388.0,0,3,4,6,10,Poland
Jakub Jankto,1,74.0,0,0,1,1,2,Czech Republic
Jakub Kosecki,0,90.0,0,0,1,0,1,Poland
Jakub Moder,0,58.0,0,0,0,1,1,England
Jakub Pešek,0,38.0,0,0,1,0,1,Czech Republic
Jakub Wawrzyniak,0,81.0,0,0,1,0,1,Poland
Jalal Hosseini,1,179.0,0,0,2,3,5,Iran
Jaloliddin Masharipov,4,99.0,0,1,2,2,4,Turkmenistan
Jamal Abu Abed,0,146.0,0,0,1,1,2,Jordan
Jamal Al-Holi,1,29.0,0,1,0,1,1,Malaysia
Jamal Ballantyne,0,9.0,0,0,0,1,1,El Salvador
Jamal Chandler,0,25.0,0,0,0,1,1,United States Virgin Islands
Jamal Charles,0,80.0,0,0,1,0,1,Grenada
Jamal Kazem,0,6.0,0,0,1,0,1,Syria
Jamal Keshek,2,93.0,0,0,1,1,2,Bangladesh
Jamal Mohamed,0,44.0,0,1,1,0,1,Kenya
Jamal Mubarak,0,67.0,0,0,1,0,1,Kuwait
Jamal Musiala,0,83.0,0,0,0,1,1,North Macedonia
Jamal Rashid,1,90.0,0,1,0,1,1,India
Jamal Taha,0,53.0,0,0,1,0,1,Lebanon
Jamal Willer,0,65.0,0,0,1,0,1,Montserrat
Jamal Yaqoub,0,88.0,0,0,1,0,1,Kuwait
Jameleddine Limam,0,245.0,0,0,4,1,5,Tunisia
James Chamanga,4,159.0,0,0,1,3,4,Tunisia
James Chewitt,0,412.0,0,0,3,4,7,Saint Vincent and the Grenadines
James Collins,0,160.0,0,0,1,2,3,Cyprus
James Debbah,1,258.0,0,1,3,1,4,Liberia
James Ha,0,20.0,0,0,1,0,1,Hong Kong
James Lawrence,0,17.0,1,0,1,0,1,Croatia
James Marcelin,2,225.0,0,0,2,2,4,Haiti
James McArthur,0,204.0,0,0,2,1,3,Scotland
James McClean,0,349.0,0,0,2,4,6,Republic of Ireland
James McFadden,0,594.0,0,0,7,3,10,Scotland
James Milner,0,74.0,0,0,0,1,1,Moldova
James Moga,0,166.0,0,0,2,1,3,Sudan
James Morrison,0,27.0,0,0,0,1,1,Wales
James Murphy,0,80.0,0,0,1,0,1,United States
James Rodríguez,6,984.0,0,4,8,11,19,Peru
James Troisi,1,237.0,0,0,2,1,3,Australia
James Ward-Prowse,0,93.0,0,0,1,1,2,England
James Wong,4,164.0,0,0,4,0,4,Malaysia
James Wong Chye Fook,1,6.0,0,0,0,1,1,South Korea
Jamie Browne,0,65.0,0,0,1,1,2,United States Virgin Islands
Jamie Lawrence,0,14.0,0,0,0,1,1,United States
Jamie Lowery,1,83.0,0,0,1,0,1,Canada
Jamie Maclaren,2,289.0,0,2,5,3,8,Palestine
Jamie Pace,0,44.0,0,0,1,1,2,Malta
Jamie Thomas,0,86.0,0,0,1,0,1,Antigua and Barbuda
Jamie Vardy,1,122.0,0,0,2,0,2,England
Jamie Ward,0,148.0,0,0,3,1,4,Northern Ireland
Jamil Joseph,0,114.0,0,0,3,0,3,Saint Lucia
Jamil Kyambadde,0,89.0,0,0,1,0,1,Uganda
Jamiro Monteiro,1,52.0,0,0,0,1,1,Liberia
Jamiru Amidu,0,14.0,0,0,0,1,1,Ghana
Jamshed Ismailov,0,2.0,0,0,1,0,1,Tajikistan
Jamshid Iskanderov,0,53.0,0,0,1,0,1,Uzbekistan
Jan Allan Müller,0,163.0,0,0,2,1,3,Scotland
Jan Banaś,0,6.0,0,0,0,1,1,Albania
Jan Bartram,0,58.0,0,1,1,1,2,Denmark
Jan Bednarek,1,59.0,0,0,0,1,1,Japan
Jan Berger,0,77.0,0,1,1,0,1,Czechoslovakia
Jan Ceulemans,6,672.0,0,0,8,7,15,Belgium
Jan Domarski,0,110.0,0,0,1,1,2,Poland
Jan Eriksson,0,125.0,0,0,3,0,3,Sweden
Jan Fuglset,0,55.0,0,1,1,0,1,Norway
Jan Furtok,0,147.0,0,0,2,0,2,Poland
Jan Heintze,0,74.0,0,0,1,1,2,Denmark
Jan Koller,4,1675.0,0,2,18,15,33,Estonia
Jan Kopic,0,62.0,0,0,1,1,2,Azerbaijan
Jan Kristian Fjærestad,0,32.0,0,0,0,1,1,German DR
Jan Liberda,0,54.0,0,0,1,0,1,Poland
Jan Michaelsen,0,90.0,0,0,1,0,1,Denmark
Jan Mulder,0,10.0,0,0,0,1,1,German DR
Jan Mølby,0,69.0,0,0,1,1,2,Finland
Jan Olsson,0,62.0,0,0,1,0,1,Sweden
Jan Peters,0,89.0,0,0,1,0,1,Netherlands
Jan Polák,0,294.0,0,0,5,0,5,Czech Republic
Jan Rezek,0,128.0,0,0,1,2,3,Lithuania
Jan Ríha,0,44.0,0,0,0,1,1,Bulgaria
Jan Suchopárek,1,90.0,0,0,0,2,2,Norway
Jan Svensson,0,128.0,0,0,1,1,2,Czechoslovakia
Jan Szmidt,0,29.0,0,0,1,0,1,Poland
Jan Sýkora,0,85.0,0,0,1,0,1,Czech Republic
Jan Urban,0,86.0,0,0,1,0,1,Poland
Jan Vertonghen,2,380.0,0,0,2,4,6,Belgium
Jan Åge Fjørtoft,0,278.0,0,0,5,2,7,Norway
Janek Meet,0,97.0,2,0,2,0,2,Scotland
Jang Hyun-soo,0,104.0,0,1,1,1,2,Lebanon
Jang Kuk-chol,0,83.0,0,0,1,1,2,North Korea
Jang Song-Hyok,0,54.0,0,1,0,1,1,Tajikistan
Janne Lindberg,0,78.0,0,0,0,1,1,Faroe Islands
Janne Salli,0,63.0,0,0,1,0,1,Finland
Jannick Buyla,1,57.0,0,0,0,1,1,Senegal
Jannik Vestergaard,0,90.0,0,0,1,0,1,Denmark
Jano Ananidze,0,78.0,0,0,1,0,1,Georgia
Janus Guðlaugsson,0,61.0,0,0,1,1,2,Iceland
Janusz Kupcewicz,1,118.0,0,0,1,1,2,Poland
Janusz Żmijewski,0,147.0,0,0,0,3,3,Belgium
Janício Martins,0,73.0,0,0,0,1,1,South Africa
Jaouad Zairi,1,261.0,0,0,4,0,4,Morocco
Jarchinio Antonia,0,45.0,0,0,1,0,1,Curaçao
Jared Borgetti,12,1795.0,0,1,29,8,37,Mexico
Jari Litmanen,0,1007.0,0,4,8,10,18,Finland
Jari Rantanen,0,43.0,0,0,2,0,2,Finland
Jari Vanhala,0,60.0,0,0,1,0,1,Finland
Jarkko Hurme,0,55.0,0,0,1,0,1,Finland
Jarmo Manninen,0,88.0,0,0,1,0,1,Finland
Jaromír Zmrhal,0,47.0,0,0,1,0,1,Czech Republic
Jaroslav Plašil,1,304.0,0,0,1,4,5,Germany
Jaroslav Pollák,0,16.0,0,0,0,1,1,Finland
Jaroslav Timko,0,147.0,0,0,3,0,3,Slovakia
Jarvin Skeete,0,104.0,0,0,2,0,2,Saint Lucia
Jasem Al-Huwaidi,13,959.0,0,0,11,10,21,Macau
Jasem Yaqoub,1,535.0,0,3,6,5,11,Bahrain
Jasim Al-Shaikh,0,51.0,0,0,1,0,1,Bahrain
Jason Culina,0,20.0,0,0,1,0,1,Australia
Jason Cunliffe,0,199.0,0,0,3,0,3,Guam
Jason Davidson,0,14.0,0,0,1,0,1,Australia
Jason Demetriou,0,80.0,0,0,0,1,1,Israel
Jason François,0,87.0,0,0,2,0,2,Grenada
Jason Koumas,0,208.0,0,2,4,0,4,Wales
Jason Mayélé,0,108.0,0,0,3,0,3,DR Congo
Jason McAteer,0,141.0,0,0,2,1,3,Republic of Ireland
Jason Roberts,0,119.0,0,1,4,1,5,Guyana
Jason Scotland,0,49.0,0,0,1,0,1,Trinidad and Tobago
Jason de Vos,1,166.0,0,0,2,1,3,Canada
Jasse Tuominen,0,21.0,0,0,1,0,1,Finland
Jassem Al-Tamimi,1,165.0,0,0,2,0,2,Qatar
Jassim Mohammed Ghulam,0,71.0,0,0,0,1,1,Pakistan
Jassim Swadi,1,68.0,0,0,1,0,1,Iraq
Jasur Khasanov,0,12.0,0,0,0,1,1,Lebanon
Javad Kazemian,1,78.0,0,0,1,0,1,Iran
Javad Manafi,1,90.0,0,0,0,1,1,Saudi Arabia
Javad Nekounam,3,1032.0,0,2,12,5,17,Iran
Javain Brown,0,43.0,1,0,1,0,1,Panama
Javi Moreno,0,76.0,0,0,1,0,1,Spain
Javid Huseynov,0,4.0,0,0,1,0,1,Azerbaijan
Javier Ambrois,6,555.0,0,1,1,11,12,England
Javier Astúa,0,210.0,0,0,4,0,4,Costa Rica
Javier Balboa,0,334.0,0,2,4,0,4,Equatorial Guinea
Javier Chevantón,1,302.0,0,1,3,3,6,Bolivia
Javier Delgado,0,127.0,1,0,2,0,2,Mexico
Javier Ferreira,0,115.0,0,0,2,0,2,Paraguay
Javier Fragoso,0,148.0,0,0,3,0,3,Mexico
Javier Guzmán,0,25.0,1,0,0,1,1,Mexico
Javier Hernández,17,1430.0,0,2,10,14,24,France
Javier Manjarín,1,84.0,0,0,1,1,2,Spain
Javier Margas,0,154.0,0,0,1,2,3,Venezuela
Javier Mascherano,2,154.0,0,0,2,0,2,Argentina
Javier Pastore,1,26.0,0,0,1,0,1,Argentina
Javier Patiño,0,66.0,0,0,2,0,2,Philippines
Javier Saviola,5,377.0,0,0,6,0,6,Argentina
Javier Tamayo,0,61.0,0,0,0,1,1,Venezuela
Javier Valdivia,0,91.0,0,0,2,0,2,Mexico
Javier Zanetti,1,89.0,0,0,2,0,2,Argentina
Javokhir Sidikov,1,17.0,0,0,0,1,1,Turkmenistan
Jawad Khalaf,0,42.0,0,0,0,1,1,Thailand
Jawdat Suleiman,1,90.0,0,0,1,0,1,Syria
Jawhar Mnari,1,73.0,0,0,1,1,2,Tunisia
Jay-Jay Okocha,3,394.0,0,2,8,3,11,Nigeria
Jaycee John Okwunwanne,1,68.0,0,0,1,1,2,Saudi Arabia
Jaylee Hodgson,3,188.0,0,0,2,1,3,Montserrat
Jaylon Bather,1,40.0,0,0,1,0,1,Bermuda
Je-Vaughn Watson,1,132.0,1,0,2,1,3,Jamaica
Jean Alexandre,0,143.0,0,0,2,0,2,Haiti
Jean Beausejour,2,167.0,0,0,2,1,3,Chile
Jean Capelle,1,15.0,0,0,0,1,1,Republic of Ireland
Jean Desgranges,0,90.0,0,0,2,0,2,France
Jean Djorkaeff,0,41.0,0,1,1,0,1,France
Jean Dockx,0,60.0,0,0,1,0,1,Belgium
Jean Foutika,2,121.0,0,0,2,0,2,Congo
Jean Gallice,0,89.0,0,0,1,0,1,France
Jean Hmae,2,180.0,0,0,2,0,2,New Caledonia
Jean Jacques Radonamahafalison,0,15.0,0,0,0,1,1,Benin
Jean Janssens,0,31.0,0,0,0,1,1,Norway
Jean Kalala N'Tumba,3,283.0,0,0,3,4,7,Congo
Jean Klein,0,85.0,0,0,0,1,1,France
Jean Lomami,0,95.0,0,0,1,1,2,Rwanda
Jean Luciano,1,83.0,0,0,1,0,1,France
Jean Ludivion,1,82.0,0,0,0,1,1,Solomon Islands
Jean Makoun,0,292.0,0,0,5,0,5,Cameroon
Jean Maleb,3,299.0,0,0,0,4,4,American Samoa
Jean Manga Onguéné,1,228.0,0,0,2,2,4,Cameroon
Jean Meneses,0,56.0,0,0,0,1,1,Colombia
Jean Michaël Seri,1,90.0,0,0,1,0,1,Ivory Coast
Jean Monuma,0,61.0,0,0,1,0,1,Haiti
Jean Márquez,0,83.0,0,0,1,0,1,Guatemala
Jean Nako Naprapol,2,122.0,0,0,3,0,3,Vanuatu
Jean Nicolas,1,370.0,0,1,2,5,7,Luxembourg
Jean Paul Farrugia,0,14.0,0,0,1,0,1,Malta
Jean Petit,0,38.0,0,0,1,0,1,France
Jean Seri,0,64.0,0,0,1,0,1,Ivory Coast
Jean Sony Alcénat,0,40.0,0,0,1,0,1,Haiti
Jean Tigana,1,62.0,0,0,0,1,1,Hungary
Jean Tsaralaza,0,79.0,0,0,1,0,1,Madagascar
Jean Vincent,2,528.0,0,0,12,0,12,France
Jean Xowie,1,216.0,0,0,2,1,3,New Zealand
Jean-Alain Boumsong,0,42.0,0,0,1,0,1,France
Jean-Baptiste N'Doga,0,49.0,0,0,2,0,2,Cameroon
Jean-Brice Wadriako,1,53.0,0,0,1,0,1,New Caledonia
Jean-Charles Castelletto,1,29.0,0,0,1,0,1,Cameroon
Jean-Claude Bras,0,82.0,0,0,2,0,2,France
Jean-Claude Désir,0,20.0,0,0,0,1,1,El Salvador
Jean-Claude Iranzi,0,70.0,0,0,1,0,1,Rwanda
Jean-Eudes Maurice,2,301.0,0,2,2,6,8,Haiti
Jean-François Domergue,0,138.0,0,0,2,0,2,France
Jean-François Larios,0,196.0,0,2,1,2,3,France
Jean-Jacques Marcel,0,104.0,0,0,1,1,2,Austria
Jean-Jacques Missé-Missé,0,63.0,0,0,0,1,1,Togo
Jean-Jacques N'Domba,0,141.0,0,0,0,2,2,Cameroon
Jean-Kasongo Banza,0,88.0,0,0,0,1,1,Burkina Faso
Jean-Louis Bozon,1,15.0,0,0,0,1,1,Algeria
Jean-Louis Straetmans,0,37.0,0,0,0,1,1,Sweden
Jean-Loup Rousseau,6,339.0,0,1,6,1,7,Tahiti
Jean-Marc Ferreri,1,27.0,0,0,1,0,1,France
Jean-Marc Guillou,0,173.0,0,0,3,0,3,France
Jean-Marie Mbuyi,0,30.0,0,0,0,1,1,Sierra Leone
Jean-Marie Tsébo,1,55.0,0,0,1,1,2,Cameroon
Jean-Michel Larqué,0,66.0,0,0,0,1,1,Republic of Ireland
Jean-Michel M'Bono,5,251.0,0,0,5,1,6,Congo
Jean-Paul,0,119.0,0,0,2,0,2,Madagascar
Jean-Paul Akono,0,4.0,0,1,1,0,1,Cameroon
Jean-Paul Brigger,0,149.0,0,1,2,1,3,Switzerland
Jean-Paul Girres,0,57.0,0,0,1,0,1,Luxembourg
Jean-Philippe Durand,0,89.0,0,0,1,0,1,France
Jean-Philippe Peguero,2,56.0,0,0,2,0,2,Haiti
Jean-Philippe Saïko,1,95.0,0,0,0,2,2,Papua New Guinea
Jean-Pierre Fiala,0,88.0,0,0,1,0,1,Cameroon
Jean-Pierre Fiedler,0,5.0,0,0,0,1,1,Netherlands
Jean-Pierre Guede Akenon,0,71.0,0,1,1,0,1,Ivory Coast
Jean-Pierre Papin,4,968.0,0,4,10,10,20,Canada
Jean-Pierre Tokoto,0,40.0,0,0,0,1,1,Morocco
Jean-Pierre Vanek,0,82.0,0,0,1,0,1,Luxembourg
Jean-Robert Menelas,0,151.0,0,0,4,0,4,Haiti
Jean-Sebastien Bax,0,88.0,0,0,0,1,1,Egypt
Jean-Silvestre N'Keoua,0,29.0,0,0,0,1,1,Equatorial Guinea
Jean-Yves Randriamarozaka,0,61.0,0,0,1,0,1,Madagascar
Jeannot Reiter,0,60.0,0,0,1,1,2,Luxembourg
Jeff Agoos,1,171.0,1,0,2,1,3,United States
Jeff Campbell,0,325.0,0,0,5,0,5,New Zealand
Jeff Gellineau,0,2.0,0,0,1,0,1,Trinidad and Tobago
Jeff Hendrick,0,52.0,0,0,0,2,2,Serbia
Jeff Strasser,0,75.0,0,0,1,2,3,Luxembourg
Jeff Whitley,0,69.0,0,0,0,2,2,Finland
Jefferson Farfán,1,975.0,0,1,14,4,18,Peru
Jefferson Lerma,0,6.0,0,0,0,1,1,Chile
Jefferson Montero,0,214.0,0,0,3,2,5,Peru
Jeffrey Bruma,0,78.0,0,0,1,0,1,Netherlands
Jeffrey Edmond,0,66.0,0,0,0,1,1,Antigua and Barbuda
Jeffrey Kwaomae,1,43.0,0,0,0,1,1,Tahiti
Jeffrey Talan,0,71.0,0,0,1,0,1,Netherlands
Jehad Al-Hussain,0,236.0,0,1,3,2,5,Syria
Jehad Muntasser,0,21.0,0,0,1,1,2,Libya
Jeison Murillo,1,36.0,0,0,0,1,1,Brazil
Jeje Lalpekhlua,1,182.0,0,0,1,2,3,India
Jelle Vossen,0,85.0,0,0,2,0,2,Belgium
Jens Erik Rasmussen,0,9.0,0,0,1,0,1,Faroe Islands
Jens Jeremies,0,31.0,0,0,1,0,1,Germany
Jens Jørn Bertelsen,0,68.0,0,0,1,0,1,Denmark
Jens Kristian Hansen,0,135.0,0,0,2,1,3,Faroe Islands
Jens Petersen,0,18.0,0,1,1,0,1,Denmark
Jens Stryger Larsen,0,35.0,0,0,1,0,1,Denmark
Jensy Muñoz,0,31.0,0,0,0,1,1,United States
Jenílson Ângelo de Souza,1,64.0,0,0,0,1,1,Costa Rica
Jenő Vincze,1,79.0,0,0,1,1,2,Egypt
Jeong Gang-Ji,0,57.0,0,0,2,0,2,South Korea
Jeong Sang-bin,0,77.0,0,0,1,0,1,South Korea
Jeong Woo-yeong,1,80.0,0,0,0,1,1,Iraq
Jeremain Lens,0,193.0,0,0,2,3,5,Hungary
Jeremy Bokila,2,141.0,0,0,1,1,2,DR Congo
Jeremy Charles,0,72.0,0,0,1,0,1,Wales
Jeremy Christie,0,69.0,0,0,1,0,1,New Zealand
Jeris Tadrus,3,147.0,0,0,3,1,4,Jordan
Jerko Leko,0,76.0,0,0,1,0,1,Croatia
Jermain Defoe,1,698.0,0,0,9,5,14,Poland
Jermaine Anderson,0,90.0,0,0,1,0,1,Jamaica
Jermaine Beckford,0,89.0,0,0,1,0,1,Jamaica
Jermaine Hue,2,92.0,0,0,1,1,2,Guatemala
Jermaine Jones,1,150.0,0,0,3,0,3,United States
Jerome Ramatlhakwane,0,110.0,0,1,1,1,2,Botswana
Jerren Nixon,2,242.0,0,0,3,2,5,Trinidad and Tobago
Jerry Akaminko,0,90.0,0,0,1,0,1,Ghana
Jerry Alexander,0,315.0,0,0,4,3,7,Barbados
Jerry Bengtson,4,598.0,0,0,8,5,13,Grenada
Jerry Donga,1,64.0,0,0,0,2,2,Vanuatu
Jerry Louis,0,89.0,0,0,1,0,1,Mauritius
Jerry Sitoe,0,45.0,0,0,1,0,1,Mozambique
Jerry Tondelua,3,249.0,0,2,2,2,4,DR Congo
Jerson Tegete,0,90.0,0,0,1,2,3,Mauritius
Jersson González,0,68.0,0,0,1,0,1,Colombia
Jerzy Brzęczek,0,46.0,0,0,1,1,2,Poland
Jerzy Gorgoń,1,31.0,0,0,0,1,1,Haiti
Jerzy Sadek,0,287.0,0,0,3,1,4,Scotland
Jerzy Wilim,0,64.0,0,0,1,0,1,Poland
Jerzy Wostal,0,59.0,0,0,1,0,1,Poland
Jesdaporn Na Phatalung,3,121.0,0,1,1,2,3,Malaysia
Jesper Blomqvist,0,64.0,1,0,1,0,1,Switzerland
Jesper Grønkjær,1,95.0,0,0,1,1,2,Denmark
Jesper Olsen,3,334.0,0,2,5,0,5,Denmark
Jesse August,1,47.0,0,0,1,0,1,Belize
Jesse John,0,15.0,0,0,1,0,1,Bahrain
Jesse Lingard,1,132.0,0,0,3,0,3,England
Jesus Correia,0,53.0,0,0,1,0,1,Portugal
Jesús Arellano,1,142.0,0,0,1,3,4,Chile
Jesús Dátolo,0,65.0,0,0,1,0,1,Argentina
Jesús Ferreira,0,27.0,0,0,1,0,1,United States
Jesús Julio,1,30.0,0,0,0,1,1,Honduras
Jesús Julián Lucendo,0,85.0,0,1,0,1,1,Armenia
Jesús Manuel Corona,2,386.0,0,0,2,4,6,Jamaica
Jesús María Zamora,0,82.0,0,0,1,0,1,Spain
Jesús Navas,1,192.0,0,0,1,2,3,Croatia
Jesús Peláez Miranda,0,2.0,0,0,0,1,1,Uruguay
Jesús Reynaldo,0,179.0,0,0,3,0,3,Bolivia
Jesús Zavala,0,112.0,0,0,0,2,2,El Salvador
Jevgeni Novikov,0,86.0,0,0,1,0,1,Estonia
Jevgeņijs Miļevskis,0,87.0,0,0,1,0,1,Latvia
Jevon Francis,0,12.0,0,0,0,1,1,Saint Lucia
Jeyab Bashafal,0,55.0,0,0,1,0,1,Yemen
Jhasmani Campos,2,192.0,0,0,1,2,3,Peru
Jhoan Sánchez,0,27.0,0,0,1,0,1,Dominican Republic
Jhon Chancellor,0,116.0,0,0,0,2,2,Bolivia
Jhon Murillo,0,51.0,0,0,0,1,1,Argentina
Jhonny Acosta,0,69.0,0,0,1,1,2,Costa Rica
Ji Dong-won,4,303.0,0,0,5,2,7,South Korea
Ji Yun-nam,1,89.0,0,0,0,1,1,Brazil
Jia Xiuquan,2,132.0,0,0,3,2,5,Singapore
Jiana Raoelijaona,0,85.0,0,0,1,0,1,Madagascar
Jiang Ning,0,176.0,0,0,3,0,3,China PR
Jim Allevinah,2,236.0,0,0,3,1,4,Gabon
Jim Bett,0,86.0,0,0,0,1,1,Iceland
Jim Brennan,0,250.0,0,0,3,0,3,Canada
Jim Brown,1,89.0,0,0,0,1,1,Argentina
Jim Holton,0,40.0,0,0,1,0,1,Scotland
Jim Kremer,0,38.0,0,0,1,0,1,Luxembourg
Jim Magilton,0,48.0,0,0,1,1,2,Northern Ireland
Jim McCalliog,0,87.0,0,0,0,1,1,England
Jim McLaughlin,0,85.0,0,0,2,0,2,Northern Ireland
Jimmy Ben,2,53.0,0,0,0,2,2,Tahiti
Jimmy Bermúdez,0,85.0,0,0,0,1,1,Sierra Leone
Jimmy Bone,0,20.0,0,0,0,1,1,Denmark
Jimmy Conway,0,23.0,0,0,1,0,1,Republic of Ireland
Jimmy Dickinson,1,94.0,1,0,1,0,1,Belgium
Jimmy Doña,0,20.0,0,0,1,0,1,Philippines
Jimmy Dunne,1,59.0,0,0,1,1,2,Norway
Jimmy Durmaz,0,89.0,0,0,2,0,2,Sweden
Jimmy Floyd Hasselbaink,1,156.0,0,1,2,2,4,Andorra
Jimmy Gatete,0,53.0,0,0,1,0,1,Rwanda
Jimmy Greaves,1,252.0,0,0,0,4,4,Luxembourg
Jimmy Johnstone,0,3.0,0,0,0,1,1,Germany
Jimmy Kaierea,0,38.0,1,0,1,0,1,Australia
Jimmy Mackay,1,113.0,0,0,3,0,3,Australia
Jimmy Marín,0,3.0,0,0,1,0,1,Costa Rica
Jimmy Mason,0,80.0,0,0,0,1,1,Northern Ireland
Jimmy McIlroy,0,233.0,0,1,2,2,4,Northern Ireland
Jimmy Modeste,0,26.0,0,0,1,0,1,Cape Verde
Jimmy Muguwa,1,85.0,0,0,0,1,1,Guinea
Jimmy Mulisa,0,27.0,0,0,1,0,1,Rwanda
Jimmy Mullen,0,126.0,0,0,0,2,2,Scotland
Jimmy Murray,1,49.0,0,0,1,0,1,Scotland
Jimmy Nicholl,0,111.0,1,0,1,1,2,Northern Ireland
Jimmy Nicholson,0,223.0,0,0,2,3,5,Scotland
Jimmy Quinn,0,351.0,0,1,7,2,9,Romania
Jimmy Rooney,2,137.0,0,0,3,0,3,Australia
Jimmy Zakazaka,0,6.0,0,0,1,0,1,Malawi
Jin Jingdao,0,39.0,0,0,1,0,1,China PR
Jiří Feureisl,1,69.0,0,0,0,1,1,Argentina
Jiří Hledík,1,70.0,0,0,1,0,1,Czechoslovakia
Jiří Novotný,0,73.0,0,0,1,0,1,Czech Republic
Jiří Sloup,0,26.0,0,0,0,1,1,Italy
Jiří Sobotka,1,49.0,0,0,1,0,1,Czechoslovakia
Jiří Štajner,0,82.0,0,0,1,0,1,Czech Republic
Jo Inge Berget,0,51.0,0,0,1,0,1,Norway
Jo Paul Ancheri,0,188.0,0,0,1,3,4,Yemen
Joachim Streich,2,1367.0,0,2,16,9,25,German DR
Joakim Mæhle,1,435.0,0,0,4,3,7,Austria
Joan Capdevila,0,21.0,0,0,2,0,2,Spain
Joan Morales,0,34.0,1,0,1,0,1,Grenada
Joan Oumari,2,145.0,0,0,3,0,3,Lebanon
Joao Rafael Elias,0,43.0,0,0,1,0,1,Rwanda
Joao Rojas,0,90.0,0,0,0,1,1,Paraguay
Joaquim Alberto Silva,2,269.0,0,0,2,2,4,Egypt
Joaquim Santana,0,30.0,0,0,1,0,1,Portugal
Joaquim Santos,0,72.0,0,0,1,0,1,United States Virgin Islands
Joaquín,0,189.0,0,0,2,1,3,Albania
Joaquín Botero,0,760.0,0,1,14,3,17,Bolivia
Joaquín Correa,0,150.0,0,0,0,2,2,Bolivia
Joaquín Peiró,1,145.0,0,0,1,1,2,Spain
Joaquín Rivas,3,219.0,0,0,1,2,3,El Salvador
Joaquín Sierra,0,86.0,0,0,1,0,1,Spain
Joaquín del Olmo,0,52.0,0,0,1,0,1,Mexico
Joash Leader,0,36.0,0,0,0,2,2,Turks and Caicos Islands
Job,0,135.0,0,0,1,1,2,Angola
Jobby Crossan,0,182.0,0,2,5,0,5,Northern Ireland
Jobi McAnuff,1,48.0,0,0,0,1,1,Costa Rica
Jocelyn Ahouéya,0,91.0,0,0,2,0,2,Benin
Jocelyn Angloma,2,27.0,0,0,0,2,2,Canada
Jodel Dossou,0,43.0,0,0,1,0,1,Benin
Joe Aisa,0,35.0,0,1,0,1,1,New Zealand
Joe Allen,0,66.0,0,0,1,1,2,Wales
Joe Bell,1,50.0,0,0,0,1,1,Solomon Islands
Joe Cole,3,276.0,0,0,1,5,6,England
Joe Corona,0,123.0,0,0,3,0,3,United States
Joe Emerson Bizera,1,22.0,0,0,1,0,1,Uruguay
Joe Gaetjens,1,38.0,0,0,0,1,1,England
Joe Harper,0,131.0,0,0,0,2,2,Denmark
Joe Haverty,0,52.0,0,0,0,1,1,Scotland
Joe Jordan,4,297.0,0,0,4,5,9,Scotland
Joe Ledley,0,103.0,0,0,0,2,2,San Marino
Joe Maca,1,48.0,0,1,0,1,1,Chile
Joe Masiga,0,108.0,0,0,1,2,3,Kenya
Joe Royle,0,51.0,0,0,1,0,1,England
Joe Spiteri,0,51.0,0,0,1,0,1,Australia
Joe-Max Moore,2,479.0,0,3,7,2,9,Colombia
Joel Antônio Martins,2,111.0,0,0,2,0,2,Brazil
Joel Campbell,6,691.0,0,0,7,6,13,Costa Rica
Joel Estrada,0,107.0,0,0,2,0,2,El Salvador
Joel Konofilla,1,89.0,0,0,1,0,1,Solomon Islands
Joel Lindpere,0,201.0,0,0,1,2,3,Liechtenstein
Joel Lupahla,1,71.0,0,0,0,1,1,Algeria
Joel Minko,0,24.0,0,0,1,0,1,Gabon
Joel Mogorosi,0,109.0,0,0,2,1,3,Eritrea
Joel Pohjanpalo,0,524.0,0,0,4,4,8,Greece
Joel Porter,6,290.0,0,0,6,0,6,Australia
Joerisse Cexome,1,79.0,0,0,1,0,1,New Caledonia
Joetex Asamoah Frimpong,0,5.0,0,0,0,1,1,Cape Verde
Joevin Jones,1,360.0,0,1,5,2,7,Trinidad and Tobago
Joey Jones,0,70.0,0,0,0,1,1,Yugoslavia
Johan Cruyff,3,1131.0,0,0,20,5,25,Netherlands
Johan Cruz,0,66.0,0,0,0,1,1,El Salvador
Johan Devrindt,0,556.0,0,0,8,4,12,Belgium
Johan Djourou,0,113.0,1,1,2,0,2,Switzerland
Johan Elmander,0,396.0,0,0,2,6,8,Sweden
Johan Fano,0,178.0,0,0,3,0,3,Peru
Johan Mjällby,0,119.0,0,0,2,1,3,Sweden
Johan Neeskens,4,423.0,0,5,7,5,12,Netherlands
Johan Venegas,1,158.0,0,0,2,2,4,Costa Rica
Johan Vonlanthen,1,141.0,0,0,4,1,5,Switzerland
Johan Walem,1,7.0,0,0,1,0,1,Belgium
Johann Eigenstiller,0,51.0,1,0,0,1,1,Austria
Johann Horvath,2,110.0,0,0,5,0,5,Austria
Johann Krankl,0,279.0,0,2,3,2,5,Austria
Johann Lonfat,0,64.0,0,0,1,0,1,Switzerland
Johann Obiang,0,75.0,1,0,1,0,1,Egypt
Johann Paul,0,66.0,0,0,1,0,1,Madagascar
Johann Schmidradner,0,4.0,0,1,0,1,1,Republic of Ireland
Johanna Omolo,1,163.0,0,0,1,2,3,Mauritius
Johannes Ortmann,0,80.0,0,0,1,0,1,Namibia
John Aldridge,1,856.0,0,4,10,7,17,Malta
John Aloisi,5,1230.0,0,1,17,5,22,Australia
John Arne Riise,0,373.0,0,1,7,2,9,Norway
John Atyeo,0,293.0,0,0,2,2,4,England
John Banda,0,132.0,0,0,2,0,2,Malawi
John Baraza,1,133.0,0,0,2,1,3,Burkina Faso
John Barnes,0,236.0,0,0,4,4,8,Turkey
John Barry Nusum,0,528.0,0,0,7,5,12,Bermuda
John Bosman,3,798.0,0,0,9,6,15,Cyprus
John Boye,3,198.0,1,0,1,3,4,Niger
John Brooks,1,86.0,0,0,0,1,1,Ghana
John Bunyenyezi,1,16.0,0,0,0,1,1,Egypt
John Byrne,0,66.0,0,0,0,2,2,Turkey
John Carew,0,746.0,0,1,10,5,15,Norway
John Catliff,0,160.0,0,2,2,2,4,Honduras
John Charles,1,244.0,0,0,1,3,4,Scotland
John Chiedozie,0,26.0,0,0,0,2,2,Tanzania
John Collins,1,470.0,0,2,5,5,10,Scotland
John Connelly,0,5.0,0,0,1,0,1,England
John Dempsey,0,58.0,1,0,1,0,1,Czechoslovakia
John Doyle,0,48.0,0,0,1,0,1,United States
John Ebow Essien,1,28.0,0,0,1,0,1,Ghana
John Egan,0,45.0,0,0,0,1,1,Portugal
John Eriksen,1,62.0,0,0,1,0,1,Denmark
John Greig,0,138.0,0,0,1,1,2,Finland
John Guidetti,0,80.0,0,0,1,0,1,Sweden
John Hartson,0,436.0,0,1,6,4,10,Armenia
John Heitinga,0,63.0,0,0,1,1,2,North Macedonia
John Hewie,0,41.0,0,1,1,0,1,Scotland
John Holland,0,151.0,2,0,2,0,2,Germany
John Hughes,0,39.0,0,0,1,0,1,Scotland
John Jensen,1,128.0,0,0,4,0,4,Denmark
John Kosmina,1,727.0,0,1,11,2,13,Taiwan
John Kramer,0,33.0,0,0,0,1,1,Czechoslovakia
John Krogh,0,60.0,0,0,0,1,1,Sweden
John Lauridsen,1,84.0,0,0,1,0,1,Denmark
John Limniatis,1,60.0,0,0,0,1,1,Jamaica
John Lungu,0,44.0,0,0,0,1,1,Ghana
John Maduka,0,78.0,0,0,0,1,1,Burkina Faso
John Mahoney,0,69.0,0,0,0,1,1,Hungary
John Matkin,0,49.0,0,0,0,1,1,Maldives
John McClelland,0,18.0,0,0,1,0,1,Northern Ireland
John McGinlay,0,40.0,0,0,2,1,3,Scotland
John McGinn,0,461.0,0,0,10,1,11,Scotland
John McPhail,0,25.0,0,0,1,0,1,Scotland
John Mensah,2,34.0,0,0,2,0,2,Ghana
John Metgod,0,138.0,0,0,2,1,3,Netherlands
John Morris Williams,0,90.0,0,0,0,1,1,Indonesia
John Moshoeu,0,249.0,0,0,4,0,4,South Africa
John Méndez,0,89.0,0,0,1,0,1,Guatemala
John O'Brien,1,136.0,0,0,3,0,3,United States
John O'Hare,0,41.0,0,0,3,0,3,Scotland
John O'Neill,0,44.0,0,0,1,0,1,Northern Ireland
John O'Shea,0,163.0,1,0,1,2,3,Republic of Ireland
John Pareanga,1,59.0,0,0,0,1,1,Tonga
John Petersen,1,162.0,0,1,2,3,5,Serbia
John Restrepo,0,156.0,0,0,2,0,2,Colombia
John Robertson,1,373.0,0,4,7,1,8,Norway
John Robinson,0,59.0,0,0,2,0,2,Wales
John Sheridan,0,139.0,0,0,1,2,3,Republic of Ireland
John Shore,0,82.0,0,0,0,1,1,Mauritius
John Sivebæk,0,57.0,0,0,0,1,1,Republic of Ireland
John Smith,0,159.0,0,0,2,0,2,Saint Kitts and Nevis
John Souttar,0,35.0,0,0,1,0,1,Scotland
John Souza,1,75.0,0,0,1,1,2,Mexico
John Stones,2,85.0,0,0,3,0,3,England
John Terry,0,85.0,0,0,1,0,1,England
John Toshack,0,353.0,0,0,3,4,7,German DR
John Utaka,2,191.0,0,0,1,2,3,Nigeria
John Wark,2,259.0,0,0,5,0,5,Scotland
John Wilkinson,1,219.0,0,0,1,2,3,Palestine
John de Wolf,0,137.0,0,0,2,0,2,Netherlands
John van 't Schip,0,47.0,0,0,1,0,1,Netherlands
John van den Brom,0,2.0,0,0,1,0,1,Netherlands
John-Patrick Strauß,0,149.0,0,0,0,2,2,Guam
Johnnier Montaño,1,87.0,0,0,0,1,1,Argentina
Johnny Crossan,0,8.0,0,0,1,0,1,Northern Ireland
Johnny Descouines,3,138.0,0,0,3,0,3,Haiti
Johnny Ekström,1,502.0,0,0,4,5,9,Sweden
Johnny Gavin,0,80.0,0,1,2,0,2,Republic of Ireland
Johnny Giles,0,41.0,0,0,1,0,1,Republic of Ireland
Johnny Hall,0,99.0,0,0,0,2,2,Tonga
Johnny Halsdorf,0,34.0,0,0,0,1,1,Netherlands
Johnny Haynes,1,146.0,0,0,0,3,3,Denmark
Johnny Leverón,1,86.0,0,0,1,0,1,Honduras
Johnny N'Wadioha,0,74.0,0,0,1,0,1,Nigeria
Johnny Nicholls,0,50.0,0,0,0,1,1,Scotland
Johnny Rep,8,591.0,0,1,3,8,11,Uruguay
Johnny Russell,0,74.0,0,0,0,1,1,San Marino
Johnny Squires,0,44.0,0,0,0,1,1,Netherlands
Johnny Thio,0,324.0,0,0,4,1,5,Belgium
Johnny Warren,1,17.0,0,0,0,1,1,Zimbabwe
Johnny Watkiss,0,125.0,0,0,1,1,2,South Korea
Johnson Bwalya,2,268.0,0,0,4,1,5,Zambia
Johny Léonard,0,131.0,0,1,0,3,3,Denmark
Joleon Lescott,1,30.0,0,0,0,1,1,France
Jomard Moussa,0,197.0,0,0,3,0,3,Syria
Jon Andoni Goikoetxea,2,132.0,0,0,1,2,3,Spain
Jon Dahl Tomasson,9,1833.0,0,5,16,20,36,Wales
Jon Kwang-ik,0,90.0,0,0,1,0,1,North Korea
Jonah Ebanks,1,30.0,0,1,1,0,1,Cayman Islands
Jonas Bahamboula,1,82.0,0,0,1,1,2,Congo
Jonas Hector,0,97.0,0,0,0,2,2,San Marino
Jonas Hofmann,0,116.0,0,0,1,1,2,Germany
Jonas Mendes,0,3.0,1,0,1,0,1,Togo
Jonas Ogandaga,0,5.0,0,0,0,1,1,Eswatini
Jonas Okétola,0,33.0,0,0,1,0,1,Benin
Jonas Paulionis,0,162.0,0,0,1,1,2,Latvia
Jonas Svensson,0,57.0,0,0,0,1,1,Gibraltar
Jonas Wind,0,152.0,0,0,0,2,2,Israel
Jonatan Johansson,0,474.0,0,0,6,5,11,Finland
Jonathan Akpoborie,0,113.0,0,0,1,1,2,Kenya
Jonathan Ayité,1,45.0,0,0,0,1,1,Ivory Coast
Jonathan Barrios,0,9.0,0,0,1,0,1,El Salvador
Jonathan Bolingi,1,139.0,0,1,2,1,3,DR Congo
Jonathan Bornstein,0,90.0,0,0,1,0,1,United States
Jonathan Bru,0,78.0,0,0,1,0,1,Mauritius
Jonathan Buatu,0,90.0,0,0,1,0,1,Angola
Jonathan Cantillana,1,121.0,0,0,3,0,3,Palestine
Jonathan David,10,862.0,0,1,11,4,15,Canada
Jonathan Fabbro,0,33.0,0,1,1,1,2,Argentina
Jonathan Faña,0,109.0,0,0,2,1,3,Dominican Republic
Jonathan Ikoné,0,85.0,0,0,1,0,1,France
Jonathan Kodjia,2,152.0,0,0,3,0,3,Ivory Coast
Jonathan Niva,0,44.0,0,0,0,1,1,Cameroon
Jonathan Osorio,1,62.0,0,0,1,1,2,Canada
Jonathan Perry,1,144.0,0,0,2,0,2,New Zealand
Jonathan Pitroipa,2,367.0,0,1,6,1,7,Burkina Faso
Jonathan Sogbie,0,55.0,0,0,0,1,1,DR Congo
Jonathan Tah,0,66.0,1,0,0,1,1,Germany
Jonathan Tehau,5,269.0,1,0,2,4,6,Samoa
Jonathan Walters,0,492.0,0,3,7,3,10,Estonia
Jonathan dos Santos,1,104.0,0,0,1,1,2,United States
Jones Chilengi,1,23.0,1,0,1,1,2,Cameroon
Jones Mwewa,0,71.0,0,0,2,0,2,Zambia
Jones Nkhwazi,0,88.0,0,0,1,0,1,Malawi
Jong Chol-min,0,173.0,0,0,1,3,4,Mongolia
Jong Il-gwan,0,207.0,0,1,4,1,5,Bahrain
Jong Tae-Se,0,72.0,0,0,0,1,1,Iran
Joni,1,64.0,0,1,2,0,2,Angola
Jonny Evans,0,105.0,0,0,3,0,3,Northern Ireland
Jonny Magallón,0,63.0,0,0,1,0,1,Mexico
Joona Toivio,0,148.0,1,0,2,0,2,Finland
Joonas Kolkka,0,324.0,0,0,6,0,6,Finland
Joonas Tamm,3,195.0,0,0,0,3,3,Gibraltar
Jope Namawa Leka,1,4.0,0,0,0,1,1,Tonga
Jordan Adéoti,0,33.0,0,0,1,0,1,Benin
Jordan Ayew,3,412.0,0,1,4,3,7,Ghana
Jordan Henderson,2,187.0,1,0,2,2,4,England
Jordan Johnson,0,52.0,0,0,0,1,1,Dominica
Jordan Morris,0,228.0,0,0,3,0,3,United States
Jordan Perez,0,52.0,1,0,1,0,1,Republic of Ireland
Jordan Wetria,1,78.0,0,0,1,0,1,New Caledonia
Jordi Alba,3,168.0,0,0,2,4,6,Spain
Jordi Cruyff,1,66.0,0,0,0,1,1,Switzerland
Jordy Caicedo,0,85.0,0,1,0,1,1,Paraguay
Jordy Delem,1,84.0,0,0,1,0,1,Martinique
Jorge Alcalde,2,266.0,0,0,5,2,7,Chile
Jorge Amado Nunes,0,82.0,0,0,0,1,1,Bolivia
Jorge Andrade,0,87.0,1,0,1,1,2,Portugal
Jorge Aravena,0,260.0,0,0,3,3,6,Chile
Jorge Bengoché,0,88.0,0,0,1,0,1,Honduras
Jorge Benjamín Araya,3,96.0,0,0,1,2,3,Chile
Jorge Bermúdez,0,50.0,0,0,1,1,2,Colombia
Jorge Bolaño,1,7.0,0,0,0,1,1,Chile
Jorge Bolaños,1,100.0,0,0,0,2,2,Bolivia
Jorge Burruchaga,3,505.0,0,1,4,3,7,Ecuador
Jorge Cadete,0,372.0,0,0,5,0,5,Portugal
Jorge Campos,1,65.0,1,0,0,1,1,Mexico
Jorge Ceciliano,1,13.0,0,0,1,0,1,Brazil
Jorge Claros,1,93.0,1,0,2,0,2,Honduras
Jorge Contreras,1,121.0,0,1,1,1,2,Venezuela
Jorge Costa,1,29.0,1,0,1,0,1,United States
Jorge Dely Valdés,2,550.0,1,0,4,8,12,Canada
Jorge Duilio Benitez,6,394.0,0,0,0,7,7,Colombia
Jorge Estuardo Vargas,0,85.0,0,0,1,0,1,Guatemala
Jorge Gáspari,0,15.0,0,0,1,0,1,Argentina
Jorge Hirano,4,280.0,0,0,2,3,5,Peru
Jorge Hugo Fernández,1,11.0,0,0,1,0,1,Argentina
Jorge Insfran,0,92.0,0,0,1,1,2,Bolivia
Jorge Larraz,5,189.0,0,4,2,3,5,Ecuador
Jorge Laurido,1,75.0,1,0,0,1,1,Ecuador
Jorge Lino Romero,2,130.0,0,0,1,1,2,France
Jorge Luis Alarcón,0,9.0,0,0,1,0,1,Ecuador
Jorge Luis Campos,1,156.0,0,0,1,1,2,Paraguay
Jorge López Caballero,1,58.0,0,0,1,0,1,Colombia
Jorge Martín Núñez,0,68.0,0,0,1,0,1,Paraguay
Jorge Monge,0,127.0,0,0,1,3,4,Guatemala
Jorge Muñoz Luna,0,80.0,0,0,1,0,1,Chile
Jorge Orlando Aravena Plaza,0,252.0,0,0,4,1,5,Chile
Jorge Oyarbide,0,279.0,0,0,4,0,4,Uruguay
Jorge Peredo,0,201.0,0,0,3,1,4,Venezuela
Jorge Peñaloza,0,51.0,0,0,0,1,1,Ecuador
Jorge Plácido,0,88.0,0,0,2,0,2,Portugal
Jorge Ramírez Gallego,0,89.0,0,0,0,1,1,Brazil
Jorge Rodríguez,0,284.0,0,2,6,1,7,Mexico
Jorge Rojas,0,7.0,0,0,1,0,1,Paraguay
Jorge Sarmiento,0,41.0,0,0,1,0,1,Peru
Jorge Sota,0,24.0,0,0,1,0,1,Mexico
Jorge Soto,2,396.0,0,1,6,1,7,Peru
Jorge Sánchez,0,21.0,0,0,1,0,1,Mexico
Jorge Toro,0,129.0,0,0,2,0,2,Chile
Jorge Valdano,4,136.0,0,0,5,0,5,Argentina
Jorge Valdivia,1,85.0,0,0,1,1,2,Colombia
Jorge Vickers,0,19.0,0,0,1,0,1,Guatemala
Jorge Álvarez,1,59.0,0,0,1,0,1,Honduras
Jorginho,0,217.0,0,3,2,1,3,Finland
Jorginho Putinatti,0,23.0,0,0,1,0,1,Brazil
Joris Marveaux,1,45.0,0,0,0,1,1,Cuba
Joris Mathijsen,0,41.0,0,0,1,1,2,Luxembourg
Jorma Vaihela,0,179.0,0,0,1,1,2,Finland
Jorman Aguilar,0,31.0,0,0,1,0,1,Panama
Josateki Kurivitu,1,90.0,0,0,1,0,1,Fiji
Jose Albornoz,0,90.0,0,0,0,1,1,Venezuela
Jose Maria Garcia,2,91.0,0,0,0,2,2,Paraguay
Jose Neves,0,60.0,0,0,1,0,1,Angola
Jose Tognola,1,77.0,0,0,0,1,1,Brazil
Joseba Etxeberria,1,496.0,0,0,2,6,8,Israel
Josef Bican,1,109.0,0,0,1,0,1,Austria
Josef Gauchel,1,168.0,0,0,3,0,3,Germany
Josef Hickersberger,0,99.0,0,0,3,0,3,Austria
Josef Hügi,0,346.0,0,0,6,2,8,Switzerland
Josef Jelínek,0,31.0,0,0,1,0,1,Czechoslovakia
Josef Jurkanin,0,73.0,0,0,1,0,1,Czechoslovakia
Josef Kadraba,1,88.0,0,0,2,0,2,Czechoslovakia
Josef Košťálek,1,93.0,0,0,1,0,1,Czechoslovakia
Josef Ludl,0,73.0,0,0,1,0,1,Czechoslovakia
Josef Martínez,2,449.0,0,0,5,3,8,Venezuela
Josef Masopust,1,85.0,0,0,1,2,3,Romania
Josef Novák,0,52.0,0,0,0,1,1,Germany
Josef Rasselnberg,0,183.0,0,0,0,4,4,Luxembourg
Josef Shirdel,1,79.0,0,0,1,0,1,Afghanistan
Josef Silný,0,33.0,0,0,0,1,1,Poland
Josef Stering,0,122.0,0,0,3,0,3,Austria
Josef Zeman,1,111.0,0,0,1,0,1,Czechoslovakia
Josef Šural,0,35.0,0,0,0,1,1,Netherlands
Joselito Vaca,0,84.0,0,0,1,0,1,Bolivia
Josep Maria Fusté,1,38.0,0,0,1,1,2,Spain
Joseph Aghoghovbia,0,47.0,0,0,1,0,1,Nigeria
Joseph Bassey,1,82.0,0,0,0,1,1,Egypt
Joseph Bléziri,1,66.0,0,0,0,1,1,Ghana
Joseph Chahrestan,3,223.0,0,0,2,1,3,Syria
Joseph Chipolina,0,29.0,1,0,1,0,1,Republic of Ireland
Joseph Enakarhire,0,28.0,0,0,0,1,1,Zimbabwe
Joseph Francis,0,17.0,0,0,0,1,1,Saint Vincent and the Grenadines
Joseph Ghartey,1,40.0,0,0,0,1,1,Benin
Joseph Kaboré,2,114.0,0,0,2,0,2,Burkina Faso
Joseph Kamwendo,0,66.0,0,0,1,0,1,Malawi
Joseph Maluka,0,35.0,0,0,2,0,2,Angola
Joseph Mapulanga,1,157.0,0,0,2,1,3,Zambia
Joseph Marrero,0,87.0,0,0,1,0,1,Puerto Rico
Joseph Mbarga,0,64.0,0,0,1,0,1,Cameroon
Joseph Mbong,0,102.0,0,0,2,0,2,Malta
Joseph Mendes,1,279.0,0,1,3,1,4,São Tomé and Príncipe
Joseph Mounoundzi,0,66.0,0,1,1,0,1,Congo
Joseph Obas,0,155.0,0,0,2,1,3,Haiti
Joseph Ouattara,0,52.0,0,0,0,1,1,Mauritania
Joseph Sam,0,51.0,0,0,0,1,1,DR Congo
Joseph Ujlaki,0,316.0,0,0,0,5,5,Republic of Ireland
Joseph Urpani,0,39.0,0,0,1,0,1,Malta
Joseph Wamba,0,76.0,0,0,1,0,1,Congo
Joseph Yegba Maya,0,64.0,0,0,1,0,1,Cameroon
Joseph Yobo,2,303.0,2,0,3,3,6,Nigeria
Joseph-Désiré Job,3,251.0,0,0,3,1,4,Cameroon
Joses Nawo,0,59.0,0,0,1,0,1,Solomon Islands
Josh Magennis,0,526.0,0,0,3,4,7,Northern Ireland
Josh Parker,0,162.0,0,0,2,0,2,Antigua and Barbuda
Josh Simpson,0,112.0,0,0,3,0,3,Canada
Josh Wolff,0,179.0,0,0,4,1,5,United States
Joshua John,2,115.0,0,0,0,2,2,Cayman Islands
Joshua Kennedy,0,455.0,0,0,6,2,8,Australia
Joshua Kimmich,0,131.0,0,0,0,2,2,Norway
Joshua King,0,722.0,0,5,6,8,14,Cyprus
Joshua Pérez,0,123.0,0,0,1,2,3,United States Virgin Islands
Josimar,2,97.0,0,0,1,1,2,Northern Ireland
Josip Brekalo,0,90.0,0,0,1,0,1,Croatia
Josip Bukal,0,199.0,0,0,0,4,4,Finland
Josip Drmić,1,393.0,0,0,4,1,5,Lithuania
Josip Iličić,0,608.0,0,4,5,8,13,Cyprus
Josip Katalinski,2,312.0,1,1,6,2,8,Greece
Josip Skoblar,1,136.0,0,2,3,1,4,Uruguay
Josip Skoko,1,151.0,0,0,1,4,5,Mexico
Josip Šimunić,0,86.0,0,0,1,1,2,Andorra
Joslin Kamatuka,1,146.0,0,0,1,1,2,Namibia
Jostein Flo,0,271.0,0,0,2,3,5,San Marino
Josué Anunciado de Oliveira,1,68.0,0,0,0,1,1,Chile
Josué Duverger,1,46.0,1,0,1,0,1,Canada
Josué Martínez,1,59.0,0,0,0,1,1,Bolivia
Josy Kirchens,0,38.0,0,0,1,0,1,Luxembourg
José Alfredo Castillo,0,367.0,0,1,3,3,6,Peru
José Altafini,2,201.0,0,0,0,3,3,Austria
José Anthony Torres,0,90.0,1,0,1,0,1,United States
José Antonio Castro,0,79.0,0,0,0,1,1,United States
José Antonio Reyes,0,177.0,0,0,0,2,2,Armenia
José Antonio Vázquez,1,37.0,0,0,0,1,1,Brazil
José Ariel Núñez,0,18.0,0,0,1,0,1,Paraguay
José Artetxe,1,11.0,0,0,0,1,1,Turkey
José Augusto Torres,3,338.0,1,0,3,2,5,Hungary
José Augusto de Almeida,3,166.0,0,0,0,4,4,Hungary
José Aveiro,6,250.0,0,0,3,3,6,Chile
José Avendaño,3,113.0,0,0,2,1,3,Brazil
José Batista,0,9.0,0,0,1,0,1,Uruguay
José Borello,3,221.0,0,0,3,0,3,Argentina
José Bustamante,0,27.0,0,0,0,2,2,Peru
José Cardona,1,19.0,0,0,1,0,1,Honduras
José Cardozo,4,979.0,0,2,11,7,18,Argentina
José Carlos Guimarães,1,53.0,0,0,1,0,1,Brazil
José Cea,0,128.0,0,0,2,0,2,Uruguay
José Chamot,1,54.0,0,0,0,1,1,Japan
José Ciprian Alfonso,1,57.0,0,0,0,2,2,United States
José Claramunt,0,122.0,0,1,1,2,3,Greece
José Clayton,0,123.0,0,3,4,0,4,Tunisia
José Coelho,0,66.0,0,0,1,0,1,Portugal
José Domingo Insfrán,0,59.0,1,0,0,1,1,Paraguay
José Durand Laguna,0,10.0,0,0,1,0,1,Argentina
José Emilio Amavisca,0,49.0,0,0,0,1,1,Armenia
José Eulogio Gárate,0,196.0,0,0,4,0,4,Spain
José Fabián Paz y Miño,0,81.0,0,0,1,0,1,Ecuador
José Fajardo,1,85.0,0,0,0,1,1,Dominica
José Fernández,4,201.0,0,0,1,3,4,Chile
José Filipe Correia Semedo,0,34.0,0,0,0,1,1,Tanzania
José Francisco Rojo,1,116.0,0,0,1,1,2,Spain
José Gabriel Chaparro,0,59.0,0,0,1,0,1,Colombia
José García,3,223.0,0,0,0,4,4,Colombia
José Gaslini,1,75.0,0,0,1,0,1,Argentina
José Gavica,1,133.0,0,0,1,1,2,Ecuador
José Gayà,0,14.0,0,0,1,0,1,Spain
José Gómez,1,28.0,0,0,1,0,1,Cuba
José Hmae,2,39.0,0,0,2,0,2,New Caledonia
José Iraragorri,2,43.0,0,1,0,2,2,Brazil
José Jacinto Vega,0,89.0,0,0,1,0,1,Ecuador
José Javier del Aguila,1,16.0,0,0,1,0,1,Guatemala
José João Pereira,0,47.0,0,0,0,1,1,Nepal
José Kanté,1,48.0,0,0,1,0,1,Guinea
José Leal,0,34.0,0,0,1,0,1,Portugal
José Leandro Andrade,1,69.0,0,0,0,1,1,Peru
José Luis Aussin,0,14.0,0,0,1,0,1,Mexico
José Luis Brown,1,23.0,0,0,1,0,1,Argentina
José Luis Caminero,4,518.0,0,0,2,6,8,Albania
José Luis Capón,0,85.0,0,0,1,0,1,Spain
José Luis Chilavert,1,506.0,0,5,5,3,8,Paraguay
José Luis Dolgetta,4,358.0,0,0,0,6,6,Ecuador
José Luis Ferraro,2,161.0,0,0,2,0,2,Argentina
José Luis Garcés,2,132.0,0,0,3,1,4,Panama
José Luis Gayà,0,71.0,0,0,0,1,1,Faroe Islands
José Luis González Dávila,0,53.0,0,0,2,1,3,Mexico
José Luis Lamadrid,1,257.0,0,0,2,3,5,Haiti
José Luis Panizo,0,15.0,0,0,1,0,1,Spain
José Luis Pineda,1,72.0,0,0,1,1,2,Honduras
José Luis Rodríguez,2,91.0,0,0,2,0,2,Panama
José Luis Sierra,3,56.0,0,0,2,1,3,Brazil
José Luis Veloso,0,79.0,0,0,1,1,2,Spain
José Luis Violeta,0,86.0,0,0,0,1,1,Cyprus
José Luís,0,83.0,0,0,1,0,1,Portugal
José Macia,3,98.0,0,0,3,0,3,Brazil
José Magriñá,1,69.0,0,0,1,0,1,Cuba
José Manuel Abundis,0,166.0,0,0,6,0,6,Mexico
José Manuel Contreras,1,158.0,0,0,2,0,2,Guatemala
José Manuel Moreno,12,493.0,0,0,12,1,13,Argentina
José Manuel Rey,0,280.0,1,0,3,2,5,Venezuela
José Manuel Velázquez,1,10.0,0,0,0,1,1,Mexico
José Manuel de la Torre,1,134.0,0,0,2,1,3,Canada
José Mari Bakero,0,257.0,0,0,6,1,7,Spain
José Maria da Cruz Martins,1,89.0,0,0,1,0,1,Macau
José María Carranza,0,26.0,0,0,0,1,1,Peru
José María Carrasco,0,66.0,1,0,1,0,1,Brazil
José María García Lavilla,0,20.0,0,0,1,0,1,Spain
José María Giménez,3,183.0,0,0,2,1,3,Uruguay
José María Jiménez,2,167.0,0,0,4,1,5,Ecuador
José María Lavalle,1,43.0,0,0,0,1,1,Paraguay
José María Medina,7,263.0,0,0,0,7,7,Chile
José María Ortiz,1,75.0,0,0,0,1,1,Colombia
José Mendoza,1,62.0,0,0,0,1,1,Argentina
José Miguel Cubero,0,31.0,0,0,0,1,1,El Salvador
José Milton Melgar,0,357.0,0,1,4,1,5,Colombia
José Mora,1,75.0,0,0,0,1,1,Peru
José Naranjo,0,195.0,0,0,3,0,3,Mexico
José Orlando Martínez Peña,0,14.0,0,0,1,0,1,El Salvador
José Orlando Semedo,0,44.0,0,0,0,1,1,Switzerland
José Oscar Herrera,0,59.0,0,0,0,1,1,Venezuela
José Parodi,2,229.0,0,0,3,1,4,Paraguay
José Pedro Fuenzalida,3,108.0,0,0,0,3,3,Argentina
José Pereda,1,110.0,0,0,0,3,3,Paraguay
José Perácio,3,195.0,0,0,3,0,3,Brazil
José Piendibene,4,212.0,0,0,1,3,4,Chile
José Pérez,3,202.0,0,0,0,4,4,Chile
José Quintanilla,1,129.0,0,0,1,1,2,El Salvador
José Rafael,0,50.0,0,0,1,0,1,Portugal
José Ramos Delgado,0,35.0,1,0,1,0,1,Bolivia
José Reinaldo de Lima,1,105.0,0,0,1,1,2,Brazil
José Ricardo Taylor,0,85.0,0,0,1,0,1,Honduras
José Ruvalcaba,0,41.0,0,0,1,0,1,Mexico
José Sanfilippo,8,624.0,0,1,9,1,10,Argentina
José Sasía,9,575.0,0,0,0,9,9,Ecuador
José Taboada,1,28.0,0,0,0,1,1,Argentina
José Torrealba,0,152.0,0,0,2,0,2,Venezuela
José Touré,0,93.0,0,0,2,1,3,France
José Travassos,0,51.0,0,0,1,0,1,Portugal
José Ufarte,1,80.0,0,0,0,1,1,Republic of Ireland
José Urquia,0,18.0,0,0,1,0,1,Honduras
José Urruzmendi,0,182.0,0,0,3,1,4,Peru
José Vargas,2,84.0,0,0,1,1,2,Ecuador
José Velásquez,3,198.0,0,0,3,2,5,Peru
José Vicente Balseca,0,25.0,0,0,1,0,1,Ecuador
José Vieira Dias Paulino do Carmo,0,79.0,0,0,0,1,1,Sudan
José Walter Roque,1,105.0,0,0,1,1,2,Uruguay
José del Solar,8,599.0,3,3,5,7,12,Paraguay
José Águas,0,158.0,0,0,2,1,3,Austria
José Ángel Iribar,0,61.0,1,0,1,0,1,Republic of Ireland
Jovan Aćimović,0,14.0,0,0,1,0,1,Yugoslavia
Jovan Kirovski,1,163.0,0,0,2,1,3,United States
Jovan Kostovski,0,85.0,0,0,1,0,1,North Macedonia
Jozef Adamec,1,322.0,0,0,6,1,7,Czechoslovakia
Jozef Barmoš,1,66.0,1,0,1,0,1,England
Jozef Chovanec,0,80.0,1,0,0,2,2,Luxembourg
Jozef Majoroš,0,195.0,0,0,3,0,3,Slovakia
Jozef Móder,0,161.0,0,0,1,2,3,Czechoslovakia
Jozef Štibrányi,1,80.0,0,0,1,0,1,Czechoslovakia
Jozy Altidore,1,1256.0,0,2,20,4,24,United States
João Cancelo,0,134.0,0,0,1,1,2,Portugal
João Carlos dos Santos,1,8.0,0,0,1,0,1,Brazil
João Domingos Pinto,0,135.0,0,0,4,0,4,Portugal
João Elias,0,41.0,0,0,0,1,1,Tunisia
João Félix,1,78.0,0,0,1,0,1,Portugal
João Moutinho,0,315.0,0,0,2,2,4,Portugal
João Palhinha,0,149.0,0,0,1,1,2,Luxembourg
João Paulo,2,81.0,0,0,1,1,2,Brazil
João Pedro,0,52.0,0,0,0,1,1,Malaysia
João Resende Alves,0,55.0,0,0,1,1,2,Portugal
João Vieira Pinto,2,813.0,0,0,12,6,18,Portugal
Joël Kimwaki,1,81.0,0,0,0,1,1,Congo
Joël Matip,0,26.0,0,0,0,1,1,Brazil
Joël Tiéhi,10,727.0,0,1,9,5,14,Gambia
Joško Gvardiol,1,87.0,0,0,1,1,2,Cyprus
Ju Manu Rai,0,129.0,0,0,2,0,2,Nepal
Ju Yingzhi,0,42.0,0,0,1,0,1,Hong Kong
Juan,4,183.0,0,0,4,2,6,Brazil
Juan Alberto Schiaffino,4,273.0,0,0,0,5,5,Bolivia
Juan Alcántara,0,407.0,0,0,5,1,6,Chile
Juan Amarilla,1,5.0,0,0,0,1,1,Chile
Juan Américo Díaz,0,18.0,0,0,1,0,1,Bolivia
Juan Angel Romero,1,17.0,0,0,0,1,1,Bolivia
Juan Antonio Pizzi,0,274.0,0,0,4,0,4,Spain
Juan Antonio Señor,1,234.0,0,1,3,1,4,Spain
Juan Arango,1,840.0,0,0,8,6,14,Venezuela
Juan Arremón,1,43.0,0,0,0,1,1,Bolivia
Juan Ayala,3,206.0,0,0,1,2,3,Uruguay
Juan Barrera,2,195.0,0,0,2,3,5,Nicaragua
Juan Bassa,0,83.0,0,0,1,0,1,Peru
Juan Bautista Agüero,2,241.0,0,0,4,1,5,Colombia
Juan Bautista Coronel,1,20.0,1,0,1,0,1,Bolivia
Juan Bautista Villalba,9,500.0,0,0,3,6,9,Bolivia
Juan Bernat,0,88.0,0,0,0,1,1,Luxembourg
Juan Caballero,0,106.0,0,0,1,1,2,Colombia
Juan Camilo Zúñiga,0,90.0,0,0,1,0,1,Colombia
Juan Carlos Arce,1,473.0,0,3,7,3,10,Venezuela
Juan Carlos Arguedas,0,91.0,0,0,2,1,3,United States
Juan Carlos Arteche,0,67.0,0,0,0,1,1,Albania
Juan Carlos Carone,1,26.0,0,0,1,0,1,Argentina
Juan Carlos Cubillas,0,43.0,0,0,1,0,1,Panama
Juan Carlos Espinoza,1,34.0,0,0,0,1,1,Canada
Juan Carlos García,0,40.0,0,0,1,0,1,Honduras
Juan Carlos Heguy,1,10.0,0,0,0,1,1,Chile
Juan Carlos Heredia,1,12.0,0,0,1,0,1,Argentina
Juan Carlos Irurieta,0,63.0,0,0,1,0,1,Argentina
Juan Carlos Lallana,1,58.0,0,0,1,0,1,Argentina
Juan Carlos Letelier,8,529.0,0,0,7,3,10,Algeria
Juan Carlos Mariño,1,131.0,0,0,1,2,3,Uruguay
Juan Carlos Oblitas,0,305.0,0,0,7,1,8,Peru
Juan Carlos Orellana,0,76.0,0,0,0,1,1,Uruguay
Juan Carlos Padilla,0,17.0,0,0,1,0,1,El Salvador
Juan Carlos Paredes,0,25.0,1,0,0,1,1,Ecuador
Juan Carlos Pedraza,0,60.0,0,0,1,0,1,Spain
Juan Carlos Plata,6,674.0,0,0,9,5,14,Nicaragua
Juan Carlos Portillo,0,30.0,0,0,0,1,1,United States Virgin Islands
Juan Carlos Rojas,2,203.0,0,1,1,3,4,Paraguay
Juan Carlos Salvini,0,159.0,0,0,2,0,2,Argentina
Juan Carlos Sarnari,1,36.0,0,0,1,0,1,Argentina
Juan Carlos Sánchez,0,74.0,0,0,0,1,1,Brazil
Juan Carlos Valerón,2,218.0,0,0,2,2,4,Spain
Juan Carlos Villamayor,2,90.0,0,0,2,0,2,Paraguay
Juan Carreño,1,70.0,0,0,0,1,1,France
Juan Carreño López,0,84.0,0,0,1,0,1,Chile
Juan Castillo,1,73.0,0,0,0,1,1,Bolivia
Juan Cayasso,3,235.0,0,0,3,1,4,Costa Rica
Juan Contrera,0,147.0,0,0,2,0,2,Dominican Republic
Juan Cruz Sol,0,39.0,0,0,1,0,1,Spain
Juan Cuadrado,3,228.0,0,2,0,5,5,Japan
Juan Domingo Brown,0,122.0,0,2,2,0,2,Argentina
Juan Emilio Salinas,1,70.0,0,0,0,2,2,Ecuador
Juan Enrique García,0,151.0,0,0,3,0,3,Venezuela
Juan Fernando Quintero,2,109.0,0,0,2,0,2,Colombia
Juan Flores Madariaga,0,143.0,0,0,3,2,5,Saint Vincent and the Grenadines
Juan Francisco Barraza,0,170.0,0,0,2,0,2,El Salvador
Juan Francisco Riveros,1,62.0,0,0,0,1,1,Chile
Juan Francisco Rodríguez Herrera,0,40.0,0,0,1,0,1,Spain
Juan Fuenmayor,0,41.0,1,0,0,1,1,Venezuela
Juan González Soto,0,27.0,0,0,0,1,1,Suriname
Juan Gutiérrez Moreno,0,34.0,0,0,0,1,1,Estonia
Juan Hernández,0,90.0,0,0,1,0,1,Mexico
Juan Hohberg,3,183.0,0,0,0,3,3,Hungary
Juan Ignacio Basaguren,0,83.0,0,0,1,0,1,Mexico
Juan Jairo Galeano,0,27.0,0,0,0,1,1,Argentina
Juan José Jayo,0,38.0,0,0,0,1,1,Chile
Juan José Muñante,0,70.0,0,0,0,1,1,Chile
Juan José Pizzuti,1,177.0,0,0,4,0,4,Argentina
Juan Joya,2,108.0,0,0,2,0,2,Peru
Juan Loyarte,1,78.0,0,0,1,0,1,Argentina
Juan Maglio,0,47.0,0,0,0,2,2,Peru
Juan Manuel Asensi,1,266.0,0,0,4,1,5,Belgium
Juan Manuel Funes,2,109.0,0,0,3,0,3,Guatemala
Juan Manuel Vargas,1,235.0,0,0,2,1,3,Peru
Juan Marvezzi,5,146.0,0,0,5,0,5,Argentina
Juan Mata,3,621.0,0,1,4,5,9,Spain
Juan Mujica,1,50.0,0,0,0,1,1,Israel
Juan Pablo Rodríguez,0,83.0,0,0,1,0,1,Mexico
Juan Pablo Sorín,2,445.0,0,0,2,5,7,Venezuela
Juan Pablo Vargas,1,121.0,0,0,2,0,2,Costa Rica
Juan Pablo Ángel,0,465.0,0,2,6,2,8,Peru
Juan Pajuelo,1,207.0,0,0,1,2,3,Ecuador
Juan Pedro Riephoff,1,96.0,0,0,0,2,2,Peru
Juan Píriz,2,196.0,0,0,0,3,3,Peru
Juan Ramón Epitié,0,57.0,0,0,1,0,1,Equatorial Guinea
Juan Ramón Martínez,3,356.0,0,0,4,3,7,El Salvador
Juan Reynoso Guzmán,2,213.0,0,0,3,1,4,Paraguay
Juan Riephoff,1,25.0,0,0,0,1,1,Colombia
Juan Rodrigo Rojas,1,77.0,1,0,0,1,1,Paraguay
Juan Román Riquelme,7,719.0,0,4,12,3,15,Argentina
Juan Sebastián Verón,0,252.0,0,1,3,3,6,Paraguay
Juan Seminario,2,217.0,0,0,1,2,3,Peru
Juan Soto Mura,2,68.0,0,0,0,2,2,Bolivia
Juan Soto Quiros,0,32.0,0,0,1,0,1,Costa Rica
Juan Ulloa,0,280.0,0,0,4,2,6,Costa Rica
Juanito,1,70.0,0,1,1,2,3,Yugoslavia
Juanpi,0,34.0,0,0,1,0,1,Venezuela
Juary Soares,0,90.0,0,0,0,1,1,Gabon
Judd Molea,0,41.0,0,0,0,1,1,Papua New Guinea
Jude Bellingham,1,35.0,0,0,1,0,1,England
Judelin Aveska,0,60.0,0,0,1,0,1,Haiti
Judikael Ixoée,1,25.0,0,1,1,0,1,New Caledonia
Juhani Peltonen,0,252.0,0,1,3,3,6,Scotland
Jukka Ikäläinen,0,47.0,1,0,1,0,1,Portugal
Julen Guerrero,0,417.0,0,0,5,5,10,Lithuania
Jules Alberto,0,83.0,0,0,2,0,2,India
Jules Bocandé,1,187.0,0,0,2,1,3,Mozambique
Jules Kadeba,0,73.0,0,0,1,0,1,Burkina Faso
Jules Lagadeau,0,180.0,0,0,2,0,2,Suriname
Juli Fernandez,1,84.0,0,0,0,1,1,Israel
Juli Sánchez,0,73.0,0,0,0,1,1,Russia
Julian Brandt,0,162.0,0,0,2,0,2,Germany
Julian Draxler,2,148.0,0,1,4,1,5,Germany
Julian Green,1,107.0,0,0,0,1,1,Belgium
Julian Johnsson,0,87.0,0,0,1,1,2,Faroe Islands
Julian Wade,2,99.0,0,0,1,1,2,Dominica
Julian de Guzman,2,177.0,0,0,1,2,3,Costa Rica
Juliano Belletti,2,146.0,1,0,1,1,2,Brazil
Julien Cools,1,130.0,0,0,2,0,2,Belgium
Julien Escudé,0,55.0,1,0,0,1,1,France
Julien Nsengiyumva,0,75.0,0,0,1,0,1,Rwanda
Julinho,1,69.0,0,0,1,0,1,Brazil
Julio Abbadie,5,250.0,0,0,0,5,5,Scotland
Julio Asad,0,11.0,0,0,0,1,1,Brazil
Julio Crisosto,0,78.0,0,0,2,0,2,Chile
Julio César Baldivieso,0,529.0,0,3,8,3,11,Argentina
Julio César Britos,3,182.0,0,0,0,3,3,Colombia
Julio César Cortés,1,75.0,0,0,1,1,2,France
Julio César Cáceres,0,54.0,0,0,1,0,1,Paraguay
Julio César Enciso,0,62.0,0,0,0,1,1,Venezuela
Julio César Romero,1,563.0,0,0,6,4,10,Brazil
Julio César Uribe,0,197.0,0,1,1,2,3,Peru
Julio César de Andrade Moura,0,75.0,0,0,1,1,2,Peru
Julio César de León,1,457.0,0,1,4,4,8,Haiti
Julio Dely Valdés,0,582.0,0,1,6,5,11,Belize
Julio Enrique Martínez,0,100.0,0,0,1,1,2,El Salvador
Julio Francia,4,219.0,0,1,4,0,4,Argentina
Julio Gallardo,2,55.0,0,0,2,1,3,Chile
Julio Libonatti,1,158.0,0,0,4,0,4,Argentina
Julio Meléndez,0,10.0,1,0,0,1,1,Peru
Julio Montero Castillo,0,44.0,0,0,1,0,1,Uruguay
Julio Morales,0,168.0,0,1,2,0,2,Uruguay
Julio Palacios Lozano,0,22.0,0,0,1,0,1,El Salvador
Julio Pérez,2,137.0,0,0,0,2,2,Bolivia
Julio Ramírez,1,5.0,0,0,0,1,1,Chile
Julio Rodas,2,93.0,0,0,2,0,2,Guatemala
Julio Salinas,3,471.0,0,0,4,10,14,Northern Ireland
Julio Valentín González,1,29.0,0,0,0,1,1,Brazil
Julio dos Santos,1,85.0,0,1,0,1,1,Costa Rica
Julius Aghahowa,4,639.0,0,0,5,5,10,Nigeria
Julius James,0,26.0,1,0,1,0,1,Costa Rica
Julius Owino,0,8.0,0,0,1,0,1,Kenya
Julián Álvarez,4,256.0,0,0,3,2,5,Ecuador
Juma Darwish Al-Mashri,0,87.0,0,0,1,0,1,Oman
Juma Marzouq,1,44.0,0,0,0,1,1,Hong Kong
Juma Mkambi,0,54.0,0,0,0,1,1,Nigeria
Jumah Salem Joher,0,32.0,0,0,1,0,1,Qatar
Junaedi Abdillah,1,70.0,0,0,0,1,1,Thailand
Jung Jae-Kwon,0,76.0,0,0,1,0,1,South Korea
Jung Woo-young,0,82.0,0,0,0,1,1,Turkmenistan
Jung Yong-Hwan,0,30.0,0,0,0,1,1,Japan
Junichi Inamoto,0,118.0,0,0,2,0,2,Japan
Juninho Bacuna,0,36.0,0,0,2,0,2,Curaçao
Juninho Paulista,0,28.0,0,0,0,1,1,Venezuela
Juninho Pernambucano,2,159.0,0,0,1,2,3,Brazil
Junior Agogo,2,387.0,0,0,5,2,7,Ghana
Junior Bukaudi,1,49.0,0,0,1,0,1,Fiji
Junior Flemmings,1,87.0,0,0,0,1,1,Guadeloupe
Junior Hoilett,7,463.0,0,2,4,4,8,Jamaica
Junior Kabananga,3,112.0,0,0,1,2,3,DR Congo
Junior Michael,1,198.0,0,1,2,1,3,American Samoa
Junior Pukoku,1,13.0,0,0,1,0,1,Cook Islands
Junya Ito,0,361.0,0,0,4,2,6,Japan
Juozas Gudelis,0,79.0,0,0,0,1,1,Latvia
Jupp Heynckes,0,224.0,0,0,4,0,4,Germany
Juraj Kucka,0,225.0,1,0,4,3,7,Slovakia
Juraj Piroska,0,54.0,0,0,0,1,1,North Macedonia
Juraj Szikora,0,15.0,0,0,0,1,1,Republic of Ireland
Jurgen Cavens,0,83.0,0,0,0,1,1,Latvia
Jurgen Degabriele,0,90.0,0,0,0,1,1,Cyprus
Jurgen Kohler,0,55.0,1,0,0,1,1,Germany
Jurica Jerković,0,47.0,0,0,1,1,2,Yugoslavia
Jurijs Ševļakovs,0,119.0,0,0,2,0,2,Latvia
Jurijs Žigajevs,0,44.0,0,0,1,0,1,Latvia
Juris Laizāns,0,500.0,0,1,4,5,9,Poland
Juriën Gaari,1,90.0,0,0,0,1,1,Jamaica
Just Fontaine,13,980.0,0,0,20,1,21,France
Justas Lasickas,0,18.0,0,0,1,0,1,Lithuania
Justin Cochrane,0,47.0,0,0,0,1,1,United States Virgin Islands
Justin Donawa,0,127.0,0,0,0,2,2,Bahamas
Justin Manao,1,116.0,0,0,1,1,2,Tonga
Justin Meram,1,158.0,0,1,1,2,3,Iraq
Justo Jacquet,0,34.0,0,0,1,0,1,Paraguay
Justo Ruiz,0,129.0,0,2,2,0,2,Andorra
Juvenal Edjogo-Owono,0,276.0,0,3,4,2,6,South Africa
Juvenal Olmos,2,53.0,0,0,1,1,2,Bolivia
Juvencio Osorio,0,61.0,0,0,2,0,2,Paraguay
Jyn Tson,0,90.0,0,0,1,0,1,Taiwan
Jyrki Nieminen,0,128.0,0,0,1,1,2,England
Jádson,1,38.0,0,0,1,0,1,Brazil
Jákup Thomsen,0,90.0,0,0,0,1,1,Malta
Ján Greguš,0,41.0,0,0,0,1,1,Malta
Ján Kapko,0,65.0,1,0,1,0,1,Italy
Ján Kozák,0,421.0,0,0,3,4,7,Czechoslovakia
Ján Čapkovič,0,223.0,0,0,0,4,4,Wales
Ján Ďurica,0,354.0,3,1,3,3,6,Germany
Ján Švehlík,1,8.0,0,0,1,0,1,Czechoslovakia
János Farkas,1,381.0,0,0,8,2,10,Hungary
János Göröcs,0,240.0,0,0,3,1,4,Russia
János Hrutka,0,82.0,0,0,1,0,1,Hungary
János Mátyus,0,83.0,0,0,1,1,2,Hungary
Jérémie Boga,1,90.0,0,0,0,1,1,Malawi
Jérémy Doku,0,42.0,0,0,1,0,1,Belgium
Jérémy Ménez,0,53.0,0,0,0,1,1,Ukraine
Jérôme Boateng,1,8.0,0,0,1,0,1,Germany
Jérôme Doté,0,80.0,0,0,1,0,1,Togo
Jérôme Lèbre Mamahou,0,115.0,0,0,3,0,3,Ivory Coast
Jérôme Rothen,0,66.0,0,0,0,1,1,Faroe Islands
Jóan Símun Edmundsson,0,195.0,0,0,1,3,4,Estonia
Jóhann Berg Guðmundsson,0,283.0,0,0,2,4,6,Switzerland
Jóhannes Eðvaldsson,0,12.0,0,0,1,0,1,Iceland
Jón Dagur Þorsteinsson,0,54.0,0,0,0,1,1,North Macedonia
Jón Daði Böðvarsson,1,175.0,1,0,4,0,4,Iceland
Jón Rói Jacobsen,0,30.0,1,0,1,0,1,Serbia
Józef Wandzik,0,53.0,1,0,1,0,1,Romania
József Bencsics,1,69.0,0,0,1,0,1,Hungary
József Bozsik,1,57.0,0,0,2,0,2,Hungary
József Horváth,0,18.0,0,0,0,1,1,Luxembourg
József Kardos,0,89.0,0,0,1,1,2,Greece
József Kiprich,0,479.0,0,2,5,6,11,Austria
József Nemes,0,126.0,0,0,3,0,3,Hungary
József Pecsovszky,0,50.0,0,0,2,0,2,Romania
József Póczik,0,158.0,0,0,0,3,3,Luxembourg
József Sebők,0,17.0,0,0,1,0,1,Hungary
József Solti,0,133.0,0,0,2,0,2,Hungary
József Szalma,0,15.0,0,0,0,1,1,Cyprus
József Tóth,2,125.0,0,0,1,1,2,Germany
József Varga,1,27.0,0,0,0,1,1,Belgium
Jô,0,180.0,0,0,2,0,2,Brazil
Jörgen Pettersson,0,53.0,0,0,1,0,1,Sweden
Jørgen Kristensen,0,75.0,0,0,1,0,1,Denmark
Jørn Andersen,0,90.0,0,0,1,1,2,Norway
Júlio Baptista,3,180.0,0,0,2,3,5,Chile
Júlio Botelho,6,343.0,0,0,4,4,8,Bolivia
Júlio Tavares,2,132.0,0,0,1,2,3,Central African Republic
Július Šimon,0,154.0,0,1,3,0,3,Slovakia
Júnior Alonso,1,119.0,0,0,1,1,2,Paraguay
Júnior Baiano,1,66.0,0,0,1,0,1,Brazil
Júnior Díaz,0,16.0,0,0,1,0,1,Costa Rica
Júnior Izaguirre,1,42.0,0,0,0,1,1,Uruguay
Júnior Moraes,0,80.0,0,0,1,0,1,Ukraine
Jürgen Damm,0,72.0,0,0,0,1,1,Honduras
Jürgen Grabowski,0,191.0,0,0,2,1,3,Germany
Jürgen Heun,0,71.0,0,0,1,0,1,German DR
Jürgen Klinsmann,15,1357.0,0,2,19,11,30,Germany
Jürgen Nöldner,0,126.0,0,0,2,1,3,German DR
Jürgen Pommerenke,0,48.0,0,0,0,1,1,Iceland
Jürgen Sparwasser,0,454.0,0,0,4,3,7,German DR
Jānis Ikaunieks,0,40.0,0,0,1,0,1,Latvia
K. Appalaraju,1,2.0,0,0,1,0,1,India
Kaan Ayhan,0,182.0,0,0,2,1,3,Turkey
Kaba Diawara,2,348.0,0,0,5,2,7,Guinea
Kabamba Musasa,0,86.0,0,0,1,0,1,DR Congo
Kabasu Babo,1,51.0,0,0,0,1,1,Nigeria
Kabeu,1,22.0,0,0,1,0,1,New Caledonia
Kadell Daniel,1,54.0,0,0,1,0,1,Guyana
Kader Mangane,0,67.0,0,0,1,0,1,Senegal
Kadhim Waal,1,84.0,0,0,1,0,1,Iraq
Kagiso Dikgacoi,0,99.0,0,0,2,0,2,South Africa
Kahraba,1,88.0,0,0,1,0,1,Egypt
Kai Haaskivi,0,143.0,0,0,0,2,2,Italy
Kai Havertz,2,347.0,0,0,3,4,7,Germany
Kai Pahlman,0,80.0,0,1,1,1,2,Finland
Kai Sjøberg,0,66.0,0,0,1,0,1,Norway
Kaies Ghodhbane,1,236.0,0,0,1,3,4,Zambia
Kaimar Saag,0,180.0,0,0,2,0,2,Estonia
Kairat Ashirbekov,0,47.0,0,0,1,0,1,Kazakhstan
Kairat Nurdauletov,0,172.0,0,2,2,1,3,Belgium
Kais Yâakoubi,0,82.0,0,0,1,0,1,Tunisia
Kaiser Hamid,1,148.0,0,1,2,0,2,Bangladesh
Kaitano Tembo,0,47.0,0,0,1,0,1,Zimbabwe
Kaj Poulsen,0,4.0,0,0,0,1,1,Wales
Kakha Gogoladze,3,177.0,0,0,1,3,4,Taiwan
Kakha Kaladze,0,122.0,2,0,0,2,2,Georgia
Kakhaber Tskhadadze,0,68.0,0,0,1,0,1,Georgia
Kakhi Asatiani,1,120.0,0,0,0,3,3,Turkey
Kakoko Etepé,2,309.0,0,0,3,4,7,Mali
Kaká,6,829.0,0,2,8,9,17,Colombia
Kalaje Gnipate,1,44.0,0,0,1,0,1,New Caledonia
Kalen Damessi,0,8.0,0,0,1,0,1,Togo
Kalevi Lehtovirta,0,187.0,0,0,3,0,3,Finland
Kalidou Koulibaly,1,70.0,0,0,0,1,1,Ecuador
Kalifa Coulibaly,1,106.0,0,0,1,1,2,Rwanda
Kalin Bankov,0,76.0,0,0,1,0,1,Bulgaria
Kaliova Bulinaceva,0,15.0,0,0,0,1,1,Vanuatu
Kalu Uche,2,28.0,0,0,1,1,2,Greece
Kalusha Bwalya,10,1104.0,0,2,11,8,19,Zambia
Kama Dumbuya,0,105.0,0,0,2,0,2,Sierra Leone
Kamal Abdel Wahab,1,37.0,0,0,0,1,1,Congo
Kamal Kamyabinia,0,32.0,0,0,0,1,1,Guam
Kamel Gabsi,1,60.0,0,0,0,1,1,Cameroon
Kamel Seddik,0,42.0,1,0,1,0,1,Libya
Kameli Kilalwaca,1,54.0,0,0,1,0,1,Fiji
Kamil Al Aswad,0,166.0,0,0,3,1,4,Bahrain
Kamil Glik,0,328.0,1,0,3,2,5,Poland
Kamil Grosicki,2,170.0,0,0,4,4,8,Gibraltar
Kamil Jóźwiak,0,72.0,0,0,0,2,2,Hungary
Kamil Kopúnek,1,89.0,0,0,1,0,1,Slovakia
Kamil Kosowski,0,88.0,0,0,3,0,3,Poland
Kamil Zayatte,0,166.0,0,0,1,1,2,Guinea
Kamilou Daouda,0,157.0,0,0,2,0,2,Niger
Kamo Hovhannisyan,0,44.0,1,0,0,2,2,Armenia
Kamunda Tshinabu,0,88.0,0,1,1,0,1,DR Congo
Kamuran Yavuz,0,15.0,0,0,0,1,1,Germany
Kanat Sardarov,1,76.0,0,0,1,0,1,Kyrgyzstan
Kandia Traoré,1,168.0,0,0,0,2,2,Congo
Kane Crichlow,3,179.0,0,0,2,1,3,Canada
Kang Chul,0,51.0,0,0,1,0,1,South Korea
Kanga Akalé,0,86.0,0,0,0,2,2,Sudan
Kanika Matondo,0,90.0,0,0,0,1,1,Congo
Kanku Mulekelayi,0,79.0,0,0,0,1,1,Ivory Coast
Kanlaya Sysomvang,0,112.0,0,1,1,0,1,Laos
Kaoru Mitoma,0,179.0,0,0,0,2,2,Australia
Kara Mbodji,2,180.0,0,0,1,2,3,South Africa
Karapet Mikaelyan,0,91.0,0,0,2,0,2,Armenia
Karel Geraerts,0,109.0,0,0,1,2,3,Lithuania
Karel Jarolím,0,35.0,0,0,1,0,1,Czechoslovakia
Karel Kula,0,67.0,0,0,1,0,1,Czechoslovakia
Karel Poborský,2,271.0,0,2,5,1,6,Czech Republic
Karen Dokhoyan,0,60.0,0,0,1,0,1,Armenia
Kari Ukkonen,0,59.0,0,0,1,1,2,Wales
Karim Abdul Razak,0,112.0,0,0,2,0,2,Ghana
Karim Adeyemi,0,90.0,0,0,1,0,1,Germany
Karim Ansarifard,4,888.0,0,2,10,4,14,Iran
Karim Bagheri,12,1594.0,0,1,15,17,32,Saudi Arabia
Karim Bavi,0,62.0,0,0,0,3,3,Qatar
Karim Bellarabi,1,57.0,0,0,0,1,1,Gibraltar
Karim Benzema,7,1035.0,0,2,11,8,19,Faroe Islands
Karim Boudiaf,0,134.0,0,0,1,2,3,Hong Kong
Karim Haggui,1,163.0,0,0,2,1,3,Tunisia
Karim Kamanzi,1,90.0,0,0,1,0,1,Rwanda
Karim Maroc,1,73.0,0,0,1,0,1,Algeria
Karim Matmour,1,99.0,0,0,1,1,2,Algeria
Karim Mohammed Allawi,1,76.0,0,0,1,0,1,Iraq
Karim Saddam,1,88.0,0,0,1,0,1,Iraq
Karim Ziani,0,154.0,0,2,3,0,3,Algeria
Karl Brauneder,0,81.0,0,0,1,0,1,Austria
Karl Hohmann,2,258.0,0,0,2,3,5,Luxembourg
Karl Kodat,0,11.0,0,0,0,1,1,Republic of Ireland
Karl Koller,1,62.0,0,0,2,0,2,Austria
Karl Namnganda,0,90.0,0,0,0,1,1,Nigeria
Karl Odermatt,0,324.0,0,0,3,3,6,Romania
Karl Sesta,1,54.0,0,0,1,0,1,Austria
Karl Skerlan,0,60.0,0,0,1,0,1,Austria
Karl Stotz,0,89.0,0,1,1,0,1,Austria
Karl Toko Ekambi,0,416.0,0,0,7,1,8,Cameroon
Karl Zischek,1,110.0,0,0,2,0,2,Austria
Karl-Erik Palmér,3,223.0,0,0,1,5,6,Republic of Ireland
Karl-Heinz Riedle,2,447.0,0,0,3,5,8,Finland
Karl-Heinz Rummenigge,10,1719.0,0,3,25,7,32,Germany
Karl-Heinz Schnellinger,1,90.0,0,0,1,0,1,Germany
Karlen Mkrtchyan,0,30.0,0,0,0,1,1,Czech Republic
Karlheinz Förster,0,126.0,0,0,1,1,2,Germany
Karol Dobiaš,1,25.0,0,0,1,0,1,Czechoslovakia
Karol Jokl,1,329.0,0,0,3,3,6,Czechoslovakia
Karol Kisel,0,54.0,0,0,0,1,1,Luxembourg
Karol Linetty,1,179.0,0,0,2,1,3,Poland
Karol Świderski,0,252.0,0,0,3,2,5,Poland
Karrar Jassim,3,113.0,0,0,3,0,3,Iraq
Kaspars Gorkšs,0,249.0,0,0,0,5,5,Denmark
Kasper Dolberg,3,341.0,0,1,4,4,8,Kazakhstan
Kasper Hämäläinen,0,232.0,0,0,5,0,5,Finland
Kasper Lorentzen,0,81.0,0,0,1,0,1,Denmark
Kassahun Teka,0,79.0,0,1,0,1,1,Zambia
Kassaly Daouda,0,53.0,1,0,1,0,1,Angola
Kassim M'Dahoma,0,10.0,1,0,1,0,1,Togo
Kassoum Ouédraogo,0,154.0,0,2,3,0,3,Burkina Faso
Kastriot Dermaku,0,32.0,0,0,1,0,1,Albania
Kasun Jayasuriya,2,113.0,0,0,3,0,3,Sri Lanka
Katlego Mashego,1,90.0,0,0,0,1,1,Central African Republic
Katlego Mphela,1,364.0,0,0,4,1,5,Tunisia
Katsuyoshi Shinto,0,19.0,0,0,1,0,1,Japan
Kaveh Rezaei,2,167.0,0,0,0,2,2,Cambodia
Kazi Salahuddin,1,60.0,0,1,0,1,1,North Korea
Kazimierz Deyna,4,631.0,0,2,9,5,14,Poland
Kazushi Kimura,2,291.0,0,0,4,3,7,Singapore
Kazuyoshi Miura,10,1519.0,0,1,23,7,30,Japan
Kebede Asfaw,0,65.0,0,0,0,1,1,Sudan
Kebede Metaferia,0,31.0,0,0,0,1,1,Israel
Kees Kist,2,229.0,0,1,3,1,4,Netherlands
Kees Rijvers,0,54.0,0,0,1,0,1,Netherlands
Kees van Kooten,2,151.0,0,0,1,3,4,Cyprus
Kei Kamara,0,93.0,0,0,2,0,2,Sierra Leone
Keidi Bare,0,34.0,0,0,0,1,1,Moldova
Keiji Tamada,3,372.0,0,0,3,4,7,Bahrain
Keijo Kousa,0,169.0,0,0,2,0,2,Finland
Keiran Murtagh,0,90.0,0,0,1,0,1,Antigua and Barbuda
Keisuke Honda,11,920.0,0,7,12,9,21,Japan
Keita Baldé,1,135.0,0,0,3,0,3,Senegal
Keita Karamokoba,0,71.0,0,0,0,1,1,DR Congo
Keita Suzuki,0,8.0,1,0,1,0,1,Vietnam
Keith Andrews,0,13.0,0,0,0,1,1,Estonia
Keith Fahey,0,76.0,0,0,0,1,1,Armenia
Keith Fletcher,0,201.0,0,0,3,0,3,Grenada
Keith Gillespie,0,140.0,1,0,2,1,3,Austria
Keith Gumbs,0,370.0,0,2,5,2,7,Saint Kitts and Nevis
Keith Mackay,0,48.0,0,0,1,0,1,New Zealand
Keith Nelson,0,192.0,0,0,6,1,7,New Zealand
Keith O'Neill,0,9.0,0,0,0,1,1,Liechtenstein
Keith Rowland,0,36.0,0,0,1,0,1,Northern Ireland
Keithroy Cornelius,0,51.0,0,0,0,1,1,Curaçao
Keithroy Freeman,0,135.0,0,1,2,2,4,Bahamas
Kelechi Emeteole,0,63.0,0,0,1,0,1,Nigeria
Kelechi Iheanacho,1,215.0,0,0,4,1,5,Zambia
Kelly Peters,0,85.0,0,0,0,1,1,Bahamas
Kelvin Mutale,0,92.0,0,0,2,2,4,Zambia
Kelvin Sebwe,2,232.0,0,1,3,3,6,DR Congo
Kelvyn Peters,0,6.0,0,0,1,0,1,Dominica
Kelyn Rowe,0,56.0,0,0,1,0,1,United States
Kema Jack,1,85.0,0,0,1,0,1,Papua New Guinea
Kemar Lawrence,1,88.0,0,0,0,1,1,Mexico
Kemar Roofe,0,38.0,0,0,0,1,1,Honduras
Kembo Uba Kembo,0,253.0,0,0,6,0,6,DR Congo
Ken Boden,0,31.0,0,0,0,1,1,New Zealand
Ken Naganuma,0,16.0,0,0,1,0,1,Japan
Kenan Karaman,0,85.0,0,0,1,1,2,Turkey
Kenan Kodro,1,65.0,0,0,0,1,1,Gibraltar
Kenan Simambe,0,84.0,0,0,1,0,1,Zambia
Kendall Velox,0,285.0,0,0,0,5,5,Saint Kitts and Nevis
Kendall Waston,1,214.0,0,0,1,2,3,Honduras
Kengo Nakamura,0,230.0,0,0,1,2,3,Thailand
Kenji Gorré,2,147.0,0,0,0,2,2,British Virgin Islands
Kenlyn Gonsalves,0,88.0,0,0,1,1,2,Saint Vincent and the Grenadines
Kennedy Chihuri,0,16.0,0,0,1,0,1,Zimbabwe
Kennedy Mweene,1,85.0,0,1,1,0,1,Zambia
Kennedy Phillip,0,39.0,0,0,1,0,1,Grenada
Kennedy Simiyu,0,30.0,0,0,1,1,2,Kenya
Kennet Andersson,5,852.0,0,2,7,9,16,Sweden
Kenneth Brylle Larsen,1,60.0,0,0,1,0,1,Denmark
Kenneth Hughes,0,69.0,0,1,1,0,1,Anguilla
Kenneth Kluivert,0,31.0,0,0,1,0,1,Suriname
Kenneth Malitoli,4,263.0,0,0,3,2,5,Zambia
Kenneth Olayombo,0,81.0,0,0,2,0,2,Nigeria
Kenneth Omeruo,1,73.0,0,0,1,0,1,Nigeria
Kenneth Thompson,0,21.0,0,0,0,1,1,Antigua and Barbuda
Kenny Cooper,0,250.0,0,1,3,0,3,United States
Kenny Dalglish,3,582.0,0,0,8,6,14,Scotland
Kenny McLean,0,4.0,0,0,0,1,1,San Marino
Kenny Miller,0,389.0,0,1,8,3,11,Scotland
Kenny Rocha Santos,0,76.0,1,0,0,1,1,Cape Verde
Kenny Sansom,0,88.0,0,0,1,0,1,England
Kenroy Skinner,0,33.0,0,0,0,1,1,Saint Kitts and Nevis
Kensuke Nagai,0,40.0,0,0,1,0,1,Japan
Kent Nielsen,0,59.0,0,0,2,0,2,Denmark
Kenta Hasegawa,0,24.0,0,0,1,0,1,Japan
Kento Hashimoto,0,51.0,0,0,1,0,1,Japan
Kentoine Jennings,0,130.0,0,0,1,1,2,Antigua and Barbuda
Kenwin McPhee,1,73.0,0,0,2,0,2,Saint Lucia
Kenwyne Jones,5,723.0,1,1,6,5,11,Trinidad and Tobago
Kenzo Huur,2,167.0,0,0,0,2,2,Montserrat
Keo Sokpheng,0,33.0,0,0,1,0,1,Cambodia
Keon Daniel,1,289.0,0,0,2,4,6,Cuba
Kerbi Rodríguez,0,64.0,0,0,1,0,1,Dominican Republic
Kerem Aktürkoğlu,0,39.0,0,0,2,1,3,Turkey
Kerem Demirbay,1,48.0,0,0,1,0,1,Germany
Kermit Erasmus,0,28.0,0,0,1,0,1,South Africa
Keron Cummings,2,122.0,0,0,2,0,2,Trinidad and Tobago
Kerry Baptiste,0,170.0,0,1,2,1,3,Honduras
Kerry Jamerson,0,72.0,0,0,1,0,1,Trinidad and Tobago
Kerry Skepple,0,103.0,0,0,3,0,3,Antigua and Barbuda
Kervens Belfort,0,308.0,0,1,3,2,5,United States Virgin Islands
Kervin Severino,0,99.0,0,1,2,0,2,Dominican Republic
Keung He-chi,1,78.0,0,0,1,0,1,Hong Kong
Kevin Archer,0,48.0,0,0,0,1,1,Suriname
Kevin Davies,0,109.0,0,0,1,1,2,Anguilla
Kevin De Bruyne,2,877.0,0,1,11,7,18,Serbia
Kevin Doyle,1,310.0,0,0,3,6,9,Republic of Ireland
Kevin Edward,0,20.0,0,0,0,1,1,Aruba
Kevin Gallacher,0,379.0,0,0,5,4,9,Estonia
Kevin Gameiro,0,82.0,0,0,2,0,2,France
Kevin Holness,2,90.0,0,0,2,0,2,Canada
Kevin Kampl,0,68.0,0,0,2,0,2,Slovenia
Kevin Keegan,0,385.0,0,1,6,7,13,Cyprus
Kevin Kilbane,1,368.0,1,0,3,4,7,Andorra
Kevin Kurányi,0,274.0,0,0,4,2,6,Germany
Kevin Lafrance,0,105.0,0,0,0,2,2,Curaçao
Kevin López,0,65.0,0,0,0,1,1,Panama
Kevin McKenna,3,224.0,0,0,2,2,4,Haiti
Kevin Mirallas,0,233.0,0,0,1,3,4,Belgium
Kevin Molino,2,367.0,0,0,3,3,6,Bermuda
Kevin Moran,0,138.0,0,0,2,0,2,Republic of Ireland
Kevin Muscat,4,372.0,0,4,8,1,9,Australia
Kevin Nemia,1,28.0,0,0,1,0,1,New Caledonia
Kevin O'Callaghan,0,35.0,0,0,1,0,1,Republic of Ireland
Kevin O'Flanagan,1,62.0,0,0,1,0,1,Republic of Ireland
Kevin Sheedy,1,234.0,0,0,3,1,4,Republic of Ireland
Kevin Strootman,0,54.0,0,0,1,1,2,Finland
Kevin Vandenbergh,0,100.0,0,0,2,0,2,Belgium
Kevin Volland,0,85.0,0,0,0,1,1,San Marino
Kevin Weymouth,0,74.0,0,0,1,0,1,New Zealand
Kevin Wilson,1,63.0,0,0,2,2,4,Faroe Islands
Kevin Wimmer,0,45.0,1,0,0,1,1,Austria
Kevin-Prince Boateng,1,93.0,0,0,0,2,2,United States
Kewullay Conteh,0,45.0,0,0,2,0,2,Sierra Leone
Keysher Fuller,1,82.0,0,0,0,2,2,United States
Khader Yousef,0,63.0,0,0,0,1,1,Malaysia
Khaibar Amani,2,129.0,0,0,2,0,2,Afghanistan
Khairul Amri,0,157.0,0,0,2,1,3,Singapore
Khalaf Al-Mutairi,1,142.0,0,0,1,1,2,Kyrgyzstan
Khalaf Al-Salamah,0,75.0,0,0,1,0,1,Kuwait
Khaled Adénon,0,2.0,0,0,1,0,1,Benin
Khaled Al Zaher,2,343.0,0,0,3,2,5,Syria
Khaled Al-Doseri,0,43.0,0,0,2,0,2,Bahrain
Khaled Awad,0,156.0,0,0,1,1,2,Jordan
Khaled Badra,1,289.0,0,2,3,3,6,Namibia
Khaled Elfallah,0,105.0,0,0,2,0,2,Libya
Khaled Hamieh,0,88.0,0,0,0,1,1,Vietnam
Khaled Korbi,1,34.0,0,0,0,1,1,Morocco
Khaled Lounici,1,2.0,0,0,0,1,1,Burkina Faso
Khaled Massad,5,742.0,0,3,9,5,14,Saudi Arabia
Khaled Mhemed,0,81.0,0,0,1,0,1,Libya
Khaled Mobayed,0,30.0,0,0,0,1,1,Philippines
Khaled Mouelhi,1,30.0,0,1,0,1,1,Togo
Khaled Saad,1,90.0,0,0,1,0,1,Jordan
Khaleel Mubarak,2,107.0,0,0,1,1,2,China PR
Khaleem Hyland,1,231.0,0,0,2,1,3,Trinidad and Tobago
Khalfan Ibrahim,3,410.0,0,2,5,4,9,Qatar
Khalfan Mubarak,0,41.0,0,0,1,0,1,United Arab Emirates
Khalfan Ngassa,0,74.0,0,0,1,0,1,Tanzania
Khalid Ahmed Elmustafa,0,81.0,0,0,2,0,2,Sudan
Khalid Al-Hajri,2,205.0,0,0,0,3,3,Bangladesh
Khalid Al-Temawi,3,66.0,0,2,2,1,3,Saudi Arabia
Khalid Bakhit,0,84.0,0,0,1,1,2,Sierra Leone
Khalid Boutaïb,1,206.0,0,0,4,1,5,Morocco
Khalid Ismaïl,2,127.0,0,0,1,3,4,United Arab Emirates
Khalid Labied,3,212.0,0,0,1,3,4,Ghana
Khalid Mohammed Sabbar,1,69.0,0,0,0,1,1,Iran
Khalid Raghib,0,172.0,0,0,3,0,3,Morocco
Khalid Salman,2,286.0,0,2,3,1,4,Qatar
Khalifa Al-Sulaiti,1,20.0,0,0,0,1,1,China PR
Khalifa Ayil,0,78.0,0,0,2,0,2,Oman
Khalifa Khalifa,0,11.0,0,0,1,0,1,Libya
Khalil Al-Malki,5,368.0,0,0,2,5,7,Qatar
Khalil Allawi,2,122.0,0,0,2,0,2,Iraq
Khalil Bani Attiah,0,45.0,0,0,1,0,1,Jordan
Khalil Ibrahim,0,40.0,0,0,1,0,1,United Arab Emirates
Khalilou Fadiga,1,125.0,0,1,2,2,4,Nigeria
Khama Billiat,1,130.0,0,0,1,1,2,Uganda
Khamees Saad Mubarak,3,548.0,0,0,6,2,8,United Arab Emirates
Khamis Al-Zahrani,0,46.0,0,0,1,0,1,Saudi Arabia
Khamis Eid,1,40.0,0,0,1,0,1,Bahrain
Khamis Eid Rafe Thani,3,107.0,0,0,2,1,3,Bahrain
Khamis Esmaeel,0,14.0,0,0,1,0,1,United Arab Emirates
Khamis Mubarak,2,73.0,0,0,0,2,2,India
Khampheng Sayavutthi,1,200.0,0,1,3,1,4,Laos
Khan Thatat Songwuti,1,72.0,0,0,0,1,1,Malaysia
Khandoker Wasim Iqbal,0,10.0,0,0,1,0,1,Bangladesh
Khano Smith,0,317.0,0,2,3,3,6,Bermuda
Khash-Erdene Tuya,0,39.0,1,0,1,0,1,Japan
Khemais Labidi,0,109.0,0,0,2,0,2,Tunisia
Khishigdalai Battulga,0,75.0,1,0,1,0,1,Maldives
Khodadad Azizi,5,501.0,0,0,4,6,10,Saudi Arabia
Khoren Bayramyan,0,74.0,0,0,1,0,1,Armenia
Khoren Oganesian,3,145.0,0,0,2,1,3,Russia
Khoun Laboravy,0,193.0,1,0,2,1,3,Cambodia
Khuda Muyaba,1,20.0,0,0,0,1,1,Ivory Coast
Khvicha Kvaratskhelia,0,260.0,0,0,3,1,4,Georgia
Khürelbaataryn Tsend-Ayuush,0,48.0,0,0,1,0,1,Mongolia
Ki Sung-yueng,2,251.0,1,2,2,6,8,North Korea
Kiatisuk Senamuang,5,795.0,0,0,11,4,15,Thailand
Kick Smit,1,244.0,0,0,4,1,5,Netherlands
Kidumu Mantantu,1,154.0,0,0,1,2,3,DR Congo
Kieffer Moore,0,153.0,0,0,2,3,5,Slovakia
Kieran Trippier,1,5.0,0,0,0,1,1,Croatia
Kiki Antenen,0,59.0,0,0,1,0,1,Switzerland
Kiko,1,145.0,0,0,2,1,3,Spain
Kily González,4,99.0,0,3,5,1,6,Uruguay
Kily Álvarez,0,90.0,0,0,1,0,1,Equatorial Guinea
Kim Bo-Kyung,0,78.0,0,0,2,0,2,South Korea
Kim Bok-man,1,20.0,0,0,1,0,1,North Korea
Kim Chi-Woo,0,176.0,0,0,1,1,2,South Korea
Kim Chol-Ho,0,43.0,0,0,0,1,1,Bahrain
Kim Christofte,1,2.0,0,1,0,1,1,Faroe Islands
Kim Do-heon,1,321.0,0,1,2,4,6,South Korea
Kim Do-hoon,4,244.0,1,0,3,4,7,South Korea
Kim Gwan-Mo,1,90.0,0,0,0,1,1,Syria
Kim Gwang-Un,1,90.0,0,0,0,1,1,Syria
Kim Ho-Kon,0,22.0,0,0,1,0,1,South Korea
Kim Jae-han,0,269.0,0,0,5,0,5,South Korea
Kim Jaggy,0,11.0,0,0,0,1,1,United States Virgin Islands
Kim Ji-sung,0,45.0,0,0,0,1,1,Hong Kong
Kim Jin-su,2,158.0,0,0,1,1,2,South Korea
Kim Jong-Boo,1,70.0,0,0,1,0,1,South Korea
Kim Jong-Min,1,53.0,0,0,1,0,1,North Korea
Kim Jong-man,1,88.0,0,0,1,0,1,North Korea
Kim Joo-sung,2,264.0,0,0,2,3,5,South Korea
Kim Jung-woo,0,116.0,0,0,1,1,2,Indonesia
Kim Ki-bok,0,8.0,0,0,1,0,1,South Korea
Kim Kuk-jin,0,10.0,0,0,1,0,1,North Korea
Kim Kwang-min,2,164.0,0,1,1,3,4,Hong Kong
Kim Kyong-il,2,131.0,0,0,2,0,2,North Korea
Kim Källström,0,426.0,0,1,7,3,10,Sweden
Kim Meng Leong,1,50.0,0,0,1,0,1,Macau
Kim Min-jae,2,92.0,0,0,1,1,2,Kyrgyzstan
Kim Nam-il,1,68.0,0,0,1,0,1,South Korea
Kim Pan-Keun,1,40.0,0,0,0,1,1,Iraq
Kim Pung-Il,1,139.0,0,0,3,0,3,North Korea
Kim Sang-sik,1,90.0,0,0,0,1,1,Iran
Kim Seung-il,2,93.0,0,0,0,2,2,Australia
Kim Shin-wook,0,285.0,0,1,6,1,7,Qatar
Kim Suk-won,0,36.0,0,0,1,0,1,South Korea
Kim Suominen,0,58.0,0,0,0,2,2,Sweden
Kim Tae-Young,0,107.0,0,0,2,0,2,South Korea
Kim Vilfort,2,615.0,0,0,8,3,11,Denmark
Kim Yong-Nam,3,257.0,0,0,3,0,3,North Korea
Kim Yong-Se,1,163.0,0,0,2,2,4,South Korea
Kim Yong-su,0,113.0,0,0,0,2,2,Thailand
Kim Young-gwon,3,285.0,0,0,5,0,5,South Korea
Kin Seng Chan,0,113.0,0,0,1,1,2,Thailand
Kingsley Black,0,42.0,0,0,1,0,1,Northern Ireland
Kingsley Coman,0,94.0,0,0,3,0,3,France
Kinitoni Falatau,1,90.0,0,0,1,0,1,Tonga
Kiril Despodov,0,110.0,0,0,1,1,2,Bulgaria
Kiril Milanov,0,71.0,0,0,1,0,1,Bulgaria
Kirk Broadfoot,0,18.0,0,0,0,1,1,Iceland
Kit Leong Cheong,1,28.0,0,0,0,1,1,Nepal
Kit Symons,0,163.0,0,0,2,0,2,Wales
Kiyika Tokodi,0,112.0,0,2,2,0,2,DR Congo
Kjell Kristiansen,0,78.0,0,0,1,0,1,Norway
Kjetil Hasund,0,145.0,0,0,0,2,2,Bulgaria
Kjetil Osvold,0,106.0,0,0,1,1,2,Cyprus
Kjetil Rekdal,2,966.0,0,6,11,4,15,Norway
Klaas Nuninga,0,5.0,0,0,1,0,1,Netherlands
Klaas-Jan Huntelaar,3,1345.0,0,2,19,7,26,Netherlands
Klas Ingesson,0,242.0,0,1,1,3,4,Sweden
Klaus Allofs,5,581.0,0,0,6,4,10,Germany
Klaus Berggreen,1,236.0,0,0,1,3,4,Luxembourg
Klaus Fichtel,0,37.0,0,0,1,0,1,Germany
Klaus Fischer,1,711.0,0,0,11,4,15,Wales
Klaus Toppmöller,0,43.0,0,0,1,0,1,Germany
Klaus-Dieter Sieloff,0,51.0,0,0,2,0,2,Germany
Kleanthis Vikelidis,2,133.0,0,1,1,2,3,Israel
Klemen Lavrič,0,147.0,0,1,1,4,5,Moldova
Klemi Saban,0,45.0,0,0,0,1,1,Moldova
Klodian Duro,0,142.0,0,0,2,1,3,Russia
Klæmint Olsen,0,259.0,0,0,2,2,4,Faroe Islands
Knory Scott,1,64.0,0,0,1,0,1,Bermuda
Knowledge Musona,2,212.0,0,1,3,2,5,Egypt
Knut Dahlen,0,15.0,0,0,1,0,1,Norway
Knut Hansson,0,120.0,0,0,0,2,2,Lithuania
Knut Kroon,1,86.0,0,0,1,1,2,Sweden
Ko Itakura,0,90.0,0,0,1,0,1,Japan
Ko Jae-wook,0,27.0,0,0,1,0,1,South Korea
Ko Jeong-woon,3,242.0,0,0,2,2,4,Iran
Ko Po Keung,0,118.0,0,0,2,0,2,Hong Kong
Kobenan Kouman,3,322.0,0,0,6,1,7,Ivory Coast
Kodjo Fo-Doh Laba,1,103.0,0,0,1,1,2,Togo
Koen Daerden,0,150.0,0,0,3,0,3,Belgium
Koffi Kossi,0,69.0,0,0,2,0,2,Togo
Koh Traoré,1,81.0,0,0,1,0,1,Burkina Faso
Koichi Hashiratani,0,47.0,0,0,0,1,1,Singapore
Koji Miyoshi,2,84.0,0,0,0,2,2,Uruguay
Koji Mori,1,19.0,0,0,0,1,1,Vietnam Republic
Koji Nakata,1,113.0,0,0,0,2,2,Bahrain
Koji Sasaki,0,26.0,0,0,0,1,1,South Korea
Kokos Antoniou,0,88.0,0,0,1,0,1,Cyprus
Kokouni Akpalo Gnavor,0,85.0,0,0,0,1,1,Senegal
Kolbeinn Sigþórsson,1,566.0,0,0,8,5,13,Iceland
Kole Hall,1,65.0,0,0,1,0,1,Bermuda
Kolo Touré,0,60.0,0,0,0,1,1,Morocco
Komlan Amewou,0,47.0,1,0,1,1,2,Libya
Komlan Assignon,1,52.0,0,1,1,1,2,Tunisia
Komron Tursunov,1,34.0,0,0,1,0,1,Tajikistan
Konan Yoboué,1,35.0,0,0,1,0,1,Ivory Coast
Konrad Laimer,0,106.0,0,0,1,1,2,Austria
Konstantin Gorovenka,1,238.0,0,0,3,0,3,Kazakhstan
Konstantin Vassiljev,0,784.0,0,2,7,7,14,Armenia
Konstantin Zyryanov,1,213.0,0,0,1,3,4,Greece
Konstantinos Galanopoulos,0,70.0,0,0,1,0,1,Greece
Konstantinos Laifis,0,85.0,0,0,2,0,2,Cyprus
Konstantinos Mitroglou,1,440.0,0,0,5,4,9,Greece
Koo Ja-cheol,6,523.0,0,1,8,4,12,South Korea
Koray Avcı,0,72.0,0,0,0,1,1,Georgia
Koriak Upaiga,0,67.0,0,0,1,0,1,Papua New Guinea
Korken Yenkibarian,1,82.0,0,0,0,1,1,Sri Lanka
Kornel Saláta,0,24.0,0,0,1,1,2,Latvia
Kossi Noutsoudje,0,138.0,0,0,2,0,2,Togo
Kosta Barbarouses,1,109.0,0,0,2,1,3,New Zealand
Kosta Tomašević,2,151.0,0,0,0,2,2,Switzerland
Kostadin Kostadinov,0,162.0,0,0,1,2,3,Finland
Kostakis Artymatas,0,75.0,0,0,0,1,1,San Marino
Kostas Aidiniou,0,80.0,0,0,1,0,1,Greece
Kostas Antoniou,0,51.0,0,0,1,1,2,Greece
Kostas Batsinilas,0,73.0,0,0,0,1,1,Cyprus
Kostas Davourlis,0,60.0,0,0,1,0,1,Greece
Kostas Eleftherakis,0,167.0,0,0,2,1,3,Portugal
Kostas Fortounis,1,241.0,0,1,1,3,4,Gibraltar
Kostas Foti,0,25.0,0,0,1,0,1,Cyprus
Kostas Frantzeskos,0,215.0,0,0,2,1,3,Greece
Kostas Iosifidis,0,47.0,0,0,1,0,1,Greece
Kostas Katsouranis,0,248.0,0,0,3,1,4,Greece
Kostas Konstantinidis,0,89.0,0,0,0,1,1,Slovenia
Kostas Mavridis,0,39.0,0,0,0,1,1,Denmark
Kostas Mitroglou,0,104.0,0,0,2,1,3,Greece
Kostas Nestoridis,0,28.0,0,0,0,1,1,Yugoslavia
Kostas Panayiotou,0,96.0,2,0,0,2,2,Cyprus
Kostas Stafylidis,0,65.0,0,0,1,1,2,Greece
Kouassi N'Dri,1,152.0,0,0,2,0,2,Ivory Coast
Kouch Sokumpheak,0,227.0,0,0,2,1,3,Cambodia
Kouligo Zoma,0,32.0,0,0,0,1,1,Mauritania
Kpah Sherman,1,86.0,0,0,1,0,1,Liberia
Krasimir Balakov,0,387.0,0,4,6,5,11,Finland
Krassimir Chomakov,0,108.0,0,0,2,0,2,Bulgaria
Kresten Bjerre,0,258.0,0,2,4,0,4,Denmark
Kris Bouckenooghe,0,27.0,0,0,0,1,1,Tahiti
Kris Boyd,0,104.0,0,1,4,0,4,Scotland
Kris Trajanovski,4,577.0,0,1,7,4,11,Tahiti
Krishanu Dey,0,119.0,0,0,1,1,2,Indonesia
Krissada Piandit,0,23.0,0,0,1,0,1,Thailand
Kristaps Grebis,0,76.0,0,0,1,0,1,Latvia
Kristen Nygaard,0,114.0,0,2,1,1,2,Denmark
Kristen Viikmäe,0,144.0,0,0,3,1,4,Estonia
Kristian Dimitrov,0,55.0,0,0,1,0,1,Bulgaria
Kristian Laferla,0,79.0,0,0,0,2,2,Estonia
Kristian Thorstvedt,0,109.0,0,0,1,2,3,Gibraltar
Kristján Örn Sigurðsson,0,155.0,0,0,2,0,2,Iceland
Kristofer Hæstad,0,31.0,0,0,1,0,1,Norway
Krisztián Kenesei,0,65.0,0,0,0,2,2,Sweden
Krisztián Lisztes,0,302.0,0,0,1,4,5,Lithuania
Krisztián Németh,0,199.0,0,0,1,2,3,Hungary
Kroekrit Thaweekarn,0,29.0,0,0,0,1,1,Vietnam
Krum Yanev,0,59.0,0,0,1,0,1,Bulgaria
Krzysztof Bukalski,0,74.0,0,1,1,0,1,Poland
Krzysztof Mączyński,0,17.0,0,0,2,0,2,Poland
Krzysztof Nowak,0,90.0,0,0,1,0,1,Poland
Krzysztof Piątek,0,355.0,0,0,2,4,6,Austria
Krzysztof Warzycha,0,211.0,0,1,2,1,3,Poland
Krépin Diatta,1,64.0,0,0,1,0,1,Senegal
Ku Kam Fai,0,60.0,0,0,0,1,1,China PR
Kubilay Türkyilmaz,0,1492.0,0,8,15,11,26,Luxembourg
Kudakwashe Mahachi,2,99.0,0,0,2,1,3,Algeria
Kuliwa Tshikalu,0,19.0,1,0,0,1,1,DR Congo
Kunishige Kamamoto,2,92.0,0,0,0,2,2,Vietnam Republic
Kunle Awesu,0,77.0,0,0,1,0,1,Nigeria
Kurapiah Gunalan,1,81.0,0,0,1,0,1,Malaysia
Kurniawan Dwi Yulianto,0,139.0,0,0,2,2,4,Indonesia
Kurt Frederick,0,155.0,0,1,1,1,2,Saint Lucia
Kurt Hamrin,0,478.0,0,0,5,2,7,Sweden
Kurt Jara,0,466.0,0,0,6,4,10,Austria
Kurt Liebrecht,0,80.0,0,1,1,0,1,German DR
Kurt Mørkøre,0,82.0,0,0,0,1,1,Luxembourg
Kurt Müller,0,189.0,0,0,1,2,3,Greece
Kurt Svanström,0,68.0,0,0,1,0,1,Sweden
Kurt Welzl,0,312.0,0,0,4,3,7,Austria
Kurt Zouma,0,60.0,0,0,0,1,1,Andorra
Kuyangana Makukula,0,47.0,0,0,0,1,1,Morocco
Kwadwo Asamoah,2,258.0,0,0,2,2,4,Mali
Kwak Tae-hwi,0,187.0,0,0,2,1,3,South Korea
Kwame Ayew,0,202.0,0,0,3,1,4,Ghana
Kwame Nti,1,43.0,0,0,1,0,1,Ghana
Kwame Quee,0,56.0,0,0,0,1,1,Liberia
Kwame Steede,0,101.0,0,0,1,1,2,Cayman Islands
Kwasi Owusu,4,358.0,0,1,2,6,8,DR Congo
Kwesi Appiah,1,44.0,0,0,1,0,1,Ghana
Kwok Ka-ming,3,252.0,0,0,1,3,4,Japan
Kwok Yue Hung,0,93.0,0,0,0,1,1,Malaysia
Kwon Chang-hoon,1,433.0,0,0,5,2,7,South Korea
Kyaw Ko Ko,1,32.0,0,0,1,0,1,Myanmar
Kyaw Zayar Win,0,85.0,0,0,0,1,1,Laos
Kyle Beckerman,0,49.0,0,0,1,0,1,United States
Kyle Lafferty,0,889.0,0,0,9,6,15,Northern Ireland
Kyle Lightbourne,0,97.0,0,0,1,1,2,Bermuda
Kyle Martino,0,51.0,0,0,1,0,1,United States
Kylian Mbappé,12,1368.0,0,2,15,6,21,France
Kyogo Furuhashi,0,171.0,0,0,3,0,3,Japan
Kypros Christoforou,0,51.0,1,0,1,0,1,Belgium
Kyriakos Papadopoulos,0,110.0,0,0,1,1,2,Greece
Kyrian Nwoko,0,13.0,0,0,1,0,1,Malta
Kálmán Kovács,0,147.0,0,0,1,3,4,Northern Ireland
Kálmán Mészöly,2,291.0,0,4,3,3,6,Hungary
Kári Reynheim,0,63.0,0,0,0,1,1,Northern Ireland
Kári Árnason,0,120.0,0,0,2,2,4,Sweden
Károly Csapó,0,9.0,0,0,0,1,1,Argentina
Károly Sándor,1,230.0,0,0,4,2,6,Hungary
Kévin Constant,1,15.0,0,1,1,0,1,Guinea
Kévin Denkey,0,77.0,0,0,0,1,1,Congo
Kévin Fortuné,2,137.0,0,0,1,1,2,Cuba
Kévin Parsemain,3,274.0,0,1,3,2,5,Martinique
Köbi Kuhn,0,132.0,0,1,2,1,3,Switzerland
Köksal Mesçi,0,79.0,0,1,1,0,1,Turkey
La'Vere Corbin-Ong,0,12.0,0,0,1,0,1,Malaysia
Labama Bokota,0,298.0,0,1,4,0,4,Rwanda
Lachezar Tanev,0,317.0,0,1,3,2,5,Belgium
Lacina Traoré,0,25.0,0,0,0,2,2,Gambia
Ladislao Kubala,0,152.0,0,0,1,3,4,Scotland
Ladislas Douniama,0,5.0,0,0,0,1,1,São Tomé and Príncipe
Ladislav Jurkemik,0,111.0,0,0,1,1,2,Italy
Ladislav Kačáni,0,29.0,0,0,0,1,1,Denmark
Ladislav Krejčí,0,56.0,0,0,0,1,1,Kazakhstan
Ladislav Kuna,0,232.0,0,0,2,2,4,Spain
Ladislav Novák,0,43.0,0,0,0,1,1,German DR
Ladislav Pavlovič,0,154.0,0,0,1,1,2,Czechoslovakia
Ladislav Petráš,2,150.0,0,0,3,2,5,Brazil
Ladislav Vízek,1,508.0,0,1,7,3,10,Czechoslovakia
Ladislav Šimůnek,0,189.0,0,0,3,0,3,Czechoslovakia
Lahcen Abrami,0,60.0,0,1,1,0,1,Morocco
Lahcen Chicha,0,64.0,0,0,0,1,1,Tunisia
Lai Wing-Cheung,0,11.0,0,0,1,1,2,Hong Kong
Laisiasa Gataurua,3,249.0,0,0,3,1,4,Fiji
Laith Hussein,8,406.0,0,0,9,3,12,Yemen
Lajos Csordás,0,91.0,0,0,2,0,2,Hungary
Lajos Détári,1,323.0,0,1,5,3,8,Netherlands
Lajos Kocsis,2,361.0,0,2,4,3,7,Hungary
Lajos Kű,0,53.0,0,1,0,1,1,Belgium
Lajos Puskás,0,68.0,0,0,1,0,1,Hungary
Lajos Szűcs,0,91.0,0,0,2,0,2,Hungary
Lajos Sătmăreanu,0,56.0,0,0,0,1,1,Hungary
Lajos Tichy,6,704.0,0,1,5,10,15,Norway
Lakhdar Belloumi,6,656.0,0,0,8,4,12,Algeria
Lakis Glezos,0,88.0,0,0,0,1,1,Bulgaria
Lakis Papaioannou,0,104.0,0,0,0,2,2,Hungary
Lalawélé Atakora,0,35.0,0,0,1,0,1,Togo
Lalaïna Nomenjanahary,1,103.0,0,0,1,2,3,Comoros
Lam Ka Wai,0,199.0,0,1,3,0,3,Hong Kong
Lamin Conteh,0,87.0,0,0,1,0,1,Sierra Leone
Lamine Diatta,1,141.0,0,0,1,1,2,Egypt
Lamnao Singto,0,74.0,0,0,2,0,2,Laos
Lancaster Joseph,0,50.0,0,0,0,1,1,Belize
Landon Donovan,7,2040.0,0,10,31,7,38,United States
Landry N'Guémo,1,64.0,0,0,1,0,1,Cameroon
Lantame Ouadja,1,66.0,0,0,1,1,2,Togo
Larbi Chebbak,1,81.0,0,0,1,0,1,Morocco
Larrymore Bedford,0,88.0,0,0,1,0,1,Saint Kitts and Nevis
Lars Bastrup,0,234.0,0,0,1,3,4,Scotland
Lars Bender,1,80.0,0,0,0,1,1,Denmark
Lars Bohinen,0,223.0,0,0,2,3,5,Cyprus
Lars Elstrup,1,123.0,0,0,2,1,3,Denmark
Lars Granström,0,49.0,0,0,0,2,2,Cyprus
Lars Jacobsen,0,7.0,0,0,0,1,1,Cyprus
Lars Krogh Gerson,0,129.0,0,1,2,1,3,Romania
Lars Olsen,0,13.0,0,0,1,0,1,Denmark
Lars Stindl,3,66.0,0,0,1,2,3,Australia
Laryea Kingston,1,82.0,0,0,1,1,2,Ghana
Lasaad Abdelli,0,37.0,0,0,1,0,1,Tunisia
Lascelles Dunkley,0,179.0,0,0,2,2,4,Jamaica
Lassana Fané,0,23.0,0,0,0,1,1,Ghana
Lasse Larsson,0,85.0,0,0,1,0,1,Sweden
Lasse Schøne,0,60.0,0,0,0,1,1,Iceland
Lasse Vibe,0,81.0,0,0,0,1,1,Albania
Lassina Dao,0,29.0,0,0,1,0,1,Ivory Coast
Lassina Diabaté,1,83.0,0,0,1,0,1,Ivory Coast
Lassina Traoré,1,76.0,0,1,0,1,1,Niger
Lau Wing Yip,1,516.0,0,0,5,4,9,Hong Kong
Laughter Chilembe,1,52.0,0,0,1,0,1,Zambia
Lauren,0,78.0,0,0,1,0,1,Cameroon
Laurent Blanc,2,552.0,0,0,6,3,9,France
Laurent Depoitre,0,64.0,0,0,0,1,1,Andorra
Laurent Grimmonprez,0,51.0,0,0,1,0,1,Belgium
Laurent Pokou,13,910.0,0,0,1,14,15,Algeria
Laurenţiu Roşu,0,156.0,0,0,2,1,3,Romania
Lauro Amado,1,29.0,0,0,1,0,1,Switzerland
Lautaro Martínez,6,484.0,0,0,6,7,13,Qatar
Lawrence Adjei,0,90.0,0,0,1,0,1,Ghana
Lawrence Harvey,1,41.0,1,0,0,1,1,Turks and Caicos Islands
Lawrence Reilly,0,82.0,0,0,1,1,2,Northern Ireland
Lawrence Shankland,0,65.0,0,0,1,0,1,Scotland
Lawrence Waya,0,51.0,0,0,1,0,1,Malawi
Lazar Marković,0,55.0,0,0,0,1,1,Wales
Lazar Tasić,0,87.0,0,0,1,0,1,Yugoslavia
Lazaros Christodoulopoulos,0,20.0,0,0,0,1,1,Lithuania
Lazarus Kaimbi,0,142.0,0,0,2,1,3,Djibouti
Le Huynh Duc,0,38.0,0,0,1,0,1,Vietnam
Leandro Bacuna,3,62.0,0,0,0,3,3,Honduras
Leandro Barreiro,0,45.0,0,0,1,0,1,Luxembourg
Leandro Machado,1,86.0,0,0,1,0,1,Brazil
Leandro Paredes,0,8.0,0,0,0,1,1,Colombia
Leandro Trossard,0,112.0,0,0,2,0,2,Belgium
Leart Paqarada,1,60.0,1,0,0,1,1,Kosovo
Ledian Memushaj,0,71.0,0,0,0,1,1,Israel
Lee Casciaro,0,136.0,0,0,1,2,3,Scotland
Lee Chun-soo,1,130.0,0,0,1,1,2,Vietnam
Lee Chung-yong,2,185.0,0,0,2,2,4,Argentina
Lee Dixon,0,9.0,0,0,1,0,1,England
Lee Dong-gook,11,986.0,0,1,12,6,18,South Korea
Lee Dong-gyeong,0,22.0,0,0,1,0,1,South Korea
Lee Eul-yong,0,9.0,0,0,1,0,1,South Korea
Lee Hak-Jong,1,31.0,0,0,0,1,1,Nepal
Lee Hoi-taek,1,59.0,0,0,0,1,1,Cambodia
Lee Jae-sung,2,176.0,0,0,2,2,4,Myanmar
Lee Jeong-hyeop,0,90.0,0,0,1,0,1,South Korea
Lee Jung-hyup,1,53.0,0,0,1,1,2,Australia
Lee Jung-il,1,7.0,0,0,0,1,1,Qatar
Lee Jung-soo,2,45.0,0,0,1,1,2,South Korea
Lee Kang-Jo,1,84.0,0,0,1,0,1,South Korea
Lee Keun-ho,1,569.0,0,0,4,5,9,South Korea
Lee Kin Wo,2,99.0,0,0,2,1,3,India
Lee McCulloch,0,10.0,0,0,1,0,1,Scotland
Lee Min-sung,1,161.0,0,0,1,1,2,Japan
Lee Sang-yoon,0,179.0,0,0,2,1,3,South Korea
Lee Soon-myung,0,79.0,0,0,0,1,1,Israel
Lee Tae-ho,6,531.0,0,2,4,5,9,South Korea
Lee Wai-Shan,0,30.0,0,0,1,0,1,Hong Kong
Lee Wilkie,0,71.0,0,0,1,0,1,Scotland
Lee Yi-woo,0,45.0,0,0,1,0,1,South Korea
Lee Young-Moo,0,116.0,0,0,0,2,2,Iran
Lee Young-jin,0,38.0,0,0,1,0,1,South Korea
Lee Young-pyo,1,166.0,0,0,3,0,3,South Korea
Leen Vente,1,216.0,0,0,2,1,3,Netherlands
Lefter Küçükandonyadis,2,239.0,0,1,3,2,5,Turkey
Lefteris Makris,0,89.0,0,0,0,1,1,Hungary
Leger Djime,1,109.0,0,0,1,1,2,Chad
Lehlohonolo Majoro,0,62.0,0,0,1,0,1,South Africa
Lehlohonolo Seema,1,90.0,0,0,1,0,1,Lesotho
Lehlomela Ramabele,0,82.0,0,0,1,0,1,Lesotho
Lei Clijsters,1,15.0,0,0,1,0,1,Belgium
Leif Engqvist,0,89.0,0,0,1,0,1,Sweden
Leif Eriksson,0,208.0,0,0,3,1,4,Sweden
Leigh Griffiths,0,258.0,0,0,3,1,4,Scotland
Leighton Baines,0,83.0,0,0,0,1,1,Moldova
Leighton James,0,375.0,0,2,5,2,7,Wales
Lejuan Simmons,1,60.0,0,0,1,0,1,Bermuda
Leng Makara,1,70.0,1,0,1,0,1,Syria
Lennart Bunke,0,192.0,0,0,4,0,4,Sweden
Lennart Skoglund,0,32.0,0,0,1,0,1,Sweden
Leo Houtsonen,0,61.0,0,0,1,0,1,Finland
Leo Lainer,0,44.0,0,0,0,1,1,Northern Ireland
Leo Leslie,0,81.0,0,0,1,0,1,Solomon Islands
Leocadio Marín,3,304.0,0,0,2,4,6,Paraguay
Leon Andreasen,0,33.0,0,0,1,1,2,Denmark
Leon Bailey,0,39.0,0,1,1,0,1,Jamaica
Leon Balogun,1,29.0,0,0,0,1,1,Central African Republic
Leon Cort,0,81.0,0,0,1,0,1,Guyana
Leon Goretzka,3,458.0,0,0,11,1,12,Australia
Leon Goua G'Bize,0,92.0,0,0,1,1,2,Ivory Coast
Leon Mupenzi,0,48.0,0,0,1,0,1,Rwanda
Leonard Farrugia,0,124.0,0,0,2,0,2,Malta
Leonard Piątek,0,23.0,0,0,2,0,2,Poland
Leonard Wells,0,89.0,0,0,1,0,1,Honduras
Leonardo Araújo,4,207.0,0,0,4,0,4,Brazil
Leonardo Astrada,1,70.0,0,0,1,0,1,Argentina
Leonardo Bonucci,1,303.0,0,1,0,5,5,Estonia
Leonardo Palacios,1,49.0,0,0,0,1,1,Argentina
Leonardo Pavoletti,0,76.0,0,0,1,0,1,Italy
Leonardo Rodríguez,1,87.0,0,0,0,2,2,Saudi Arabia
Leonardo Véliz,0,31.0,0,0,1,0,1,Chile
Leone Vurukania,2,90.0,0,0,0,2,2,Tonga
Leonel Duarte,0,85.0,0,0,0,1,1,Antigua and Barbuda
Leonel Hernández,0,258.0,0,1,4,1,5,Costa Rica
Leonel Justiniano,1,82.0,0,0,1,0,1,Bolivia
Leonel Moreira,0,66.0,1,0,1,0,1,United States
Leonel Saint-Preux,0,28.0,0,0,0,1,1,Suriname
Leonel Sánchez,5,488.0,0,3,9,2,11,Brazil
Leonel Vielma,0,72.0,0,0,0,1,1,Argentina
Leong Ka Hang,0,111.0,0,1,2,0,2,Macau
Leonhard Kass,0,47.0,0,0,0,1,1,Sweden
Leonid Buryak,1,56.0,0,0,2,0,2,Russia
Leonid Koshelev,0,93.0,0,0,1,1,2,Taiwan
Leonid Kovel,0,86.0,0,0,1,0,1,Belarus
Leonidas Flores,1,17.0,0,0,1,0,1,Costa Rica
Leonson Lewis,1,179.0,0,0,2,1,3,United States
Leopold Grausam,0,193.0,0,0,2,1,3,Austria
Leopold Kielholz,3,68.0,0,0,0,3,3,Netherlands
Leopoldo Luque,0,406.0,0,0,5,3,8,Venezuela
Leopoldo Quiñónez,1,32.0,0,0,0,1,1,Ecuador
Leotis Boateng,0,11.0,0,0,1,0,1,Nigeria
Leovegildo Lins da Gama Júnior,1,159.0,0,0,1,1,2,Brazil
Leroy Fer,1,77.0,0,0,1,0,1,Netherlands
Leroy Francis,0,116.0,0,0,2,0,2,Saint Kitts and Nevis
Leroy Sané,1,320.0,0,0,3,4,7,Netherlands
Les Ferdinand,1,166.0,0,0,2,2,4,England
Les Scheinflug,2,85.0,0,1,1,1,2,North Korea
Leslie Santos,0,60.0,0,1,1,0,1,Hong Kong
Lesly St. Fleur,0,379.0,1,0,7,0,7,Bahamas
Lester Hayes III,0,90.0,0,0,1,0,1,Puerto Rico
Lester Moré,3,704.0,0,1,7,7,14,Cayman Islands
Lester Peltier,0,193.0,0,0,4,0,4,Trinidad and Tobago
Leszek Lipka,0,75.0,0,0,0,1,1,Malta
Levan Kenia,1,90.0,0,0,1,0,1,Georgia
Levan Kobiashvili,0,565.0,0,3,3,5,8,Hungary
Levan Mchedlidze,0,16.0,0,0,1,0,1,Georgia
Levi García,1,160.0,0,0,1,2,3,Saint Vincent and the Grenadines
Levon Hayrapetyan,0,22.0,1,0,1,0,1,Serbia
Lexa Bibi,2,99.0,0,0,1,1,2,Vanuatu
Leônidas,1,55.0,0,0,1,0,1,Brazil
Leônidas da Silva,7,439.0,0,0,7,0,7,Brazil
Li Bing,2,396.0,0,0,3,4,7,Saudi Arabia
Li Chang-Ha,2,43.0,0,0,2,0,2,North Korea
Li Dong-woon,1,22.0,0,0,1,0,1,North Korea
Li Fubao,1,7.0,0,0,0,1,1,North Korea
Li Huan-wen,1,45.0,0,0,0,1,1,Israel
Li Huayun,1,108.0,0,0,0,1,1,Kuwait
Li Hui,1,84.0,0,0,3,0,3,China PR
Li Jinyu,0,413.0,0,0,5,3,8,China PR
Li Kwok Keung,1,14.0,0,0,1,0,1,Hong Kong
Li Ming,2,147.0,0,0,5,0,5,China PR
Li Weifeng,0,517.0,0,0,5,2,7,China PR
Li Xiao,0,70.0,0,0,0,1,1,Japan
Li Xiaopeng,0,144.0,0,0,3,0,3,China PR
Li Yi,0,80.0,0,0,1,0,1,China PR
Li Yong-Man,0,3.0,0,0,0,1,1,Hong Kong
Li Yong-Sob,2,66.0,0,0,1,2,3,North Korea
Liam Brady,0,296.0,0,2,4,1,5,Republic of Ireland
Liam O'Kane,0,68.0,0,0,0,1,1,Portugal
Liam Tuohy,0,71.0,0,0,2,1,3,Republic of Ireland
Liam Walker,1,33.0,0,0,2,0,2,Gibraltar
Liberato Cacace,1,71.0,0,0,1,0,1,New Zealand
Libor Kozák,0,19.0,0,0,0,1,1,Italy
Libor Sionko,1,113.0,0,0,2,3,5,Slovakia
Ligorio López,0,113.0,0,0,1,1,2,Mexico
Lilian Laslandes,0,74.0,0,0,0,1,1,Armenia
Lilian Thuram,0,117.0,0,0,2,0,2,France
Lim Teong Kim,0,19.0,0,0,0,1,1,Singapore
Limberg Gutiérrez,1,144.0,0,0,1,2,3,Bolivia
Limbikani Mzava,1,51.0,1,0,1,0,1,Mozambique
Lin Lefeng,1,81.0,0,0,0,2,2,India
Lin Qiang,0,51.0,0,0,0,1,1,Macau
Lin Wen Han,1,59.0,0,0,0,1,1,Bangladesh
Lincoln Zvasiya,0,81.0,0,0,1,0,1,Zimbabwe
Linnal Wilson,0,67.0,0,0,1,0,1,Jamaica
Lino Nessi,1,10.0,0,0,1,0,1,Paraguay
Linos Chalwe,0,26.0,0,0,1,0,1,Zambia
Linos Makwaza,1,40.0,0,0,1,0,1,Zambia
Liombi Essende,1,72.0,0,0,0,1,1,Liberia
Lionel Messi,25,2475.0,0,14,39,15,54,Argentina
Lior Refaelov,0,164.0,0,0,0,3,3,Malta
Lisi Leututu,1,8.0,1,0,0,1,1,American Samoa
Listner Pierre-Louis,0,44.0,0,0,1,0,1,Haiti
Lito,0,39.0,0,0,1,0,1,Cape Verde
Litsepe Marabe,0,88.0,0,0,1,0,1,Lesotho
Liu Binbin,1,5.0,0,0,1,0,1,China PR
Liu Haiguang,4,259.0,0,0,3,2,5,China PR
Liu Jian,1,77.0,0,0,1,1,2,China PR
Liuai Duguga,0,89.0,0,0,1,0,1,Fiji
Liviu Ciobotariu,0,66.0,0,0,0,1,1,Slovakia
Lizardo Garrido,0,85.0,1,0,1,0,1,Paraguay
Liédson,1,241.0,0,0,2,1,3,Denmark
Ljubinko Drulović,1,108.0,0,0,1,1,2,North Macedonia
Ljubomir Radanović,0,95.0,0,0,1,1,2,Yugoslavia
Ljupčo Markovski,0,69.0,0,0,0,1,1,Armenia
Llewellyn Riley,0,256.0,0,0,3,2,5,Grenada
Lo Chih Tsong,0,71.0,1,0,1,0,1,New Zealand
Lo Hung-Hoi,1,53.0,0,0,1,0,1,Hong Kong
Lo Kwan Yee,0,32.0,0,0,2,0,2,Hong Kong
Loay Taleb,1,60.0,0,0,0,1,1,Maldives
Locó,0,78.0,0,0,0,1,1,Benin
Logan Rogerson,1,36.0,0,1,1,0,1,New Zealand
Loh Wai Chi,1,15.0,0,0,0,1,1,India
Lokenge Mungongo,0,166.0,0,0,0,2,2,Burkina Faso
Lokoua Taufahema,4,244.0,0,0,0,5,5,Samoa
Lomana LuaLua,1,76.0,0,0,0,2,2,Togo
Lorenc Trashi,0,40.0,0,0,0,1,1,Moldova
Lorenzo Fernández,3,93.0,0,0,0,3,3,Peru
Lorenzo Gimenez,0,11.0,0,0,1,0,1,Paraguay
Lorenzo Insigne,1,274.0,0,0,3,3,6,Italy
Lorenzo Pellegrini,0,77.0,0,0,0,1,1,Armenia
Lorenzo Staelens,0,268.0,0,2,4,2,6,Belgium
Lorenzo Tehau,5,293.0,0,0,1,4,5,Samoa
Lorgio Álvarez,0,57.0,0,0,0,1,1,Peru
Loris Benito,0,75.0,0,0,0,1,1,Gibraltar
Lorry Thomsen,1,45.0,0,0,0,1,1,Fiji
Loten Dalai,0,89.0,0,0,0,1,1,Australia
Lotfi Hsoumi,0,80.0,0,0,1,0,1,Tunisia
Lotfi Rouissi,0,60.0,0,0,0,2,2,Benin
Lothar Emmerich,1,39.0,0,0,1,0,1,Germany
Lothar Matthäus,7,657.0,0,5,10,5,15,Czechoslovakia
Lou Macari,0,18.0,0,0,0,1,1,Denmark
Louis Camara,2,55.0,0,0,0,2,2,Ethiopia
Louis Floch,0,30.0,0,0,1,0,1,France
Louis Gomis Diop,0,2.0,0,0,1,0,1,Senegal
Louis Pilot,0,143.0,0,0,3,1,4,Luxembourg
Louis Saha,0,16.0,0,0,1,1,2,Georgia
Louis Schaub,0,335.0,0,0,4,1,5,Austria
Louis-Paul M'Fédé,2,234.0,0,1,4,0,4,Cameroon
Lovro Majer,1,201.0,0,0,1,2,3,Malta
Loïc Loval,1,33.0,0,0,0,1,1,Panama
Loïc Négo,0,178.0,0,0,1,1,2,Hungary
Loïc Rémy,0,120.0,0,0,2,0,2,France
Lubambo Musonda,0,59.0,0,0,1,0,1,Zambia
Luboš Kozel,0,26.0,0,0,1,0,1,Czech Republic
Luboš Kubík,1,210.0,0,0,3,1,4,Czechoslovakia
Luc Holtz,0,44.0,0,0,1,0,1,Luxembourg
Luc Nilis,1,242.0,0,0,2,5,7,Armenia
Luca Gobbi,0,27.0,1,0,0,1,1,San Marino
Luca Toni,2,481.0,0,0,7,4,11,Italy
Lucas Barrios,4,301.0,0,0,2,3,5,Paraguay
Lucas Biglia,0,19.0,0,0,0,1,1,Colombia
Lucas Cavallini,10,492.0,0,0,3,7,10,Mexico
Lucas Lima,1,125.0,0,0,1,1,2,Argentina
Lucas Neill,0,84.0,0,0,1,0,1,Australia
Lucas Paquetá,1,303.0,0,0,4,2,6,Paraguay
Lucas Pratto,0,79.0,0,0,1,1,2,Venezuela
Lucas Radebe,2,64.0,0,0,1,1,2,Uruguay
Lucho González,2,171.0,0,0,3,1,4,Argentina
Luciano Djim,0,39.0,0,0,0,1,1,Zimbabwe
Luciano Figueroa,6,516.0,0,0,4,5,9,Argentina
Luciano Galletti,0,63.0,0,0,0,1,1,Bolivia
Luciano Narsingh,0,161.0,0,0,1,1,2,Netherlands
Luciano Vassallo,1,325.0,0,4,6,1,7,Israel
Lucien Cossou,0,278.0,0,0,4,0,4,France
Lucien Kassi-Kouadio,2,176.0,0,1,3,0,3,Ivory Coast
Lucien Kouassi Kouame,0,17.0,0,0,1,0,1,Ivory Coast
Lucien Laurent,1,19.0,0,0,1,0,1,France
Lucien Mettomo,1,52.0,0,0,1,0,1,Cameroon
Lucjan Brychczy,0,250.0,0,0,4,2,6,Poland
Lucky Msiska,0,68.0,0,0,2,0,2,Zambia
Ludo Coeck,1,106.0,0,0,3,0,3,Belgium
Ludovic Giuly,0,206.0,0,0,2,1,3,France
Ludovic Gotin,1,59.0,0,0,1,0,1,Guadeloupe
Ludovic Magnin,0,158.0,1,0,2,0,2,Republic of Ireland
Ludovic Sané,0,14.0,1,0,1,0,1,Ivory Coast
Ludovico Avio,1,60.0,0,0,1,0,1,Argentina
Ludwig Augustinsson,1,62.0,0,0,0,2,2,Mexico
Luigi De Agostini,1,176.0,0,0,2,0,2,Italy
Luigi Di Biagio,2,46.0,0,0,2,0,2,Italy
Luigi Pieroni,0,52.0,0,0,0,1,1,Azerbaijan
Luigi Riva,0,407.0,0,0,4,3,7,Wales
Luis Advíncula,0,89.0,0,0,0,1,1,Ecuador
Luis Alfonso Rodríguez,1,26.0,0,0,1,0,1,Mexico
Luis Alfredo Ramírez,0,83.0,0,0,0,1,1,Nicaragua
Luis Anaya,0,229.0,0,0,1,2,3,El Salvador
Luis Antonio Jiménez,0,91.0,0,0,2,0,2,Chile
Luis Aragonés,0,75.0,0,0,1,0,1,Spain
Luis Araneda,0,127.0,0,0,2,0,2,Chile
Luis Artime,8,625.0,0,0,9,2,11,Argentina
Luis Capurro,1,6.0,0,1,1,0,1,Ecuador
Luis Carlos Perea,1,88.0,0,0,1,0,1,Colombia
Luis Casquez,0,77.0,0,0,1,0,1,Dominican Republic
Luis Chávez,1,52.0,0,0,0,1,1,Saudi Arabia
Luis Copete,0,64.0,0,0,2,0,2,Nicaragua
Luis Cristaldo,0,151.0,0,0,1,3,4,Venezuela
Luis Cruz,1,59.0,1,0,1,0,1,Austria
Luis Cruzado,0,40.0,0,0,1,0,1,Peru
Luis Cubilla,2,169.0,0,0,1,4,5,Bolivia
Luis Diego Arnáez,0,166.0,0,0,2,1,3,Costa Rica
Luis Díaz,3,395.0,0,0,2,5,7,Peru
Luis Enrique,2,705.0,0,0,9,3,12,Spain
Luis Enrique Cálix,3,119.0,0,0,0,3,3,Canada
Luis Ernesto Castro,0,137.0,0,0,3,0,3,Uruguay
Luis Ernesto Pérez,0,267.0,0,0,5,0,5,Mexico
Luis Espel,1,89.0,0,0,0,1,1,Trinidad and Tobago
Luis Espinal,1,75.0,0,0,0,1,1,Anguilla
Luis Fernández,1,164.0,0,1,3,1,4,France
Luis Flores,0,107.0,0,0,3,1,4,Mexico
Luis Fretes,3,209.0,0,0,0,3,3,Chile
Luis Fuentes,0,42.0,0,0,2,0,2,Chile
Luis Gabriel Rey,0,60.0,0,0,2,1,3,Colombia
Luis Galeano,0,60.0,0,0,1,1,2,Nicaragua
Luis García,1,244.0,1,0,5,0,5,Argentina
Luis García Postigo,9,1035.0,0,2,12,6,18,Mexico
Luis González Rubio,2,5.0,0,0,1,1,2,Colombia
Luis Guadalupe,0,90.0,1,0,1,0,1,Argentina
Luis Guzmán,3,214.0,0,0,0,3,3,Colombia
Luis Guzmán Gonzales,1,62.0,0,0,0,1,1,Ecuador
Luis Gómez,0,90.0,0,0,0,1,1,Bolivia
Luis Henríquez,0,81.0,0,0,1,1,2,Panama
Luis Hernán Álvarez,0,25.0,0,0,0,1,1,Argentina
Luis Hernández,18,1138.0,0,3,9,12,21,Mexico
Luis Luna,0,56.0,0,0,2,0,2,Mexico
Luis Mago,0,9.0,0,0,1,0,1,Venezuela
Luis Manuel Seijas,0,82.0,0,0,1,0,1,Venezuela
Luis Martén,1,177.0,0,0,2,1,3,Cuba
Luis Martínez,0,111.0,0,0,2,0,2,Guatemala
Luis Marín Murillo,1,174.0,0,1,2,1,3,Costa Rica
Luis Mendez,1,61.0,0,0,1,0,1,Belize
Luis Mendoza,1,54.0,0,0,1,1,2,Chile
Luis Mendoza Benedetto,0,55.0,0,0,1,0,1,Venezuela
Luis Meseguer,1,34.0,0,0,0,1,1,South Sudan
Luis Miguel Noriega,1,45.0,0,1,0,1,1,Nicaragua
Luis Miguel Salvador,0,232.0,0,0,5,0,5,Mexico
Luis Molowny,0,65.0,0,0,1,0,1,Spain
Luis Montes,2,60.0,0,0,0,2,2,Martinique
Luis Monti,2,101.0,0,0,2,0,2,Argentina
Luis Monzón,4,220.0,0,1,4,0,4,Paraguay
Luis Morales,0,51.0,0,0,1,0,1,Venezuela
Luis Muriel,0,122.0,0,1,3,0,3,Colombia
Luis Navarrete,0,51.0,0,0,1,0,1,Peru
Luis Nery Caballero,0,15.0,0,0,0,1,1,Ecuador
Luis Norberto Campero,3,66.0,0,0,0,3,3,Brazil
Luis Omar Sanchez,1,43.0,0,0,0,1,1,Montserrat
Luis Paradela,1,33.0,0,0,1,0,1,Cuba
Luis Quiñónez,1,30.0,0,0,1,0,1,Colombia
Luis Ramallo,0,260.0,0,0,2,5,7,Venezuela
Luis Ramírez Zapata,1,64.0,0,0,0,1,1,Hungary
Luis Regueiro,0,165.0,0,0,2,1,3,Spain
Luis Reyna,0,59.0,0,0,0,1,1,Argentina
Luis Santamaría,0,77.0,0,0,0,1,1,Saint Vincent and the Grenadines
Luis Suárez,16,2414.0,0,9,28,18,46,Uruguay
Luis Suárez Miramontes,0,141.0,0,0,1,3,4,Spain
Luis Tejada,10,1292.0,0,1,15,9,24,Panama
Luis Vargas Peña,1,80.0,0,0,0,2,2,Chile
Luis Zavalla,0,121.0,0,0,0,2,2,Venezuela
Luis de Souza,1,75.0,0,0,1,0,1,Peru
Luis de la Fuente,0,197.0,0,0,4,0,4,Mexico
Luis del Sol,0,80.0,0,0,0,1,1,Morocco
Luisão,1,68.0,0,0,0,2,2,Argentina
Luizão,0,31.0,0,0,2,0,2,Brazil
Luk Man Wai,1,51.0,0,0,1,0,1,Taiwan
Luka Jović,0,125.0,0,0,2,0,2,Serbia
Luka Menalo,0,155.0,0,0,2,0,2,Bosnia and Herzegovina
Luka Milivojević,0,11.0,0,0,0,1,1,Austria
Luka Modrić,3,891.0,0,6,12,6,18,Croatia
Luka Đorđević,0,24.0,0,0,0,1,1,San Marino
Lukas Podolski,6,1285.0,0,0,18,11,29,Germany
Lukas Spalvis,0,90.0,0,0,1,0,1,Lithuania
Luke Adams,1,80.0,0,0,1,0,1,New Zealand
Luke Dimech,0,73.0,0,0,1,0,1,Malta
Luke Gambin,0,16.0,0,0,0,1,1,Slovakia
Luke Ivor,0,17.0,0,0,0,1,1,Bermuda
Luke Jukulile,0,87.0,0,0,1,0,1,Zimbabwe
Luke Shaw,0,2.0,0,0,1,0,1,England
Luke Wilkshire,0,147.0,0,2,1,1,2,Saudi Arabia
Luki Gosche,0,55.0,0,0,2,0,2,Samoa
Lukáš Haraslín,0,45.0,0,0,0,1,1,Croatia
Lukáš Hrádecký,1,74.0,1,0,0,1,1,Finland
Lukáš Masopust,0,58.0,0,0,0,1,1,Montenegro
Lukáš Provod,0,50.0,0,0,1,0,1,Czech Republic
Lungisani Ndlela,2,109.0,0,0,1,1,2,Jamaica
Lupo Quiñónez,0,44.0,0,0,0,1,1,Argentina
Luther Blissett,0,192.0,0,0,3,0,3,England
Luton Shelton,2,423.0,0,2,9,2,11,Guatemala
Lutz Lindemann,0,108.0,0,0,1,1,2,German DR
Luuk de Jong,0,380.0,0,0,2,3,5,Finland
Luz Gastelbondo,1,27.0,0,0,0,1,1,Uruguay
Luís Fabiano,10,873.0,0,1,10,10,20,Chile
Luís Fernandes,0,83.0,0,0,1,0,1,Lebanon
Luís Figo,2,780.0,0,1,9,8,17,Latvia
Luís Henrique,1,144.0,0,0,1,1,2,Brazil
Luís Leal,0,86.0,0,0,1,0,1,São Tomé and Príncipe
Luís Neto,1,54.0,1,0,0,1,1,Portugal
Luís Oliveira,0,186.0,0,0,3,3,6,Belgium
Luís Roberto Alves,3,1024.0,0,1,18,3,21,Mexico
Luís Trochillo,1,88.0,0,0,0,1,1,Argentina
Luíz Mesquita de Oliveira,4,168.0,0,0,4,0,4,Brazil
Lwata Mpia,0,78.0,0,0,1,0,1,DR Congo
Lyle Taylor,3,318.0,0,2,1,5,6,Curaçao
Lyndon Dykes,0,187.0,0,1,2,2,4,Scotland
Lyndon Hooper,0,54.0,0,0,0,1,1,Australia
Lyndon Joseph,0,90.0,1,0,0,1,1,Grenada
Lys Mouithys,0,80.0,0,0,0,2,2,Mali
Lyuboslav Penev,1,524.0,1,0,7,2,9,San Marino
Lárus Guðmundsson,0,21.0,0,0,1,0,1,Iceland
Lárus Sigurðsson,0,66.0,0,0,0,1,1,Ukraine
László Branikovits,0,88.0,0,0,2,0,2,Hungary
László Bálint,1,211.0,1,0,3,2,5,Hungary
László Bölöni,1,293.0,0,0,5,1,6,Romania
László Dajka,1,73.0,1,0,1,0,1,Russia
László Disztl,0,16.0,0,0,1,0,1,Hungary
László Fazekas,2,369.0,0,0,6,1,7,Czechoslovakia
László Fekete,0,53.0,0,0,2,0,2,Hungary
László Kiss,3,554.0,0,0,6,2,8,Norway
László Klausz,0,80.0,0,0,3,0,3,Hungary
László Kleinheisler,0,84.0,0,0,0,2,2,Norway
László Nagy,0,188.0,0,0,1,3,4,Norway
László Pusztai,0,111.0,0,0,2,1,3,Hungary
László Szokolai,0,143.0,0,0,2,0,2,Hungary
László Tieber,0,74.0,0,0,0,1,1,Finland
Lázaro Darcourt,3,361.0,0,0,3,3,6,Cayman Islands
Lázaro Oliveira,1,46.0,0,0,1,0,1,Angola
Lázár Szentes,1,131.0,0,0,2,0,2,Hungary
Léger Djimrangar,1,92.0,0,0,1,1,2,Chad
Léider Preciado,1,82.0,0,0,1,0,1,Colombia
Léon Dolmans,0,90.0,0,2,1,1,2,Norway
Léon Glovacki,0,67.0,0,0,0,2,2,Luxembourg
Léon Letsch,0,58.0,0,0,0,1,1,Netherlands
Léon Mungamuni,1,188.0,0,0,1,2,3,Ethiopia
Léon Semmeling,0,49.0,0,0,1,0,1,Belgium
Léopold Anoul,3,194.0,0,0,3,2,5,Finland
Léster Blanco,1,215.0,0,0,1,3,4,El Salvador
Lê Công Vinh,0,521.0,0,1,7,4,11,Vietnam
Lê Hữu Đức,2,178.0,0,0,0,3,3,Hong Kong
Líder Paz,0,96.0,0,0,2,1,3,Bolivia
Lúcio,1,84.0,0,0,0,1,1,United States
Lư Đình Tuấn,1,14.0,0,0,1,0,1,Vietnam
M'Bala Nzola,0,35.0,0,1,1,0,1,Angola
M'Baye Niang,1,60.0,0,0,0,1,1,Poland
M'Peti Suzeti,0,1.0,0,0,1,0,1,DR Congo
Ma Jung-U,2,116.0,0,0,2,0,2,North Korea
Ma Lin,3,446.0,0,0,1,7,8,Kuwait
Ma Mingyu,1,195.0,0,0,3,2,5,Syria
MaNicolás Oliveratias Almeyda,0,45.0,0,0,0,1,1,Brazil
Mabululu,0,48.0,0,0,1,0,1,Angola
Macchambes Younga-Mouhani,0,184.0,0,0,3,0,3,Congo
Macha Gatien,1,88.0,0,0,1,0,1,Tahiti
Maciej Żurawski,0,447.0,0,1,5,3,8,Northern Ireland
Maciu Dunadamu,1,190.0,0,0,1,2,3,Fiji
Macnelly Torres,0,128.0,0,0,3,0,3,Colombia
Madjid Bougherra,1,160.0,0,0,1,2,3,Zambia
Mael Kaudre,0,83.0,0,0,0,1,1,Fiji
Magdi Abdelghani,2,159.0,0,2,0,2,2,Algeria
Magid Mohamed,1,156.0,0,0,2,0,2,Qatar
Magnús Bergs,0,110.0,0,0,1,1,2,Czechoslovakia
Magomed Ozdoyev,0,83.0,0,0,1,1,2,Russia
Mahad Khaireh,0,39.0,0,0,1,0,1,Djibouti
Mahamadou Diarra,2,202.0,0,0,2,1,3,Burkina Faso
Mahamadou N'Diaye,1,108.0,0,0,2,0,2,Mali
Mahamane Cissé,0,115.0,0,0,3,0,3,Niger
Mahamat Labbo,0,63.0,0,0,1,1,2,Chad
Mahamoudou Kéré,0,116.0,0,0,3,0,3,Burkina Faso
Maharan Radi,0,4.0,0,0,0,1,1,Luxembourg
Mahboub Juma'a,0,69.0,0,0,2,0,2,Kuwait
Mahdi Houssein Mahabeh,0,45.0,0,1,1,0,1,Djibouti
Mahdi Kadhim,1,35.0,0,0,0,1,1,Yemen
Mahdi Kamel,2,139.0,0,0,2,0,2,Iraq
Mahdi Karim,0,251.0,0,0,0,4,4,Pakistan
Maheanum Gatien,2,131.0,0,0,2,0,2,Tahiti
Maher Al Sayed,0,162.0,0,1,2,0,2,Syria
Maher Hammam,1,57.0,0,0,2,0,2,Egypt
Maher Kanzari,0,30.0,0,0,1,0,1,Tunisia
Maher Malki,0,89.0,0,0,1,0,1,Syria
Maher Sabra,0,95.0,1,0,2,0,2,South Korea
Mahfood Sultan Al Araimi,2,117.0,0,0,0,2,2,Nepal
Mahir Emreli,0,128.0,0,0,1,1,2,Azerbaijan
Mahir Shukurov,0,152.0,0,1,2,0,2,Azerbaijan
Mahlon Houkarawa,1,82.0,0,0,0,1,1,Fiji
Mahmadu Alphajor Bah,0,87.0,0,0,1,0,1,Sierra Leone
Mahmood Abdulrahman,0,295.0,0,1,4,1,5,Bahrain
Mahmood Al-Ajmi,0,45.0,0,0,1,0,1,Bahrain
Mahmoud Al Baher,1,64.0,0,0,1,0,1,Syria
Mahmoud Al-Jahani,0,22.0,0,0,1,0,1,Libya
Mahmoud Al-Mawas,9,726.0,0,3,5,7,12,Cambodia
Mahmoud Al-Sayed,0,101.0,0,0,2,0,2,Syria
Mahmoud Baquir Younes,0,89.0,1,0,0,1,1,Lebanon
Mahmoud Chahoud,0,63.0,0,0,0,1,1,Maldives
Mahmoud El Ali,0,213.0,0,0,2,3,5,Lebanon
Mahmoud El Khatib,2,307.0,0,0,5,3,8,Egypt
Mahmoud El-Gohary,3,144.0,0,0,3,0,3,Egypt
Mahmoud Fathalla,0,55.0,0,0,1,0,1,Egypt
Mahmoud Guendouz,0,34.0,0,0,1,0,1,Algeria
Mahmoud Khamees,0,66.0,0,0,1,1,2,Lebanon
Mahmoud Mokhtar El-Tetsh,2,126.0,0,0,3,2,5,Egypt
Mahmoud Shelbaieh,2,147.0,0,0,2,2,4,Taiwan
Mahmoud Soufi,1,448.0,0,0,8,0,8,Qatar
Mahmoud Yaseen Al-Soufi,1,367.0,0,0,5,1,6,Qatar
Mahmud Qurbanov,0,63.0,0,0,0,1,1,Finland
Mai Aih Naing,0,88.0,0,0,1,0,1,Myanmar
Mai Chao,3,354.0,0,2,3,2,5,South Korea
Maicon Sisenando,4,146.0,0,0,2,2,4,Brazil
Maik Galakos,0,206.0,0,0,3,0,3,Greece
Maikel Reyes,3,213.0,0,0,1,2,3,Guatemala
Majdi Samir,0,67.0,0,0,1,0,1,Oman
Majdi Shaaban Samir,0,266.0,0,0,2,2,4,Oman
Majdi Siddiq,0,37.0,0,0,1,0,1,Qatar
Majed Abdullah,4,516.0,0,0,9,2,11,Saudi Arabia
Majid Musisi,0,73.0,0,0,1,0,1,Uganda
Majid Namjoo-Motlagh,1,15.0,0,1,0,1,1,Taiwan
Mak King-Fun,0,217.0,0,0,4,0,4,Hong Kong
Mak Tian-fu,1,37.0,0,0,0,1,1,Hong Kong
Makoto Hasebe,1,35.0,0,0,0,1,1,Syria
Maksim Bardachov,0,23.0,0,0,1,0,1,Belarus
Maksim Buznikin,0,19.0,0,0,1,0,1,Russia
Maksim Igorevich Shevchenko,0,116.0,0,0,2,0,2,Kazakhstan
Maksim Medvedev,1,47.0,1,0,2,0,2,Azerbaijan
Maksim Nizovtsev,0,62.0,0,0,0,1,1,Albania
Maksim Romaschenko,0,365.0,0,1,3,4,7,Belarus
Maksim Shatskikh,3,861.0,0,1,13,6,19,Uzbekistan
Maksim Skavysh,0,90.0,0,0,0,1,1,Estonia
Maksim Smirnov,0,147.0,0,0,1,1,2,Scotland
Maksim Valadzko,0,55.0,0,0,1,0,1,Belarus
Maksim Zhalmagambetov,0,53.0,0,0,1,0,1,Kazakhstan
Maksym Kalynychenko,1,173.0,0,0,2,1,3,Saudi Arabia
Mal Donaghy,0,15.0,0,0,0,1,1,Albania
Mal Griffiths,0,80.0,0,0,1,0,1,Wales
Malcolm Allen,0,11.0,0,0,0,1,1,Germany
Malcolm Bland,0,180.0,0,0,2,0,2,New Zealand
Malcolm Dunford,0,154.0,0,0,3,1,4,New Zealand
Malcolm Macdonald,0,224.0,0,0,5,0,5,England
Malek Mouath,2,309.0,0,0,3,2,5,Japan
Malick Evouna,1,74.0,0,0,1,1,2,Burkina Faso
Malik Awab,0,36.0,0,0,1,0,1,Singapore
Malik Jabir,1,100.0,0,0,1,0,1,Ghana
Malkhaz Asatiani,0,242.0,1,0,3,2,5,Georgia
Mama Baldé,0,82.0,0,0,0,1,1,Sudan
Mama Ouattara,0,104.0,0,0,1,1,2,Sierra Leone
Mamadaou Koïta,1,52.0,0,0,0,1,1,Nigeria
Mamadou Aliou Keita,3,162.0,0,0,2,3,5,Ethiopia
Mamadou Bagayoko,1,103.0,0,0,2,0,2,Mali
Mamadou Bah,2,216.0,0,0,2,1,3,Guinea
Mamadou Diallo,1,241.0,0,0,3,2,5,Cameroon
Mamadou Diarra,0,75.0,0,0,1,0,1,Senegal
Mamadou Kané,0,31.0,0,0,0,1,1,Morocco
Mamadou Niang,3,185.0,0,0,3,2,5,Senegal
Mamadou Niass,0,69.0,0,0,1,0,1,Mauritania
Mamadou Sakho,0,94.0,0,0,2,0,2,France
Mamadou Samassa,2,171.0,0,1,2,3,5,Benin
Mamadou Tall,0,54.0,1,0,0,1,1,Burkina Faso
Mamadou Zongo,0,329.0,0,0,5,4,9,Kenya
Mamane Ali,0,82.0,0,0,0,1,1,Togo
Mamar Mamouni,1,13.0,0,0,1,0,1,Algeria
Mame Biram Diouf,1,211.0,0,0,1,2,3,Ghana
Mamedaly Karadanov,0,159.0,0,0,1,1,2,Cambodia
Mamun Joarder,3,170.0,0,0,2,1,3,Thailand
Mandla Masango,1,17.0,0,0,1,0,1,South Africa
Maneca,0,85.0,0,0,1,0,1,Brazil
Manfred Kaiser,0,57.0,0,0,0,1,1,Wales
Manfred Kaltz,0,220.0,0,2,3,3,6,Germany
Manfred Linzmaier,0,115.0,0,0,2,0,2,Austria
Manfred Ritschel,0,75.0,0,1,0,1,1,Bulgaria
Manfred Zsak,0,62.0,0,0,1,0,1,Austria
Mani Stenter,1,68.0,0,0,0,1,1,Samoa
Maniche,2,196.0,0,0,5,1,6,Portugal
Maninho,0,69.0,0,0,0,1,1,Zimbabwe
Manjrekar James,0,35.0,0,0,0,1,1,Honduras
Manny Rodríguez,0,90.0,0,0,1,0,1,Dominican Republic
Manoa Masi,2,62.0,0,0,0,2,2,Samoa
Manoel Alencar Monte,0,23.0,0,0,0,1,1,Argentina
Manolo,0,294.0,0,0,4,1,5,Spain
Manolo Gabbiadini,0,90.0,0,0,1,0,1,Italy
Manolom Phomsouvanh,0,71.0,0,0,0,2,2,Cambodia
Manor Solomon,0,62.0,0,0,1,1,2,Moldova
Manrique Quesada,0,117.0,0,0,2,0,2,Costa Rica
Mansour Al-Mousa,1,47.0,0,0,1,0,1,Saudi Arabia
Mansour Al-Muainea,0,40.0,0,0,1,0,1,Saudi Arabia
Mansour Basha Mohamed,1,62.0,0,0,1,0,1,Kuwait
Mansour Boutabout,0,309.0,0,0,3,2,5,Niger
Mansour Muftah,8,785.0,0,0,11,1,12,Qatar
Mansour Sulaiti,1,37.0,0,0,0,1,1,United Arab Emirates
Mansurdzhon Hakimov,0,37.0,0,0,1,0,1,Tajikistan
Mantas Savėnas,0,41.0,0,0,1,0,1,Lithuania
Mantorras,0,134.0,0,0,1,1,2,Angola
Manuchekhr Dzhalilov,1,475.0,0,1,7,3,10,Tajikistan
Manucho,7,424.0,0,2,2,7,9,South Africa
Manucho Diniz,0,66.0,1,0,1,0,1,South Africa
Manuel Akanji,1,58.0,0,0,0,1,1,Portugal
Manuel Alonso,1,132.0,0,0,3,0,3,Mexico
Manuel Amoros,1,111.0,0,1,1,0,1,France
Manuel Arancibia,1,84.0,0,0,2,0,2,Chile
Manuel Arenas,2,110.0,0,0,1,1,2,Chile
Manuel Asisclo Cordoba,0,15.0,0,0,1,0,1,Colombia
Manuel Bobadilla,0,88.0,0,0,0,1,1,Panama
Manuel Bravo Paredes,0,41.0,0,0,0,1,1,Brazil
Manuel Cardoni,0,117.0,0,0,1,1,2,Malta
Manuel Drago,1,47.0,0,0,0,1,1,Colombia
Manuel Fernandes,0,496.0,0,0,5,3,8,Portugal
Manuel Ferreira,0,117.0,0,0,3,2,5,Peru
Manuel Fleitas Solich,1,73.0,0,1,1,1,2,Argentina
Manuel Friedrich,0,87.0,0,0,0,1,1,San Marino
Manuel Gavilán,1,17.0,0,0,0,1,1,Brazil
Manuel Locatelli,0,161.0,0,0,2,1,3,Bulgaria
Manuel Lugo,0,110.0,0,0,1,2,3,Paraguay
Manuel Marani,0,86.0,0,0,1,0,1,San Marino
Manuel Marengo,0,14.0,0,0,0,1,1,Venezuela
Manuel Muñoz,1,229.0,0,0,5,0,5,Chile
Manuel Negrete Arias,0,34.0,0,0,1,0,1,Mexico
Manuel Ott,0,84.0,0,0,1,0,1,Philippines
Manuel Pellegrina,1,83.0,0,0,1,0,1,Argentina
Manuel Piñeiro,0,80.0,0,0,1,0,1,Chile
Manuel Ramírez,0,134.0,0,0,3,0,3,Chile
Manuel Rivera,0,72.0,0,0,2,0,2,Peru
Manuel Rosas,3,159.0,1,1,1,2,3,Chile
Manuel Rosas Arreola,1,89.0,1,1,0,3,3,Suriname
Manuel Saavedra,0,61.0,0,0,1,0,1,Chile
Manuel Salamanca,1,71.0,0,0,0,1,1,Bolivia
Manuel Sanchís Hontiyuelo,0,64.0,0,0,1,0,1,Spain
Manuel Sanchís Martínez,1,57.0,0,0,1,0,1,Spain
Manuel Sarabia,0,129.0,0,0,1,1,2,Spain
Manuel Schauls,0,41.0,1,0,1,0,1,Estonia
Manuel Seoane,2,360.0,0,0,8,0,8,Argentina
Manuel Vallejas,1,36.0,0,0,0,1,1,Ecuador
Manuel Varela,1,79.0,1,0,1,0,1,Argentina
Manuel Vasques,0,65.0,0,0,2,0,2,Portugal
Manuel Velázquez,0,27.0,0,0,2,0,2,Spain
Mao Jianqing,1,33.0,0,0,1,0,1,China PR
Mao Yijun,0,87.0,0,0,0,1,1,Iran
Maor Melikson,0,61.0,0,0,0,1,1,Luxembourg
Maouhoub Ghazouani,1,87.0,0,0,0,2,2,Bulgaria
Marat Bikmaev,1,201.0,0,0,2,2,4,Palestine
Marat Izmailov,0,32.0,0,0,2,0,2,Russia
Marc Berdoll,1,197.0,0,0,3,0,3,France
Marc Bernaus,0,60.0,0,0,1,0,1,Andorra
Marc Birsens,0,76.0,0,0,1,0,1,Luxembourg
Marc Degryse,2,586.0,0,0,10,4,14,Belgium
Marc Enoumba,0,37.0,0,0,1,0,1,Bolivia
Marc Hottiger,0,126.0,0,0,4,0,4,Switzerland
Marc Janko,0,906.0,0,1,10,10,20,Austria
Marc Joseph,0,42.0,0,0,1,0,1,Antigua and Barbuda
Marc Overmars,1,659.0,0,0,6,5,11,Netherlands
Marc Pujol,0,195.0,0,3,3,1,4,Andorra
Marc Rebés,0,26.0,0,0,1,0,1,Andorra
Marc Rieper,1,136.0,0,0,1,1,2,Denmark
Marc Vales,0,150.0,0,0,4,0,4,Andorra
Marc Van Der Linden,4,428.0,0,0,2,5,7,Portugal
Marc Wilmots,4,870.0,0,2,9,9,18,Belgium
Marc Wilson,0,46.0,0,0,0,1,1,Faroe Islands
Marc Zoro,1,54.0,0,0,1,0,1,Ivory Coast
Marc-Vivien Foé,1,258.0,0,0,3,3,6,Ghana
Marcel Artelesa,0,80.0,0,0,0,1,1,Luxembourg
Marcel Bossi,0,18.0,1,0,1,0,1,England
Marcel Christophe,1,51.0,0,0,0,1,1,Serbia
Marcel Coraș,1,73.0,0,0,0,2,2,Germany
Marcel Desailly,1,67.0,0,0,2,0,2,France
Marcel Di Domenico,0,54.0,0,0,1,0,1,Luxembourg
Marcel Halstenberg,0,48.0,0,0,0,1,1,Northern Ireland
Marcel Kimemba Mbayo,0,12.0,0,0,1,0,1,DR Congo
Marcel Koller,0,7.0,0,0,0,1,1,Turkey
Marcel Langiller,1,40.0,0,0,1,0,1,France
Marcel Paeschen,0,25.0,0,0,1,0,1,Belgium
Marcel Răducanu,0,189.0,0,0,2,1,3,Yugoslavia
Marcel Sabitzer,0,404.0,0,0,3,4,7,Montenegro
Marcel de Jong,1,28.0,0,0,0,1,1,Costa Rica
Marcelinho Paraíba,0,4.0,0,0,1,0,1,Brazil
Marcelino Bernal,1,214.0,0,0,3,1,4,Mexico
Marcelino Martínez,0,218.0,0,0,4,0,4,Spain
Marcelino Núñez,0,77.0,0,0,0,1,1,Bolivia
Marcell Jansen,1,117.0,0,0,2,1,3,Germany
Marcelo,0,97.0,1,0,1,1,2,Brazil
Marcelo Balboa,1,253.0,1,0,3,1,4,United States
Marcelo Brozović,0,297.0,1,0,5,1,6,Croatia
Marcelo Corrales,1,84.0,0,0,0,1,1,Ecuador
Marcelo Gallardo,3,461.0,0,2,5,3,8,Argentina
Marcelo Martins Moreno,3,1246.0,0,6,15,10,25,Venezuela
Marcelo Nascimento da Costa,0,65.0,0,0,1,0,1,Bulgaria
Marcelo Oliveira,1,89.0,0,0,1,0,1,Brazil
Marcelo Otero,0,229.0,0,0,5,1,6,Uruguay
Marcelo Salas,4,1177.0,0,1,13,9,22,Chile
Marcelo Saralegui,3,227.0,0,0,5,1,6,Uruguay
Marcelo Sosa,1,22.0,0,0,1,0,1,Uruguay
Marcelo Zalayeta,3,478.0,0,0,5,2,7,Czech Republic
Marcial Barrios,7,434.0,0,1,3,5,8,Chile
Marcial Salazar,1,39.0,1,0,1,0,1,Colombia
Marciano Leyman,0,68.0,0,0,0,1,1,Guyana
Marcin Kuźba,0,144.0,0,0,2,0,2,Poland
Marcin Żewłakow,1,313.0,0,0,3,1,4,Poland
Marco Antonio Anariba,2,117.0,0,1,0,3,3,Jamaica
Marco Antonio Mendoza,0,42.0,0,0,1,0,1,Honduras
Marco Antonio Sandy,0,96.0,1,0,2,0,2,Bolivia
Marco Antônio García Alves,1,57.0,0,0,1,1,2,Brazil
Marco Asensio,1,21.0,0,0,1,0,1,Spain
Marco Bode,1,232.0,0,0,1,4,5,Northern Ireland
Marco Delvecchio,1,117.0,0,0,1,2,3,France
Marco Di Vaio,0,64.0,0,0,1,0,1,Italy
Marco Estrada,0,74.0,0,0,1,0,1,Chile
Marco Etcheverry,2,542.0,0,1,9,2,11,Colombia
Marco Fabián,4,212.0,0,1,2,2,4,Mexico
Marco Garcés,1,38.0,0,0,1,0,1,Mexico
Marco Ilaimaharitra,1,76.0,0,0,1,0,1,Madagascar
Marco Materazzi,2,45.0,0,0,1,1,2,Czech Republic
Marco Padalino,0,87.0,0,0,1,0,1,Switzerland
Marco Pappa,1,200.0,0,0,3,1,4,Cuba
Marco Paulo Rebelo Lopes,0,81.0,0,0,0,1,1,Gabon
Marco Reus,2,557.0,0,0,8,5,13,Germany
Marco Rojas,0,252.0,0,0,3,1,4,New Zealand
Marco Sandy,0,94.0,0,0,3,0,3,Bolivia
Marco Schällibaum,0,23.0,0,0,1,0,1,Switzerland
Marco Soares,0,166.0,0,0,1,1,2,Cape Verde
Marco Streller,0,105.0,0,0,1,1,2,Turkey
Marco Tardelli,2,205.0,0,0,3,0,3,Italy
Marco Ureña,5,509.0,0,0,3,6,9,Costa Rica
Marco Verratti,0,118.0,0,0,2,0,2,Italy
Marco Zwyssig,0,26.0,0,0,1,0,1,Switzerland
Marco van Basten,4,927.0,0,2,6,12,18,Republic of Ireland
Marcos Alonso Peña,0,67.0,0,0,0,1,1,Iceland
Marcos Bermeo,1,36.0,1,0,0,1,1,Ecuador
Marcos Coll,1,68.0,0,0,1,0,1,Colombia
Marcos González,0,29.0,0,0,1,0,1,Chile
Marcos Lugris,0,93.0,0,1,1,1,2,Dominican Republic
Marcos Paulo,1,45.0,0,0,0,1,1,New Zealand
Marcos Pizzelli,0,203.0,0,0,3,3,6,Armenia
Marcos Rojo,3,150.0,0,0,1,2,3,Nigeria
Marcos Senna,0,83.0,0,0,1,0,1,Spain
Marcus Allbäck,2,1009.0,0,0,12,7,19,Moldova
Marcus Berg,0,762.0,0,0,12,4,16,Sweden
Marcus Danielson,0,11.0,0,0,0,1,1,Malta
Marcus Forss,0,29.0,0,0,0,1,1,Bosnia and Herzegovina
Marcus Gayle,1,41.0,0,0,1,0,1,Jamaica
Marcus Ingvartsen,0,89.0,0,0,1,0,1,Denmark
Marcus Julien,0,41.0,0,0,0,1,1,Belize
Marcus Lopez,1,127.0,1,1,2,0,2,Guam
Marcus Macauley,1,81.0,0,0,1,1,2,Angola
Marcus Pürk,0,84.0,0,0,1,0,1,Austria
Marcus Rashford,3,368.0,0,0,3,4,7,England
Marcus Tulio Tanaka,0,219.0,1,0,1,3,4,Thailand
Marcílio Alves da Silva,2,126.0,0,0,0,2,2,Pakistan
Mardik Mardikian,2,53.0,0,1,0,3,3,Guam
Marei Al Ramly,0,70.0,0,0,1,0,1,Libya
Marei Suliman,0,54.0,0,0,1,0,1,Libya
Marek Citko,0,7.0,0,0,0,1,1,England
Marek Hamšík,1,931.0,0,2,8,9,17,Slovakia
Marek Heinz,2,220.0,0,0,2,2,4,Czech Republic
Marek Jankulovski,0,410.0,0,3,4,5,9,Iceland
Marek Koźmiński,0,19.0,0,0,0,1,1,Netherlands
Marek Kulič,0,91.0,0,0,2,0,2,Czech Republic
Marek Kusto,0,24.0,0,0,0,1,1,Iceland
Marek Lemsalu,0,87.0,1,0,0,1,1,Estonia
Marek Leśniak,0,282.0,0,0,2,3,5,Poland
Marek Matějovský,0,23.0,0,0,0,1,1,Germany
Marek Mintál,0,385.0,0,0,5,4,9,Slovakia
Marek Ostrowski,0,58.0,0,0,0,1,1,Greece
Marek Poštulka,0,82.0,0,0,0,2,2,Faroe Islands
Marek Saganowski,0,352.0,0,0,3,1,4,Poland
Marek Sapara,0,124.0,0,0,3,1,4,Slovakia
Marek Ujlaky,0,77.0,0,0,1,0,1,Slovakia
Marek Čech,0,265.0,0,0,3,2,5,Slovakia
Marian Hristov,0,58.0,0,0,0,1,1,Andorra
Marian Zeman,0,37.0,0,0,1,0,1,Slovakia
Marians Pahars,0,134.0,0,0,3,2,5,Norway
Marijo Dodik,0,85.0,0,0,1,0,1,Bosnia and Herzegovina
Marinho Chagas,0,96.0,0,0,2,0,2,Brazil
Marino Alcívar,1,149.0,0,0,0,3,3,Peru
Marino Klinger,1,86.0,0,0,1,0,1,Colombia
Marinos Ouzounidis,0,113.0,1,0,3,0,3,Russia
Mario Acevedo,0,84.0,0,0,0,1,1,Barbados
Mario Alborta,1,42.0,0,0,0,1,1,Argentina
Mario Balotelli,6,563.0,0,3,5,6,11,Italy
Mario Basler,0,71.0,0,0,1,0,1,Germany
Mario Bertini,0,81.0,0,0,0,1,1,Romania
Mario Bolatti,0,84.0,0,0,0,1,1,Uruguay
Mario Boyé,5,269.0,0,0,5,0,5,Argentina
Mario Cordero,1,81.0,0,0,1,1,2,Costa Rica
Mario Corso,0,236.0,0,0,1,2,3,Israel
Mario César Ramírez,0,43.0,1,0,1,0,1,Ecuador
Mario Evaristo,1,135.0,0,0,3,0,3,Argentina
Mario Fernández,1,7.0,0,0,1,0,1,Argentina
Mario Frick,0,537.0,1,1,7,5,12,Liechtenstein
Mario Gaspar Pérez,0,22.0,0,0,0,1,1,Ukraine
Mario Gavranović,1,425.0,0,0,2,3,5,Switzerland
Mario Gjurovski,0,42.0,0,0,1,0,1,North Macedonia
Mario Gómez,5,793.0,0,0,6,9,15,Germany
Mario Götze,2,520.0,0,0,8,2,10,Germany
Mario Haas,0,96.0,0,0,2,0,2,Austria
Mario Harte,0,76.0,0,0,0,1,1,United States Virgin Islands
Mario Kempes,0,464.0,0,0,8,1,9,Venezuela
Mario Lemina,0,30.0,0,0,0,1,1,Ivory Coast
Mario Ludovico Bergara,3,192.0,0,0,0,4,4,Ecuador
Mario López,0,327.0,0,1,0,7,7,Haiti
Mario Mandžukić,12,997.0,1,0,11,12,23,Croatia
Mario Martínez,0,139.0,0,0,3,0,3,Honduras
Mario Moreno,1,88.0,0,0,1,0,1,Chile
Mario Mutsch,0,61.0,0,0,1,0,1,Luxembourg
Mario Méndez,0,5.0,0,0,0,1,1,Nicaragua
Mario Ochoa,0,89.0,0,0,1,0,1,Mexico
Mario Pašalić,1,235.0,0,0,3,1,4,Croatia
Mario Pedraza,1,44.0,0,0,1,0,1,Cuba
Mario Rafael Rodríguez,0,323.0,0,0,3,3,6,Costa Rica
Mario Regueiro,0,4.0,0,0,0,1,1,Chile
Mario Rodríguez,3,209.0,0,0,3,2,5,Argentina
Mario Rondón,0,32.0,0,0,0,1,1,Bolivia
Mario Saralegui,0,70.0,0,0,0,1,1,Ecuador
Mario Soto,2,129.0,0,0,1,2,3,Bolivia
Mario Stanić,1,108.0,0,0,2,1,3,Jamaica
Mario Tenorio,0,6.0,0,0,1,0,1,Ecuador
Mario Vega,0,90.0,0,0,1,0,1,Costa Rica
Mario Yepes,1,187.0,0,0,2,2,4,Colombia
Mario Zanabria,0,120.0,0,0,2,0,2,Argentina
Marios Agathokleous,0,273.0,0,0,4,1,5,Cyprus
Marios Charalambous,0,26.0,1,0,0,1,1,Cyprus
Marios Christodoulou,0,163.0,0,0,2,0,2,Cyprus
Marios Elia,0,30.0,0,0,1,0,1,Cyprus
Marios Tsingis,0,68.0,0,1,0,1,1,Italy
Marius Lăcătuș,2,322.0,0,2,4,3,7,Romania
Marius Mapou,0,64.0,0,0,1,0,1,New Caledonia
Marius Mbaiam,1,28.0,0,0,0,1,1,Sudan
Marius Niculae,0,182.0,0,0,2,3,5,Romania
Marius Stankevičius,0,341.0,1,1,2,4,6,Lithuania
Marius Trésor,1,154.0,0,0,0,2,2,Luxembourg
Marius Walter,1,13.0,0,0,1,0,1,France
Marius Žaliūkas,0,18.0,0,0,1,0,1,Lithuania
Mariusz Kukiełka,0,88.0,0,0,0,1,1,San Marino
Mariusz Lewandowski,0,187.0,0,0,2,1,3,Portugal
Marián Masný,0,281.0,0,0,3,4,7,Czechoslovakia
Mark Armstrong,3,150.0,0,0,3,0,3,New Zealand
Mark Bosnich,0,88.0,0,1,1,0,1,Australia
Mark Bowen,0,126.0,0,0,2,0,2,Wales
Mark Bresciano,0,213.0,0,0,4,1,5,Australia
Mark Burton,0,339.0,0,0,5,1,6,Australia
Mark Chamberlain,0,71.0,0,0,1,0,1,England
Mark Ebanks,1,173.0,0,1,3,1,4,Cayman Islands
Mark Fish,0,110.0,0,0,2,0,2,South Africa
Mark González,1,134.0,0,0,1,1,2,Bolivia
Mark Hartmann,1,88.0,0,0,1,0,1,Philippines
Mark Hateley,0,206.0,0,0,2,2,4,England
Mark Hughes,0,471.0,0,0,7,4,11,Wales
Mark Kennedy,0,148.0,0,0,1,1,2,Iceland
Mark Kinsella,0,61.0,0,0,2,0,2,Republic of Ireland
Mark Lawrenson,0,204.0,0,0,3,2,5,Cyprus
Mark Mackay,0,37.0,0,0,0,1,1,Puerto Rico
Mark Milligan,1,219.0,0,3,2,2,4,Australia
Mark Pembridge,0,255.0,0,1,0,4,4,Albania
Mark Rogers,1,63.0,1,0,0,1,1,Canada
Mark Strudal,0,162.0,0,0,2,0,2,Denmark
Mark Uhatahi,1,46.0,0,0,1,0,1,Tonga
Mark Viduka,2,334.0,0,0,2,4,6,Mexico
Mark Watson,1,180.0,0,0,1,2,3,Canada
Mark Williams,0,311.0,0,0,5,1,6,South Africa
Mark Wright,1,58.0,0,0,1,0,1,England
Mark van Bommel,1,311.0,0,0,2,4,6,Andorra
Mark-Anthony Kaye,2,95.0,0,0,0,2,2,Cayman Islands
Marko Arnautović,1,1255.0,0,4,13,10,23,Austria
Marko Babić,0,19.0,0,0,0,1,1,Bulgaria
Marko Dević,0,134.0,0,1,1,3,4,Ukraine
Marko Kristal,0,160.0,0,0,1,1,2,Estonia
Marko Livaja,1,167.0,0,0,2,1,3,Croatia
Marko Pantelić,1,304.0,0,0,2,3,5,Serbia
Marko Rajamäki,0,20.0,0,0,1,0,1,Finland
Marko Rehmer,0,48.0,0,0,1,2,3,Greece
Marko Simić,0,106.0,0,0,1,1,2,Kazakhstan
Marko Topić,0,87.0,0,0,1,0,1,Bosnia and Herzegovina
Marko Valok,0,83.0,0,0,0,2,2,Israel
Marko Vešović,0,48.0,0,0,1,1,2,Kazakhstan
Marko Šuler,0,97.0,0,0,0,2,2,San Marino
Markus Babbel,0,72.0,0,0,1,0,1,Germany
Markus Henriksen,0,204.0,1,0,2,2,4,Norway
Markus Rosenberg,0,139.0,0,0,2,0,2,Sweden
Markus Schopp,0,229.0,0,0,1,4,5,Northern Ireland
Markus Tanner,0,55.0,1,0,2,0,2,Switzerland
Marlon Ayoví,0,118.0,0,2,1,1,2,Venezuela
Marlon Felter,0,215.0,1,1,3,2,5,Aruba
Marlon James,0,252.0,0,0,3,1,4,Saint Vincent and the Grenadines
Marlon King,1,221.0,0,1,5,3,8,Haiti
Marlos,0,27.0,0,0,0,1,1,Lithuania
Marlos Huggins,0,18.0,0,0,0,1,1,Puerto Rico
Marlos Moreno,1,73.0,0,0,1,0,1,Colombia
Marouane Chamakh,2,131.0,0,0,3,2,5,Morocco
Marouane Fellaini,2,548.0,0,0,9,2,11,Belgium
Maroš Klimpl,0,37.0,0,0,1,0,1,Slovakia
Marquinhos,0,147.0,1,0,2,2,4,Brazil
Marshall Forbes,0,63.0,0,1,1,0,1,Cayman Islands
Marshall Munetsi,0,77.0,0,0,1,0,1,Zimbabwe
Marteinn Geirsson,1,51.0,0,1,0,1,1,Malta
Martin Amerhauser,0,71.0,0,0,1,0,1,Austria
Martin Andresen,1,40.0,0,0,0,1,1,Turkey
Martin Boyle,3,132.0,0,0,2,1,3,Nepal
Martin Braithwaite,1,317.0,0,0,2,3,5,Denmark
Martin Büchel,0,17.0,1,0,2,0,2,Liechtenstein
Martin Chivers,0,173.0,0,0,3,2,5,England
Martin Dahlin,4,730.0,0,0,8,8,16,Sweden
Martin Dúbravka,0,30.0,1,0,1,0,1,Spain
Martin Fabuš,0,70.0,0,0,1,1,2,Slovakia
Martin Fenin,0,87.0,0,0,0,1,1,Poland
Martin Frýdek,0,111.0,0,0,1,1,2,Belarus
Martin Gisinger,0,37.0,0,0,0,1,1,Cyprus
Martin Gregory,0,85.0,0,0,1,0,1,Malta
Martin Harnik,0,501.0,0,0,2,7,9,Belgium
Martin Hiden,0,69.0,0,0,0,1,1,San Marino
Martin Hinteregger,0,121.0,1,0,2,2,4,Georgia
Martin Hoffmann,1,532.0,0,0,8,3,11,Chile
Martin Jakubko,0,351.0,0,0,3,3,6,Cyprus
Martin Jiránek,0,85.0,1,0,0,1,1,Czech Republic
Martin Jørgensen,1,237.0,0,1,2,5,7,Brazil
Martin Koscelník,0,77.0,0,0,1,0,1,Slovakia
Martin Laursen,0,102.0,0,0,2,0,2,Denmark
Martin Linnes,0,86.0,0,0,0,1,1,San Marino
Martin Machón,1,45.0,0,0,1,0,1,Guatemala
Martin O'Neill,1,208.0,0,0,4,1,5,Northern Ireland
Martin Olsson,0,189.0,0,0,1,2,3,San Marino
Martin Paterson,0,57.0,0,0,1,1,2,Northern Ireland
Martin Peters,1,329.0,0,0,2,5,7,England
Martin Petrov,1,761.0,0,2,11,4,15,Bulgaria
Martin Petráš,0,28.0,0,0,0,1,1,North Macedonia
Martin Reim,0,364.0,0,2,3,4,7,Italy
Martin Samuelsen,0,82.0,0,0,1,0,1,Norway
Martin Smedberg-Dalence,1,17.0,0,0,0,1,1,Ecuador
Martin Stocklasa,0,41.0,0,0,0,1,1,Luxembourg
Martin Stranzl,0,157.0,0,0,1,2,3,Austria
Martin Sánchez,0,72.0,0,0,1,0,1,Argentina
Martin Telser,0,49.0,0,0,1,0,1,Liechtenstein
Martin Vunk,0,28.0,0,0,1,0,1,Estonia
Martin Weber,0,88.0,0,0,0,1,1,Italy
Martin Ødegaard,0,70.0,0,0,1,0,1,Norway
Martin Škrtel,0,342.0,2,0,6,1,7,Slovakia
Martins Eyo,1,54.0,0,0,1,0,1,Nigeria
Martti Hyvärinen,0,5.0,0,0,1,0,1,Finland
Martí Ventolrà,0,68.0,0,0,1,0,1,Spain
Martín Arzuaga,0,70.0,0,0,1,0,1,Colombia
Martín Cáceres,0,114.0,0,0,2,1,3,Bolivia
Martín Demichelis,1,77.0,0,0,0,1,1,Greece
Martín Flor,1,47.0,0,0,0,1,1,Chile
Martín Hidalgo,2,136.0,0,0,2,0,2,Peru
Martín Palermo,4,351.0,0,0,3,2,5,Argentina
Martín Pando,0,101.0,0,0,1,1,2,Ecuador
Martín Rodríguez,1,67.0,0,0,1,0,1,Chile
Marvin Andrews,2,239.0,1,0,3,4,7,Trinidad and Tobago
Marvin Baudry,0,10.0,0,0,1,0,1,Congo
Marvin Ceballos,0,79.0,0,1,1,0,1,Guatemala
Marvin Chávez,1,168.0,0,0,0,2,2,Cuba
Marvin Elliott,0,23.0,0,0,1,0,1,Jamaica
Marvin Faustin,0,63.0,0,0,1,0,1,Trinidad and Tobago
Marvin Fletes,1,46.0,0,0,0,1,1,Turks and Caicos Islands
Marvin González,1,101.0,1,0,2,0,2,El Salvador
Marvin Monterrosa,0,109.0,0,0,0,2,2,United States Virgin Islands
Marvin Ogunjimi,0,297.0,0,0,3,2,5,Kazakhstan
Marvin Rodríguez,1,186.0,0,0,3,1,4,Honduras
Marwan Khalifa Khouri,0,82.0,0,0,1,0,1,Syria
Marwan Medrati,0,78.0,0,0,1,0,1,Syria
Maryan Wisniewski,2,412.0,0,0,7,2,9,Iceland
Marzouk Al-Otaibi,7,347.0,0,0,2,6,8,Egypt
Masaaki Sawanobori,0,84.0,0,0,0,1,1,United Arab Emirates
Masahiko Inoha,0,89.0,0,0,0,1,1,Qatar
Masahiro Fukuda,1,196.0,0,0,3,1,4,Japan
Masakiyo Maezono,2,176.0,0,0,2,0,2,Japan
Masami Ihara,2,164.0,0,0,1,2,3,Sri Lanka
Masashi Nakayama,6,611.0,0,0,6,3,9,Japan
Masashi Oguro,3,419.0,0,0,3,2,5,Japan
Masashi Watanabe,1,11.0,0,0,1,0,1,Japan
Masato Morishige,1,35.0,0,0,0,1,1,Afghanistan
Masauso Tembo,1,73.0,0,0,1,0,1,Zambia
Masayuki Okano,1,118.0,0,0,1,0,1,Japan
Masengo Ilunga,0,85.0,0,0,1,0,1,DR Congo
Masimba Mambare,0,42.0,0,0,1,0,1,Zimbabwe
Mason Mount,0,153.0,0,0,0,2,2,Kosovo
Masoud Shojaei,1,232.0,0,1,2,2,4,Iran
Mass Sarr Jr.,1,54.0,0,0,0,1,1,Gabon
Massadio Haïdara,1,2.0,0,0,1,0,1,Mali
Massamasso Tchangai,2,108.0,0,0,0,2,2,DR Congo
Massimo Lombardo,0,14.0,0,0,0,1,1,Finland
Massimo Luongo,0,220.0,0,0,5,0,5,Australia
Massimo Margiotta,0,74.0,0,0,0,1,1,Peru
Massimo Oddo,0,71.0,0,1,1,0,1,Italy
Master Masiku,0,78.0,0,0,0,1,1,Malawi
Mat Noh,0,31.0,0,0,1,0,1,Singapore
Matar Niang,2,101.0,0,0,0,2,2,Ethiopia
Matateu,0,169.0,0,0,2,1,3,Portugal
Mate Vatsadze,0,75.0,0,0,2,0,2,Georgia
Matej Mavrič,0,58.0,0,0,0,1,1,Moldova
Matej Mitrović,1,68.0,0,0,0,1,1,Kosovo
Mateja Kežman,4,524.0,0,0,4,6,10,Faroe Islands
Mateus Galiano da Costa,1,48.0,0,0,0,1,1,Burkina Faso
Mateus Uribe,0,139.0,0,0,1,1,2,Peru
Matheus Nunes,0,90.0,0,0,1,0,1,Portugal
Mathew Leckie,3,314.0,0,0,4,5,9,Australia
Mathias Christen,0,60.0,0,0,1,0,1,Liechtenstein
Mathias Jensen,0,39.0,0,0,1,0,1,Denmark
Mathias Jänisch,0,87.0,0,0,1,0,1,Luxembourg
Mathias Jørgensen,1,85.0,0,0,0,2,2,Croatia
Mathias Normann,0,88.0,0,0,1,0,1,Norway
Mathieu Bollen,0,100.0,0,0,2,0,2,Belgium
Mathieu Dossevi,1,5.0,0,0,0,1,1,Morocco
Mathieu Valbuena,1,87.0,0,0,1,1,2,France
Mathías Corujo,1,88.0,0,0,1,0,1,Uruguay
Matias Belli Moldskred,1,87.0,0,0,0,1,1,Turks and Caicos Islands
Mats Hummels,2,181.0,2,0,2,3,5,Germany
Mats Jingblad,0,87.0,0,0,0,1,1,Czechoslovakia
Mats Magnusson,0,177.0,0,0,2,1,3,Sweden
Mats Møller Dæhli,0,22.0,0,0,0,1,1,Malta
Mats Nordgren,0,54.0,0,0,0,1,1,France
Matt Besler,0,32.0,0,0,0,1,1,Saint Vincent and the Grenadines
Matt Doherty,0,85.0,0,0,1,0,1,Republic of Ireland
Matt Elliott,0,98.0,1,0,0,2,2,Scotland
Matt Holland,2,243.0,0,0,1,3,4,Portugal
Matt McKay,0,27.0,0,0,1,0,1,Australia
Matt Miazga,0,88.0,0,0,1,0,1,United States
Matt Moussilou,0,1.0,0,0,0,1,1,São Tomé and Príncipe
Matt Ritchie,0,45.0,0,0,1,0,1,Scotland
Mattar Al-Mukhaini,1,64.0,0,0,0,1,1,Taiwan
Matteo Darmian,0,65.0,0,0,0,1,1,Azerbaijan
Matteo Pessina,1,144.0,0,0,2,0,2,Italy
Matteo Vitaioli,0,55.0,0,0,0,1,1,Lithuania
Matthew Amoah,1,439.0,0,0,5,4,9,Ghana
Matthew Bingley,0,66.0,0,0,1,0,1,Australia
Matthew Booth,0,5.0,0,0,1,0,1,South Africa
Matthew Garbett,1,90.0,0,0,0,1,1,Solomon Islands
Matthew Hoppe,0,83.0,0,0,1,0,1,United States
Matthew Upson,1,37.0,0,0,0,1,1,Germany
Matthias Döschner,0,84.0,0,0,0,1,1,Iceland
Matthias Ginter,0,41.0,0,0,1,0,1,Germany
Matthias Herget,0,83.0,0,0,0,2,2,Czechoslovakia
Matthias Liebers,0,40.0,0,0,1,0,1,German DR
Matthias Phaeton,1,20.0,0,0,0,1,1,Suriname
Matthias Sammer,2,349.0,0,0,4,2,6,Iceland
Matthias Sindelar,1,111.0,0,0,2,0,2,Austria
Matthijs de Ligt,0,48.0,0,0,1,0,1,Netherlands
Matthías Hallgrímsson,0,25.0,0,0,0,1,1,German DR
Matti Paatelainen,0,77.0,0,0,1,2,3,Czechoslovakia
Mattia Destro,0,5.0,0,0,1,0,1,Italy
Mattia Stefanelli,0,136.0,1,0,0,2,2,Norway
Mattias Jonson,1,361.0,0,0,3,4,7,Sweden
Mattias Käit,1,239.0,0,0,4,1,5,Estonia
Mattias Svanberg,0,72.0,0,0,1,0,1,Sweden
Matty Geoghegan,0,37.0,0,0,0,1,1,Norway
Matías Campos,0,86.0,0,0,1,0,1,Chile
Matías Fernández,0,390.0,0,0,3,4,7,Chile
Matías Jadue,0,90.0,0,0,0,1,1,Saudi Arabia
Matěj Vydra,0,128.0,0,0,0,2,2,Armenia
Maung Maung Lwin,0,63.0,0,0,1,0,1,Myanmar
Mauri Vanhanen,0,72.0,0,0,1,0,1,Finland
Mauri Wasi,2,107.0,0,0,1,1,2,Papua New Guinea
Maurice Escalona,0,161.0,0,0,2,1,3,Aruba
Maurice Martens,0,32.0,0,0,2,0,2,Belgium
Maurice Sunguti,0,145.0,0,0,0,2,2,Burkina Faso
Maurice Tillotson,1,7.0,1,0,1,0,1,Indonesia
Maurice Willems,0,168.0,0,0,0,3,3,France
Mauricio Alonso Rodríguez,0,90.0,0,0,0,1,1,Haiti
Mauricio Cienfuegos,0,315.0,0,0,5,0,5,El Salvador
Mauricio Ernesto González,0,90.0,0,0,0,1,1,Suriname
Mauricio Isla,0,152.0,0,0,2,0,2,Chile
Mauricio Molina,1,79.0,0,0,1,0,1,Colombia
Mauricio Pineda,1,36.0,0,0,1,0,1,Argentina
Mauricio Pinilla,0,275.0,0,0,1,4,5,Chile
Mauricio Pochettino,0,67.0,0,0,0,1,1,Paraguay
Mauricio Ramos,1,87.0,0,0,0,1,1,Chile
Mauricio Serna,0,120.0,0,2,0,2,2,Bolivia
Mauricio Solís,0,115.0,0,0,1,1,2,Costa Rica
Mauricio Wright,3,191.0,0,0,1,2,3,Colombia
Maurinho,1,128.0,0,0,2,0,2,Brazil
Mauro Camoranesi,0,134.0,0,0,0,3,3,Belarus
Mauro Rosales,0,14.0,0,0,0,1,1,Peru
Mauro Valentini,0,110.0,1,0,1,1,2,San Marino
Mavango Kiala,0,85.0,0,0,0,1,1,Sudan
Mavuba Mafuila,0,89.0,0,1,1,0,1,DR Congo
Mawa Inunu,0,42.0,0,0,1,0,1,DR Congo
Max Gradel,6,264.0,0,0,2,5,7,Ivory Coast
Max Hagmayr,0,24.0,0,0,1,0,1,Austria
Max Kruse,2,207.0,0,0,1,2,3,Gibraltar
Max Llovera,0,82.0,0,0,0,1,1,Hungary
Max Lorenz,0,32.0,0,0,1,0,1,Germany
Max Morlock,6,545.0,0,0,9,3,12,Germany
Maxi Gómez,0,90.0,0,0,1,0,1,Uruguay
Maxi Pereira,1,141.0,0,0,2,1,3,Uruguay
Maxi Rodríguez,3,341.0,0,0,4,3,7,Argentina
Maxim Fedin,0,62.0,0,0,1,0,1,Kazakhstan
Maxime Bossis,1,89.0,0,0,1,0,1,France
Maxime Camara,0,28.0,0,0,1,0,1,Guinea
Maxime Chanot,0,126.0,1,1,2,0,2,Luxembourg
Maximilian Göppel,0,227.0,2,0,1,2,3,Israel
Maxwel Cornet,2,208.0,0,0,2,1,3,Ivory Coast
May Mahlangu,0,71.0,0,0,1,0,1,South Africa
Maya Yoshida,2,608.0,0,0,8,1,9,Japan
Mayanga Maku,5,215.0,0,0,0,7,7,Sudan
Maykel Galindo,1,72.0,0,0,0,1,1,Costa Rica
Maynor Figueroa,1,75.0,0,0,0,2,2,Trinidad and Tobago
Mayron George,1,30.0,0,0,1,0,1,Costa Rica
Mazinho Oliveira,1,16.0,0,0,1,1,2,Brazil
Mbala Mbuta Biscotte,0,75.0,0,0,1,0,1,DR Congo
Mbark Boussoufa,1,90.0,0,0,0,1,1,South Africa
Mbiamcie Mvoubi,0,89.0,0,1,1,0,1,Congo
Mbo Mpenza,0,123.0,0,0,2,0,2,Belgium
Mbulelo Mabizela,0,108.0,0,0,2,0,2,South Africa
Mbuleya Tondelva,0,150.0,0,0,1,1,2,Mauritius
Mbungu Ekofa,1,137.0,0,0,1,1,2,DR Congo
Mbwana Samatta,1,289.0,0,0,5,1,6,Tanzania
McDonald Mariga,0,84.0,0,1,2,0,2,Kenya
Meaataz Kailouni,0,86.0,0,0,0,1,1,Kyrgyzstan
Mechack Jérôme,0,38.0,0,0,0,1,1,Grenada
Meddie Kagere,0,227.0,0,0,3,2,5,Rwanda
Medhi Benatia,0,30.0,0,0,0,1,1,Ivory Coast
Medin Zhega,0,31.0,0,0,1,0,1,Albania
Mehdi Abtahi,1,22.0,0,0,0,1,1,Taiwan
Mehdi Ben Slimane,2,103.0,0,0,2,1,3,Rwanda
Mehdi Fonounizadeh,2,95.0,0,0,0,2,2,Saudi Arabia
Mehdi Ghayedi,1,84.0,0,0,0,1,1,Cambodia
Mehdi Hasheminasab,0,54.0,0,0,1,0,1,Iran
Mehdi Mahdavikia,2,439.0,0,0,4,5,9,Maldives
Mehdi Monajati,0,19.0,0,0,1,0,1,Iran
Mehdi Nafti,0,27.0,0,0,0,1,1,Botswana
Mehdi Taremi,7,1007.0,0,1,9,11,20,Iran
Mehdi Torabi,0,89.0,0,0,1,0,1,Iran
Mehmed Baždarević,0,188.0,0,0,0,3,3,Wales
Mehmet Aurélio,0,72.0,0,0,1,0,1,Turkey
Mehmet Durakovic,0,227.0,0,0,3,0,3,Australia
Mehmet Oğuz,0,85.0,0,0,1,0,1,Turkey
Mehmet Scholl,1,177.0,0,0,3,0,3,Germany
Mehmet Türkkan,0,51.0,0,0,1,0,1,Turkey
Mehmet Özgül,0,22.0,0,0,1,0,1,Turkey
Meho Kodro,0,59.0,0,0,1,1,2,Slovenia
Mehrdad Minavand,3,296.0,0,0,0,4,4,Thailand
Mehrdad Mohammadi,0,85.0,0,0,1,0,1,Iran
Mei Fang,0,10.0,0,0,1,0,1,China PR
Meinhard Olsen,0,83.0,0,0,0,1,1,Moldova
Mejdi Traoui,1,82.0,0,0,1,0,1,Tunisia
Mekan Nasyrow,0,83.0,0,0,2,0,2,Turkmenistan
Mekan Saparow,0,73.0,1,0,1,1,2,Oman
Mel Charles,0,6.0,0,0,0,1,1,German DR
Meli Vuilabasa,2,266.0,0,0,3,1,4,Fiji
Melih Atacan,0,54.0,0,0,1,0,1,Turkey
Melis Asprou,0,22.0,0,0,1,0,1,Cyprus
Melvin Valies,1,65.0,0,0,0,1,1,Montserrat
Melvin Valladares,1,145.0,0,0,2,0,2,Honduras
Memphis Depay,3,1392.0,0,6,17,9,26,Australia
Meng Kam Jong,0,76.0,0,0,1,0,1,Macau
Mengistu Worku,5,731.0,0,0,9,2,11,Ethiopia
Mengitsu Hussien,0,7.0,0,0,1,0,1,Ethiopia
Merih Demiral,0,188.0,2,0,3,0,3,Italy
Merlyn Membreño,0,65.0,0,0,1,0,1,Honduras
Merouane Zemmama,0,66.0,0,0,1,0,1,Morocco
Mert Müldür,0,84.0,0,0,1,0,1,Turkey
Meshach Wade,0,130.0,0,0,2,0,2,Bermuda
Meshal Abdullah,0,86.0,0,0,0,1,1,Laos
Meshal Mubarak,0,140.0,0,0,2,0,2,Qatar
Mesut Özil,4,1051.0,0,4,12,6,18,Ghana
Metin Kurt,0,4.0,0,0,1,0,1,Turkey
Metin Oktay,0,166.0,0,0,2,1,3,Norway
Metin Tekin,0,112.0,0,0,1,1,2,Albania
Metodije Spasovski,0,64.0,0,0,2,0,2,Yugoslavia
Mevlüt Erdinç,0,178.0,0,0,1,2,3,Turkey
Mexhit Haxhiu,0,77.0,0,0,1,0,1,Albania
Mica Pinto,0,8.0,0,0,1,0,1,Luxembourg
Micah Hyde,0,40.0,0,0,0,1,1,El Salvador
Micah Lea'alafa,0,102.0,0,1,2,0,2,Solomon Islands
Micah Richards,0,66.0,0,0,1,0,1,England
Michael Amir Murillo,1,72.0,1,0,2,0,2,Panama
Michael Arroyo,0,164.0,0,0,0,2,2,Colombia
Michael Ballack,4,1030.0,0,8,15,12,27,Greece
Michael Barrantes,2,129.0,0,0,2,0,2,Costa Rica
Michael Baur,0,98.0,1,0,2,2,4,Austria
Michael Beauchamp,0,21.0,0,0,0,1,1,Thailand
Michael Bethel,0,40.0,0,0,1,0,1,Bahamas
Michael Boxall,0,31.0,1,0,1,0,1,Russia
Michael Bradley,2,514.0,0,0,9,3,12,United States
Michael Chabala,1,167.0,0,0,3,1,4,Zambia
Michael Crawford,0,50.0,0,0,1,0,1,Saint Kitts and Nevis
Michael Degiorgio,0,102.0,0,0,0,2,2,Spain
Michael Dupuy,1,90.0,0,0,0,1,1,New Caledonia
Michael Eneramo,0,80.0,0,0,1,0,1,Nigeria
Michael Essien,0,249.0,0,1,5,1,6,Ghana
Michael Estrada,0,234.0,0,0,5,1,6,Ecuador
Michael Forde,0,89.0,0,0,1,0,1,Barbados
Michael Foster,0,150.0,0,0,3,1,4,Papua New Guinea
Michael Glowatzky,0,11.0,0,0,1,0,1,German DR
Michael Gravgaard,0,167.0,0,0,1,3,4,Denmark
Michael Gregoritsch,1,163.0,0,0,2,0,2,Austria
Michael Groom,1,6.0,0,0,1,0,1,New Zealand
Michael Hughes,0,183.0,0,0,2,1,3,Portugal
Michael Junior Palusami,1,20.0,0,0,1,0,1,Samoa
Michael Keane,0,30.0,0,0,0,1,1,Montenegro
Michael Klein,0,109.0,0,0,1,1,2,Romania
Michael Krohn-Dehli,2,81.0,0,0,2,2,4,Cyprus
Michael Lang,0,94.0,0,0,1,1,2,Albania
Michael Laudrup,3,825.0,0,3,14,5,19,Denmark
Michael Lohai,1,71.0,0,0,0,1,1,American Samoa
Michael McGarry,0,104.0,0,0,2,0,2,New Zealand
Michael McGlinchey,1,183.0,0,0,3,1,4,New Zealand
Michael Mifsud,1,706.0,0,2,9,5,14,Malta
Michael Ngadeu-Ngadjui,3,240.0,0,0,3,1,4,Cameroon
Michael O'Neill,0,214.0,0,0,2,2,4,Malta
Michael Obiku,0,67.0,0,0,0,1,1,Angola
Michael Olunga,2,289.0,0,0,4,3,7,Mauritius
Michael Orozco,0,136.0,0,0,1,1,2,United States
Michael Owen,5,1194.0,0,1,14,13,27,Romania
Michael Preetz,1,6.0,0,0,1,0,1,Germany
Michael Rabeson,0,26.0,0,0,1,0,1,Madagascar
Michael Robinson,0,128.0,0,0,2,2,4,Republic of Ireland
Michael Schjønberg,0,110.0,0,0,1,2,3,Cyprus
Michael Smith,0,7.0,0,0,0,1,1,Germany
Michael Stocklasa,0,90.0,0,0,1,0,1,Liechtenstein
Michael Streiter,0,48.0,0,0,1,0,1,Austria
Michael Umaña,0,22.0,0,0,1,0,1,Costa Rica
Michael Zandberg,0,90.0,0,0,1,0,1,Israel
Michael Zisser,0,89.0,0,0,0,1,1,Finland
Michail Antonio,0,109.0,0,1,1,2,3,El Salvador
Michal Bílek,2,420.0,0,3,5,2,7,Czechoslovakia
Michal Horňák,0,10.0,0,0,1,0,1,Czech Republic
Michal Kadlec,0,326.0,1,3,1,4,5,Czech Republic
Michal Krmenčík,0,85.0,0,0,3,1,4,Czech Republic
Michal Ďuriš,0,110.0,0,0,0,1,1,Northern Ireland
Michalis Kapsis,0,43.0,0,0,0,1,1,Georgia
Michalis Konstantinou,0,898.0,0,4,10,12,22,Cyprus
Michalis Kritikopoulos,0,80.0,0,0,0,1,1,Malta
Michalis Yasemis,0,118.0,0,1,1,1,2,Cyprus
Michaël Maria,2,36.0,0,0,0,2,2,British Virgin Islands
Michał Żewłakow,0,93.0,1,2,3,0,3,Poland
Michel Bassolé,2,50.0,0,0,0,2,2,Nigeria
Michel Bouanga,0,127.0,0,0,2,0,2,Congo
Michel De Wolf,1,64.0,0,0,1,0,1,Belgium
Michel Goba,0,75.0,0,0,1,0,1,Ivory Coast
Michel Hmaé,6,579.0,0,0,10,1,11,New Caledonia
Michel Kira,0,26.0,0,0,1,0,1,Madagascar
Michel Minko,0,37.0,0,0,1,0,1,Gabon
Michel Mézy,0,63.0,0,0,1,0,1,France
Michel Ngonge,0,60.0,0,0,1,1,2,Mauritius
Michel Platini,4,1336.0,0,3,17,10,27,Bulgaria
Michel Reuter,0,88.0,0,0,0,1,1,Switzerland
Michel Valke,0,15.0,1,0,1,0,1,Austria
Michele Cevoli,0,96.0,2,0,2,0,2,Azerbaijan
Michele Polverino,0,128.0,0,0,3,0,3,Liechtenstein
Michy Batshuayi,3,537.0,0,1,4,6,10,Belgium
Michél Mazingu-Dinzey,0,52.0,0,0,1,0,1,DR Congo
Mick Channon,0,343.0,0,1,3,3,6,England
Mick Martin,0,171.0,1,0,2,2,4,France
Mickaël Poté,2,101.0,0,0,1,2,3,Benin
Mickey Thomas,0,107.0,0,0,2,0,2,Wales
Mickey Trotman,1,101.0,0,0,0,1,1,Costa Rica
Mickey Walsh,0,145.0,0,0,1,1,2,Iceland
Mickey Weche,1,89.0,0,1,0,1,1,Nigeria
Mido,1,287.0,0,1,5,1,6,Egypt
Miel Pijs,0,35.0,0,0,1,0,1,Netherlands
Miguel Aguilar,0,202.0,0,0,1,3,4,Venezuela
Miguel Almirón,1,112.0,0,1,1,1,2,Chile
Miguel Angel Lauri,1,28.0,0,0,1,0,1,Argentina
Miguel Augusto Prince,0,133.0,0,0,3,0,3,Colombia
Miguel Borja,1,254.0,0,2,5,0,5,Colombia
Miguel Busquets,1,71.0,0,0,1,0,1,Chile
Miguel Camargo,1,123.0,0,0,1,2,3,Chile
Miguel Dellavalle,0,13.0,0,0,0,1,1,Chile
Miguel Echenausi,1,89.0,0,0,0,1,1,United States
Miguel Estrada,0,3.0,0,0,0,1,1,Nicaragua
Miguel Gandara,0,90.0,0,0,1,0,1,Cuba
Miguel González,0,97.0,0,0,2,0,2,Spain
Miguel Layún,0,20.0,0,0,0,1,1,United States
Miguel Martínez,1,57.0,0,0,1,0,1,Uruguay
Miguel María Michelagnoli,0,47.0,0,0,1,0,1,Paraguay
Miguel Mea Vitali,0,24.0,0,0,1,0,1,Venezuela
Miguel Mercado,1,78.0,0,0,0,1,1,Chile
Miguel Peredo,1,117.0,0,0,1,1,2,Argentina
Miguel Pereira,1,86.0,0,0,1,0,1,Angola
Miguel Pérez,0,38.0,0,0,1,0,1,Dominican Republic
Miguel Sabah,4,263.0,0,0,5,0,5,Mexico
Miguel Veloso,0,222.0,0,0,2,1,3,Portugal
Miguel Villalta,1,27.0,0,0,0,1,1,Uruguay
Miguel Zepeda,1,283.0,0,0,3,2,5,Chile
Miguel Ángel Benítez,1,209.0,0,0,5,2,7,Paraguay
Miguel Ángel Brindisi,1,108.0,0,0,3,0,3,Argentina
Miguel Ángel Bustillo,0,20.0,0,0,1,0,1,Spain
Miguel Ángel Gamboa,0,145.0,0,0,1,2,3,Bolivia
Miguel Ángel Loayza,4,136.0,0,0,3,2,5,Peru
Miguel Ángel Nadal,0,123.0,0,0,1,1,2,Spain
Miguel Ángel Neira,1,87.0,0,1,1,1,2,Chile
Miguel Ángel Noro,0,59.0,1,0,0,1,1,Bolivia
Miguel Ángel Ponce,1,90.0,0,0,0,1,1,Martinique
Miguel Ángel Russo,0,27.0,0,0,1,0,1,Argentina
Miha Mevlja,0,143.0,1,0,1,1,2,Slovakia
Miha Zajc,0,147.0,0,0,2,2,4,Slovenia
Mihai Pintilii,0,31.0,0,0,1,0,1,Romania
Mihail Aleksandrov,0,26.0,0,1,1,1,2,Bulgaria
Mihail Lozanov,0,66.0,0,0,0,1,1,Austria
Mihail Titow,0,23.0,0,0,1,0,1,Turkmenistan
Mihails Zemļinskis,0,404.0,1,3,2,5,7,Belarus
Mihal Gjika,0,15.0,0,0,1,0,1,Albania
Mihály Korhut,0,10.0,0,0,1,0,1,Hungary
Mihály Kozma,0,9.0,0,0,1,0,1,Hungary
Mihály Lantos,2,78.0,0,1,1,1,2,Hungary
Miikka Toivola,0,60.0,0,0,1,1,2,Finland
Mijat Gaćinović,0,106.0,0,0,1,1,2,Georgia
Mika Lipponen,0,238.0,0,0,2,3,5,Turkey
Mika Nurmela,0,84.0,0,0,1,1,2,Azerbaijan
Mika Väyrynen,0,166.0,0,0,2,1,3,Poland
Mikael Forssell,0,930.0,0,2,16,4,20,Finland
Mikael Lustig,0,241.0,0,0,2,3,5,Sweden
Mikael Nilsson,0,3.0,0,0,0,1,1,Poland
Mikalay Ryndzyuk,0,70.0,0,0,1,1,2,Poland
Mike England,0,171.0,0,0,2,1,3,Wales
Mike Hanke,0,88.0,0,0,1,0,1,Germany
Mike Havenaar,0,58.0,0,0,2,0,2,Japan
Mike Okoth Origi,0,344.0,0,0,5,1,6,Guinea
Mike Ott,0,83.0,0,0,1,0,1,Philippines
Mike Summerbee,0,9.0,0,0,1,0,1,England
Mikel John Obi,3,234.0,0,0,5,0,5,Nigeria
Mikel Oyarzabal,1,280.0,0,0,2,1,3,Spain
Mikel Villanueva,0,80.0,0,0,1,1,2,Peru
Mikhail Gordeichuk,0,96.0,0,0,2,0,2,Belarus
Mikhail Sivakow,0,33.0,0,1,1,0,1,Belarus
Mikheil Ashvetia,0,17.0,0,0,1,0,1,Georgia
Mikheil Kavelashvili,0,52.0,0,0,1,0,1,Georgia
Mikheil Meskhi,2,174.0,0,0,2,1,3,Russia
Mikkel Beck,0,54.0,0,0,1,1,2,Belgium
Mikkel Damsgaard,0,119.0,0,0,3,1,4,Denmark
Mikkel Diskerud,0,83.0,0,0,1,0,1,United States
Miklos Molnar,0,129.0,0,0,2,0,2,Denmark
Miklós Fehér,0,259.0,0,0,0,4,4,Azerbaijan
Miklós Kovács,1,89.0,0,0,0,1,1,Peru
Miku,2,336.0,0,0,3,2,5,Venezuela
Milad Meydavoudi,0,7.0,0,0,0,1,1,Indonesia
Milad Mohammadi,1,58.0,0,0,0,1,1,Cambodia
Milan Albrecht,0,30.0,0,0,1,0,1,Czechoslovakia
Milan Badelj,1,85.0,0,0,0,2,2,Malta
Milan Baroš,5,1418.0,0,1,20,5,25,Czech Republic
Milan Dolinský,0,180.0,0,0,2,1,3,Czechoslovakia
Milan Dvořák,2,32.0,0,1,1,1,2,Czechoslovakia
Milan Galić,4,623.0,0,0,5,12,17,Yugoslavia
Milan Jovanović,1,387.0,0,0,3,5,8,Finland
Milan Luhový,1,216.0,0,0,1,2,3,Czechoslovakia
Milan Osterc,0,299.0,0,0,3,1,4,Slovenia
Milan Rapaić,2,177.0,0,2,3,1,4,Italy
Milan Ristovski,0,79.0,0,0,0,1,1,Armenia
Milan Smiljanić,0,75.0,0,0,0,1,1,Azerbaijan
Milan Đurić,0,138.0,0,0,1,1,2,Bosnia and Herzegovina
Milan Škoda,1,236.0,0,0,3,0,3,Czech Republic
Milan Škriniar,1,272.0,2,0,4,1,5,Northern Ireland
Milciades Morel,0,137.0,0,0,2,1,3,Brazil
Mile Jedinak,5,884.0,1,11,11,7,18,Australia
Mile Krstev,0,117.0,0,0,2,0,2,North Macedonia
Mile Sterjovski,0,241.0,0,0,4,0,4,Australia
Milenko Ačimovič,1,466.0,0,1,9,0,9,Slovenia
Milenko Špoljarić,0,431.0,0,2,5,1,6,Cyprus
Miles Robinson,0,167.0,0,0,2,0,2,United States
Milivoje Novaković,0,947.0,0,2,14,7,21,Slovenia
Milko Djurovski,0,29.0,0,0,0,1,1,Bulgaria
Millan Baçi,0,18.0,0,0,1,0,1,Albania
Miller Bolaños,3,319.0,0,0,4,1,5,Ecuador
Millón Medeiros,0,24.0,0,1,1,0,1,Brazil
Milot Rashica,0,38.0,0,0,0,2,2,Montenegro
Milovan Mirosevic,0,107.0,0,0,1,1,2,Argentina
Miloš Krasić,0,49.0,0,0,1,1,2,Serbia
Miloš Milutinović,1,128.0,0,0,3,1,4,Yugoslavia
Miloš Šestić,0,112.0,0,0,0,2,2,France
Milton Coimbra,0,198.0,0,0,2,1,3,Bolivia
Milton Karisa,0,11.0,0,0,0,1,1,Congo
Milton Meléndez,0,114.0,0,0,1,2,3,Jamaica
Milton Núñez,2,722.0,0,0,8,4,12,Honduras
Milutin Pajević,0,57.0,0,0,3,0,3,Yugoslavia
Milyon Beguashaw,0,38.0,0,0,1,0,1,Ethiopia
Mimi El-Sherbini,1,64.0,0,0,1,0,1,Egypt
Mimis Domazos,0,91.0,0,0,1,1,2,Romania
Mimis Papaioannou,1,681.0,0,0,9,3,12,Greece
Mimoun Mahi,0,88.0,0,0,1,0,1,Morocco
Mindaugas Kalonas,0,106.0,0,1,1,1,2,Romania
Minervino Pietra,0,65.0,0,0,1,0,1,Portugal
Mini Jakobsen,0,133.0,0,0,2,2,4,Italy
Minor López,0,172.0,0,0,1,2,3,Belize
Minyahil Teshome,1,61.0,0,0,0,1,1,Central African Republic
Miodrag Belodedici,0,42.0,0,0,1,0,1,Romania
Miodrag Ješić,0,66.0,0,0,1,0,1,Yugoslavia
Miralem Pjanić,1,543.0,0,2,8,4,12,Luxembourg
Miralem Sulejmani,0,90.0,0,0,1,0,1,Serbia
Miran Pavlin,1,130.0,0,0,0,2,2,Ukraine
Miranda,0,2.0,0,0,1,0,1,Brazil
Mirbağır İsayev,0,73.0,0,0,1,0,1,Azerbaijan
Mircea Dridea,0,139.0,0,0,1,2,3,Romania
Mircea Lucescu,0,276.0,0,1,3,2,5,Cyprus
Mircea Sandu,0,90.0,0,0,2,0,2,Romania
Mirco Gennari,0,87.0,1,0,1,0,1,Spain
Mirdjalal Kasimov,0,71.0,0,0,1,0,1,Uzbekistan
Mirel Josa,0,69.0,0,0,1,0,1,Albania
Mirel Rădoi,0,25.0,0,0,0,1,1,Luxembourg
Mirjalol Qosimov,7,747.0,0,1,7,8,15,Qatar
Mirko Hrgović,0,64.0,0,0,0,2,2,Malta
Mirko Ivanovski,0,59.0,0,0,1,0,1,North Macedonia
Mirko Palazzi,0,74.0,0,0,0,1,1,Azerbaijan
Mirko Vučinić,0,433.0,0,1,7,2,9,Montenegro
Mirlan Murzaev,3,297.0,0,1,0,6,6,United Arab Emirates
Miro,0,52.0,0,0,1,0,1,Mozambique
Miroslav Baranek,0,12.0,0,0,0,1,1,Bosnia and Herzegovina
Miroslav Chvíla,0,78.0,0,0,0,1,1,Romania
Miroslav Gajdůšek,0,149.0,0,0,0,2,2,Scotland
Miroslav Gjokić,0,142.0,0,0,0,2,2,Romania
Miroslav Kadlec,0,82.0,0,0,2,0,2,Czechoslovakia
Miroslav Karhan,0,463.0,0,1,7,2,9,Slovakia
Miroslav Klose,13,2316.0,0,0,29,19,48,Germany
Miroslav Pavlović,0,67.0,0,0,0,1,1,Spain
Miroslav Romaschenko,0,68.0,0,0,1,0,1,Belarus
Miroslav Sovič,0,3.0,0,0,0,1,1,Liechtenstein
Miroslav Stevanović,0,84.0,0,0,0,1,1,Finland
Miroslav Stoch,0,149.0,0,0,2,1,3,Slovakia
Miroslav Đukić,1,91.0,0,0,1,1,2,Hungary
Mirosław Szymkowiak,0,41.0,0,0,1,1,2,Poland
Mirosław Trzeciak,0,99.0,0,0,2,0,2,Poland
Mirsad Bešlija,0,41.0,0,0,0,1,1,Spain
Mirsad Hibić,0,29.0,1,0,0,1,1,Bosnia and Herzegovina
Misagh Bahadoran,1,145.0,0,0,2,1,3,Philippines
Mislav Oršić,2,127.0,0,0,2,0,2,Croatia
Mitchell Duke,6,350.0,0,0,4,2,6,Australia
Mitchell Joseph,0,65.0,0,0,1,0,1,Dominica
Mithun Chowdhury,0,52.0,0,0,1,0,1,Bangladesh
Mitko Stojkovski,0,150.0,0,1,3,2,5,North Macedonia
Mitsunori Yoshida,1,36.0,0,0,0,1,1,Bangladesh
Mitsuo Ogasawara,0,106.0,0,0,2,1,3,Japan
Mixu Paatelainen,0,672.0,0,0,9,4,13,Wales
Mladen Bartolović,0,45.0,0,0,0,1,1,Malta
Mladen Krstajić,0,74.0,0,0,0,1,1,Switzerland
Mladen Mladenović,0,7.0,0,0,1,0,1,Croatia
Mladen Petrić,0,432.0,0,0,6,4,10,Croatia
Mladen Rudonja,0,55.0,0,0,0,1,1,Romania
Mladen Vasilev,0,37.0,0,0,0,1,1,Norway
Mo Johnston,1,422.0,0,1,7,3,10,Scotland
Mo'ayyad Salim,0,70.0,0,0,1,0,1,Jordan
Moayad Ajan,1,42.0,0,0,0,1,1,Afghanistan
Mobarak Al-Faneeni,0,49.0,0,0,1,0,1,Kuwait
Moctar Sidi El Hacen,1,72.0,0,1,0,1,1,Mali
Moderato Wisintainer,2,110.0,0,0,0,2,2,Bolivia
Modeste Eta,0,64.0,0,0,0,1,1,Equatorial Guinea
Modeste M'Bami,2,107.0,0,0,2,0,2,Cameroon
Modestus Haas,0,60.0,1,0,1,0,1,Romania
Modibo Maïga,2,157.0,0,0,2,1,3,Mali
Modibo Sidibé,0,34.0,0,0,0,1,1,Tunisia
Mogakolodi Ngele,1,218.0,0,0,4,0,4,Botswana
Mogens Berg,0,60.0,0,0,0,1,1,Greece
Mogogi Gabonamong,0,12.0,0,0,1,0,1,Botswana
Mohaisen Al-Jam'an,1,207.0,0,0,3,0,3,Saudi Arabia
Mohamad Kdouh,3,107.0,0,0,1,2,3,Lebanon
Mohamad Moustafa Kadir,1,193.0,0,2,2,1,3,Taiwan
Mohamad Yehya Al Rashed,0,76.0,0,0,1,0,1,Syria
Mohamadi Balma,0,27.0,1,0,1,0,1,Guinea
Mohamadou Sumareh,0,220.0,0,0,2,2,4,Malaysia
Mohamadu Salisu,0,55.0,0,0,1,0,1,Ghana
Mohamed Abdallah,0,68.0,0,0,0,1,1,Tanzania
Mohamed Abdel-Shafy,1,80.0,0,0,0,1,1,Algeria
Mohamed Abdelmonem,1,35.0,0,0,1,0,1,Egypt
Mohamed Abdelrahman,0,145.0,0,0,2,0,2,Sudan
Mohamed Abdelwahab,0,88.0,0,0,0,1,1,Sudan
Mohamed Abdulazeez,0,13.0,0,0,0,1,1,Oman
Mohamed Aboutrika,4,1238.0,0,4,10,10,20,Sudan
Mohamed Ahmed,0,111.0,0,0,2,0,2,United Arab Emirates
Mohamed Ahmed Bashir,2,106.0,0,0,2,0,2,Sudan
Mohamed Akid,0,158.0,0,0,2,1,3,Tunisia
Mohamed Al Ghanodi,0,48.0,0,0,0,1,1,Rwanda
Mohamed Al Zeno,1,209.0,0,1,2,2,4,Syria
Mohamed Al-Diabaz,0,75.0,0,0,2,0,2,Jordan
Mohamed Al-Romaihi,1,290.0,0,0,2,2,4,Bahrain
Mohamed Al-Shehhi,0,174.0,0,1,3,2,5,United Arab Emirates
Mohamed Al-Suwaiyed Shehrani,1,82.0,0,0,0,1,1,Syria
Mohamed Ala'a,0,23.0,0,0,1,0,1,Egypt
Mohamed Ali,0,46.0,0,0,1,0,1,Ethiopia
Mohamed Ali Hamoud,0,37.0,0,0,1,0,1,Oman
Mohamed Ali Mahjoubi,0,178.0,0,0,3,0,3,Tunisia
Mohamed Ali Manser,1,70.0,0,0,1,0,1,Tunisia
Mohamed Amine Ben Amor,0,83.0,0,0,0,1,1,Guinea
Mohamed Aoudou,0,176.0,0,0,2,0,2,Benin
Mohamed Barakat,1,179.0,0,0,3,1,4,Egypt
Mohamed Bayo,2,123.0,0,0,1,1,2,Sudan
Mohamed Boussati,0,30.0,0,0,1,0,1,Morocco
Mohamed Brahimi,0,60.0,0,0,1,0,1,Algeria
Mohamed Daima,0,71.0,0,0,0,1,1,Ghana
Mohamed Dräger,0,31.0,0,0,1,0,1,Tunisia
Mohamed El Monir,0,126.0,0,0,0,2,2,Rwanda
Mohamed El Rabty,0,88.0,0,0,1,0,1,Libya
Mohamed El-Akad,0,42.0,0,0,1,0,1,Egypt
Mohamed El-Sayed,0,72.0,0,0,2,0,2,Qatar
Mohamed El-Seyagui,1,86.0,0,0,1,0,1,Egypt
Mohamed Elneny,1,72.0,0,0,2,1,3,Egypt
Mohamed Elyounoussi,0,340.0,0,0,2,4,6,San Marino
Mohamed Emara,0,15.0,0,0,1,0,1,Egypt
Mohamed Farouk,0,221.0,0,0,3,0,3,Egypt
Mohamed Gasri,0,160.0,0,0,1,1,2,Benin
Mohamed Hameed,0,90.0,0,0,1,0,1,Sri Lanka
Mohamed Hassan Abdullah,2,159.0,0,0,1,1,2,Yemen
Mohamed Hubail,1,308.0,0,0,3,2,5,China PR
Mohamed Husain,1,277.0,1,0,2,2,4,Kuwait
Mohamed Jameel,0,61.0,0,0,0,1,1,China PR
Mohamed Kaci-Saïd,0,67.0,0,0,0,1,1,Tunisia
Mohamed Kader,3,336.0,0,0,1,5,6,Ghana
Mohamed Kallon,1,158.0,0,1,2,1,3,Sierra Leone
Mohamed Kamara,0,11.0,0,0,1,0,1,Sierra Leone
Mohamed Khalfi,0,70.0,0,0,2,0,2,Morocco
Mohamed Konaté,2,139.0,0,0,0,2,2,Niger
Mohamed Koussa,0,49.0,0,0,1,0,1,Libya
Mohamed Latif,1,132.0,0,0,2,1,3,Egypt
Mohamed Liban,0,21.0,0,0,0,1,1,Eswatini
Mohamed M'Changama,0,70.0,0,0,0,1,1,Lesotho
Mohamed Madih,0,58.0,0,0,1,0,1,Morocco
Mohamed Magdy,0,9.0,0,2,2,0,2,Egypt
Mohamed Maghfour,0,14.0,0,0,1,0,1,Morocco
Mohamed Mesud,0,83.0,0,0,1,0,1,Ethiopia
Mohamed Morsi Hussein,4,151.0,0,0,4,0,4,Egypt
Mohamed Nagy,0,83.0,0,0,1,0,1,Egypt
Mohamed Nazeeh,0,80.0,0,0,1,0,1,Maldives
Mohamed Nizam,0,66.0,0,0,1,1,2,Mongolia
Mohamed Obaid,0,48.0,0,0,1,0,1,United Arab Emirates
Mohamed Obaid Al-Zahiri,1,11.0,1,0,0,1,1,United Arab Emirates
Mohamed Omer,0,127.0,0,0,2,1,3,United Arab Emirates
Mohamed Rashid,1,69.0,0,0,1,1,2,United Arab Emirates
Mohamed Salah,5,1026.0,0,3,9,10,19,Guinea
Mohamed Salah Abo Greisha,0,77.0,0,0,1,0,1,Egypt
Mohamed Salah Jedidi,2,168.0,0,0,2,2,4,Tunisia
Mohamed Salim,0,3.0,0,0,0,1,1,New Caledonia
Mohamed Salmeen,1,113.0,1,0,1,2,3,Kyrgyzstan
Mohamed Samadi,0,50.0,0,0,1,0,1,Morocco
Mohamed Shawky,1,178.0,0,0,1,2,3,Egypt
Mohamed Sissoko,1,79.0,0,0,1,1,2,Kenya
Mohamed Sylla,0,62.0,0,0,0,1,1,Cameroon
Mohamed Tayib Abdul Noor,0,83.0,0,0,1,0,1,Oman
Mohamed Timoumi,0,216.0,0,0,2,2,4,Senegal
Mohamed Wonkoye,1,127.0,0,1,1,1,2,Djibouti
Mohamed Yattara,3,255.0,0,0,3,3,6,Guinea
Mohamed Youssouf,0,72.0,0,0,0,1,1,Mozambique
Mohamed Zahid Hossain,0,22.0,0,0,1,0,1,Bangladesh
Mohamed Zidan,5,253.0,0,0,3,3,6,Egypt
Mohammad Afash,1,318.0,0,1,6,1,7,Taiwan
Mohammad Al Marmour,0,44.0,0,0,0,1,1,Lebanon
Mohammad Al-Sahlawi,3,1042.0,0,5,8,11,19,Hong Kong
Mohammad Al-Shalhoub,3,371.0,0,1,9,0,9,Saudi Arabia
Mohammad Alavi,0,38.0,0,0,0,1,1,China PR
Mohammad Hassan,1,74.0,0,0,0,1,1,Kyrgyzstan
Mohammad Hassan Ansarifard,0,50.0,0,0,0,1,1,Bangladesh
Mohammad Ibrahim Hussain,0,27.0,0,0,0,1,1,Brunei
Mohammad Jakalan,0,30.0,0,0,0,1,1,Saudi Arabia
Mohammad Kassas,0,90.0,0,0,1,0,1,Lebanon
Mohammad Mohebi,0,132.0,0,0,2,0,2,Iran
Mohammad Muharam,1,140.0,0,0,2,1,3,Jordan
Mohammad Nasuha,0,43.0,0,0,1,0,1,Indonesia
Mohammad Nosrati,1,138.0,0,0,1,1,2,Oman
Mohammad Nouri,1,83.0,0,0,0,1,1,United Arab Emirates
Mohammad Omar,0,122.0,0,0,1,3,4,Brunei
Mohammad Reza Khalatbari,0,174.0,0,0,1,2,3,Maldives
Mohammad Sadeghi,0,89.0,0,0,1,0,1,Iran
Mohammad Sultan,1,25.0,0,0,0,1,1,South Korea
Mohammad Umer,0,66.0,0,0,1,1,2,Pakistan
Mohammadou Idrissou,1,86.0,0,0,1,0,1,Cameroon
Mohammed Abdellaoue,0,163.0,0,1,1,1,2,Iceland
Mohammed Abdul Ghani,0,44.0,0,0,0,1,1,Syria
Mohammed Abdul Noor,2,103.0,0,0,0,2,2,Taiwan
Mohammed Abduljawad,1,65.0,0,0,0,1,1,Qatar
Mohammed Adolf Rishard,0,70.0,0,0,1,0,1,Tanzania
Mohammed Ahmed,0,52.0,0,0,1,0,1,Ghana
Mohammed Al Balushi,1,8.0,0,0,0,1,1,Iraq
Mohammed Al-Anbar,0,5.0,0,0,0,1,1,South Korea
Mohammed Al-Attas,0,74.0,1,0,0,1,1,United Arab Emirates
Mohammed Al-Fatil,1,37.0,0,0,1,0,1,Saudi Arabia
Mohammed Al-Ghafri,1,22.0,0,0,0,1,1,Bangladesh
Mohammed Al-Ghassani,0,70.0,0,0,0,1,1,Turkmenistan
Mohammed Al-Hardan,0,65.0,0,1,1,0,1,Bahrain
Mohammed Al-Hinai,0,202.0,0,0,0,3,3,India
Mohammed Al-Jaish,2,126.0,0,0,1,1,2,Palestine
Mohammed Al-Khilaiwi,0,116.0,0,0,2,0,2,Saudi Arabia
Mohammed Al-Musalami,1,90.0,0,0,1,0,1,Oman
Mohammed Al-Suwaiti,1,4.0,0,0,0,1,1,Qatar
Mohammed Ali El Khider,1,33.0,1,0,1,0,1,Cameroon
Mohammed Boqshan,1,56.0,0,0,1,0,1,Yemen
Mohammed Chaouch,1,158.0,0,0,5,1,6,Morocco
Mohammed Diarra,0,81.0,0,0,1,0,1,Guinea
Mohammed El Filali,0,91.0,0,0,2,0,2,Morocco
Mohammed Gargo,1,214.0,0,1,3,0,3,Ghana
Mohammed Ghaddar,0,427.0,0,2,3,4,7,Lebanon
Mohammed Gholam,1,61.0,0,0,1,0,1,Qatar
Mohammed Jewel Rana,2,100.0,0,0,2,0,2,Bangladesh
Mohammed Jumaa,0,90.0,0,0,1,0,1,United Arab Emirates
Mohammed Karam,0,90.0,0,0,1,0,1,Kuwait
Mohammed Kasola,0,179.0,0,0,3,1,4,Qatar
Mohammed Khalifa Al-Ammari,0,71.0,0,0,1,0,1,Qatar
Mohammed Khamis Al-Araimi,0,200.0,0,0,3,1,4,Oman
Mohammed Kudus,2,107.0,0,0,1,2,3,Ghana
Mohammed Lashaf,0,40.0,0,0,1,0,1,Morocco
Mohammed Lawal,0,120.0,0,1,1,1,2,Morocco
Mohammed Muntari,1,262.0,0,0,4,2,6,Qatar
Mohammed Musa,0,210.0,0,0,3,1,4,Qatar
Mohammed Noor,0,192.0,0,2,2,1,3,Saudi Arabia
Mohammed Ouseb,0,161.0,0,1,2,0,2,Namibia
Mohammed Razak,0,89.0,0,0,1,1,2,Indonesia
Mohammed Sahil,1,85.0,0,0,0,1,1,Ivory Coast
Mohammed Salem,0,44.0,0,0,1,0,1,Yemen
Mohammed Salem Al-Enazi,4,671.0,0,0,12,4,16,Qatar
Mohammed Salem Al-Mal,0,60.0,0,0,1,0,1,Qatar
Mohammed Salim,0,85.0,0,0,0,1,1,Nigeria
Mohammed Salisu,1,24.0,0,0,0,1,1,South Korea
Mohammed Sama,0,88.0,0,1,0,1,1,Nigeria
Mohammed Sangare,0,82.0,0,1,1,0,1,Liberia
Mohammed Sujan,2,162.0,0,0,2,0,2,Bangladesh
Mohammed Tayeb Al Alawi,0,77.0,0,0,2,0,2,Bahrain
Mohammed Zughair,0,30.0,0,0,0,1,1,Uzbekistan
Mohanad Ali,4,221.0,0,0,4,3,7,Iraq
Mohanad Salem,0,16.0,0,0,1,0,1,United Arab Emirates
Mohannad Abdul-Raheem,6,272.0,0,0,6,0,6,Iraq
Mohd Aidil Zafuan Abdul Radzak,0,8.0,0,0,0,1,1,Taiwan
Mohd Amri Yahyah,0,19.0,0,0,0,1,1,Kuwait
Mohd Bunyamin Omar,0,45.0,0,0,0,1,1,Bahrain
Mohd Noor Ali,0,65.0,0,0,1,0,1,Singapore
Mohd Rafi Ali,1,129.0,0,0,1,1,2,Indonesia
Mohd Safiq Rahim,0,68.0,0,0,1,1,2,Malaysia
Mohieddine Habita,0,119.0,0,1,2,0,2,Tunisia
Mohsen Garousi,0,144.0,0,0,2,1,3,Thailand
Mohsen Khalili,0,90.0,0,0,0,1,1,Syria
Mohsen Labidi,1,36.0,0,0,1,0,1,Tunisia
Mohsen Qarawi,1,53.0,0,0,1,1,2,Singapore
Mohsin Al-Khaldi,0,97.0,0,0,2,0,2,Oman
Mohsin Harthi,0,5.0,0,0,1,0,1,Saudi Arabia
Mohsin Yousifi,0,10.0,0,0,1,0,1,Iran
Moise Adilehou,1,53.0,0,0,0,1,1,Morocco
Moise Brou,0,81.0,0,0,1,0,1,Gabon
Moise Kean,0,183.0,0,0,4,0,4,Italy
Moise Poida,1,55.0,0,0,0,1,1,American Samoa
Moisés Caicedo,1,171.0,0,0,2,1,3,Ecuador
Moisés Hernández,1,77.0,0,1,1,1,2,British Virgin Islands
Moisés Villarroel,0,37.0,0,0,0,1,1,Bolivia
Moisés Villarroel Angulo,0,53.0,0,0,1,0,1,Bolivia
Mojtaba Jabbari,0,145.0,0,0,1,2,3,Iran
Mokhtar Dahari,1,50.0,0,0,0,1,1,China PR
Mokhtar Dhouieb,1,87.0,0,0,0,1,1,Mexico
Mokhtar Kalem,1,125.0,0,0,2,0,2,Algeria
Mokhtar Mokhtar,1,70.0,0,0,2,0,2,Egypt
Molesi Tokuma,1,48.0,1,0,0,1,1,Samoa
Momath Gueye,1,46.0,0,1,1,0,1,Senegal
Momo Soumah,0,218.0,0,0,3,1,4,Guinea
Momodou Ceesay,0,8.0,0,0,0,1,1,Tanzania
Momčilo Vukotić,0,44.0,0,0,2,0,2,Yugoslavia
Moncef Cherif,0,29.0,0,0,0,1,1,Ethiopia
Moncef Khouini,0,62.0,0,0,1,0,1,Tunisia
Monduone N'Kama,0,23.0,0,0,1,0,1,DR Congo
Mone Wamowe,0,37.0,0,0,0,2,2,Fiji
Mongi Delhoum,0,80.0,0,0,1,0,1,Tunisia
Mongkol Tossakrai,1,191.0,0,0,2,1,3,Thailand
Monsef Zerka,1,74.0,0,0,0,1,1,Namibia
Monès Chéry,1,85.0,0,1,0,2,2,Guadeloupe
Moon Jung-sik,0,110.0,0,0,2,0,2,South Korea
Morciré Sylla,3,178.0,0,0,2,1,3,Guinea
Mordechai Spiegler,4,449.0,0,1,6,3,9,Israel
Mordon Malitoli,1,87.0,0,0,0,1,1,Sierra Leone
Morgan Gould,0,14.0,0,0,0,1,1,Botswana
Morten Bisgaard,0,48.0,0,0,0,1,1,Iceland
Morten Gamst Pedersen,0,426.0,0,0,4,3,7,Norway
Morten Nordstrand,0,128.0,0,0,2,1,3,Denmark
Morten Rasmussen,0,129.0,0,0,3,0,3,Denmark
Morten Wieghorst,0,147.0,0,0,0,2,2,Saudi Arabia
Morteza Pouraliganji,2,173.0,0,0,2,1,3,Iran
Mory Koné,0,39.0,0,0,1,0,1,Guinea
Moses Chavula,0,220.0,1,0,1,2,3,Malawi
Moses Chikwalakwala,0,50.0,0,0,0,2,2,Namibia
Moses Msereko,1,32.0,0,0,0,1,1,Morocco
Moses Ramafole,0,64.0,0,0,0,1,1,Botswana
Moses Simon,1,127.0,0,0,2,1,3,Nigeria
Moses Simwala,0,204.0,0,0,2,1,3,Zambia
Moses Toata,1,89.0,0,0,1,0,1,Solomon Islands
Moshe Leon,0,20.0,0,0,1,0,1,Israel
Moshe Onana,5,336.0,0,0,5,0,5,Israel
Moshe Romano,3,123.0,0,0,2,1,3,Hong Kong
Moshe Selecter,0,75.0,0,0,1,0,1,Israel
Moshe Sinai,0,56.0,0,0,0,1,1,Scotland
Mostafa Mohamed,0,135.0,0,0,0,2,2,Gabon
Mostafa Taha,0,100.0,0,0,2,0,2,Egypt
Motasem Sabbou,0,87.0,0,0,0,1,1,Guinea
Mothobi Mvala,0,71.0,0,0,0,1,1,Ethiopia
Motohiro Yamaguchi,0,67.0,0,0,1,0,1,Japan
Mouagi,1,90.0,0,0,0,1,1,Australia
Mouhanad Boushi,0,163.0,0,0,3,0,3,Syria
Moulay Khanousi,1,27.0,0,0,0,1,1,Tunisia
Moumi Ngamaleu,0,61.0,0,1,0,1,1,Ivory Coast
Moumouni Dagano,2,1008.0,0,2,10,9,19,Burkina Faso
Mounir Diane,0,46.0,0,0,1,0,1,Morocco
Mounir El Hamdaoui,0,83.0,0,0,1,0,1,Morocco
Mourad Meziane,0,155.0,0,0,2,0,2,Algeria
Mouritala Ogunbiyi,0,98.0,0,0,2,0,2,Benin
Mousa Dembélé,0,315.0,0,0,5,0,5,Belgium
Moussa Badiane,0,83.0,0,0,2,0,2,Senegal
Moussa Camara,1,8.0,0,0,1,0,1,Guinea
Moussa Diakhité,1,42.0,0,0,0,1,1,Congo
Moussa Djenepo,0,19.0,0,0,0,1,1,Rwanda
Moussa Doumbia,1,85.0,0,0,1,0,1,Mali
Moussa Hirir,0,85.0,0,0,0,1,1,DR Congo
Moussa Hojeij,0,277.0,0,0,3,1,4,Lebanon
Moussa Kanfideni,0,82.0,0,0,1,1,2,Niger
Moussa Konaté,0,53.0,0,0,1,0,1,Senegal
Moussa Latoundji,1,90.0,0,0,0,1,1,Nigeria
Moussa Mallam,0,20.0,0,0,0,1,1,Angola
Moussa Marega,1,45.0,0,1,1,0,1,Mali
Moussa Maâzou,2,169.0,0,1,2,2,4,Somalia
Moussa N'Dao,1,56.0,0,0,0,1,1,Cameroon
Moussa N'Diaye,0,248.0,0,0,2,2,4,Benin
Moussa Samba,0,84.0,0,0,1,0,1,Mauritania
Moussa Saïb,0,125.0,0,1,1,1,2,Algeria
Moussa Sissako,0,36.0,1,0,0,1,1,Mali
Moussa Sissoko,1,73.0,0,0,0,1,1,Switzerland
Moussa Sow,4,424.0,0,1,4,2,6,Equatorial Guinea
Moussa Traoré,2,159.0,0,0,0,2,2,Congo
Moussa Wagué,1,71.0,0,0,0,1,1,Japan
Moussa Yahaya,0,112.0,0,0,2,0,2,Niger
Moustafa Abdou,2,155.0,0,0,6,0,6,Egypt
Moustapha Bangura,0,20.0,0,0,1,0,1,Sierra Leone
Moustapha Bayal Sall,1,45.0,0,0,0,1,1,Tunisia
Moustapha Choukri,0,179.0,0,0,1,2,3,Senegal
Moustapha Salifou,1,215.0,0,0,4,2,6,Togo
Moysés Ferreira Alves,1,80.0,0,0,1,0,1,Brazil
Mrisho Ngassa,0,11.0,0,0,0,1,1,Chad
Mthunzi Mkhontfo,0,45.0,0,0,0,1,1,Djibouti
Mu Kanazaki,0,98.0,0,0,1,1,2,Singapore
Mu'nas Dabbur,0,497.0,0,1,8,3,11,Israel
Muayad Al-Haddad,1,26.0,0,0,0,1,1,Iran
Mubarak Anber,1,47.0,1,0,0,1,1,Qatar
Mubarak Mustafa,3,613.0,0,2,8,3,11,Saudi Arabia
Mubarak Wakaso,4,331.0,0,3,6,2,8,Ghana
Muda Lawal,1,71.0,0,0,2,1,3,Nigeria
Mudashiru Lawal,2,166.0,0,0,1,2,3,Guinea
Mudather El Tahir,2,161.0,0,1,4,0,4,Sudan
Muhadjiri Hakizimana,0,111.0,0,0,1,1,2,Seychelles
Muhamad El-Basheer El-Asyad,0,185.0,0,0,2,0,2,Sudan
Muhamed Konjić,0,37.0,0,0,1,1,2,Lithuania
Muhamed Mujić,0,203.0,0,0,2,2,4,Romania
Muhammad Arshad,2,29.0,0,0,1,1,2,Pakistan
Muhammad Ilham,0,30.0,0,0,0,1,1,Turkmenistan
Muhammad Ridwan,0,76.0,0,0,1,0,1,Indonesia
Muhammet Akagündüz,0,88.0,0,0,0,1,1,Belarus
Muhannad El Tahir,0,103.0,0,1,2,0,2,Sudan
Muhedin Targaj,0,213.0,0,2,2,1,3,Finland
Muhsen Al-Ghassani,2,250.0,0,1,3,1,4,Uzbekistan
Muhsin Musabah,0,26.0,1,0,1,0,1,Qatar
Mujahid Ahmed,0,231.0,0,0,2,1,3,Mozambique
Mukhsin Mukhamadiev,0,80.0,0,0,1,0,1,Russia
Mulugeta Kebede,0,99.0,0,0,1,1,2,Kenya
Mumamba Numba,0,136.0,0,0,0,2,2,Seychelles
Mumba Mwila,0,42.0,0,0,0,1,1,Tanzania
Mun In-Guk,0,118.0,0,0,2,0,2,North Korea
Munaf Ramadan,0,12.0,0,0,1,0,1,Syria
Munif Shaef Noman,0,50.0,0,0,1,0,1,Yemen
Munir El Haddadi,0,82.0,0,0,1,0,1,Morocco
Munther Abu Amarah,0,33.0,0,0,0,1,1,Bangladesh
Munthir Khalaf,1,152.0,0,0,0,2,2,Jordan
Murad Alyan,1,117.0,0,0,2,1,3,Afghanistan
Murad Hüseynov,0,89.0,0,0,1,0,1,Azerbaijan
Murat Yakin,0,134.0,0,0,1,2,3,Finland
Murray Barnes,0,56.0,0,0,1,1,2,Australia
Murtaz Khurtsilava,0,73.0,0,0,2,0,2,Russia
Musa Al-Taamari,1,26.0,0,0,1,0,1,Jordan
Musa Barrow,2,161.0,0,1,1,1,2,Gambia
Musa Noah Kamara,1,55.0,0,0,0,1,1,Ivory Coast
Musa Otieno,0,183.0,0,0,2,1,3,Kenya
Musa Shannon,0,89.0,0,0,0,1,1,Ghana
Musab Al-Battat,0,9.0,0,0,0,1,1,Malaysia
Musaed Neda,0,202.0,0,0,2,2,4,Kuwait
Muslim Agaev,0,136.0,0,0,0,3,3,Vietnam
Mussab Al-Laham,0,30.0,0,0,1,0,1,Jordan
Mussad Nur,1,38.0,0,0,1,0,1,Egypt
Mustafa Denizli,0,25.0,0,0,0,1,1,Malta
Mustafa El Haddaoui,0,62.0,0,0,2,0,2,Morocco
Mustafa Ertan,1,21.0,0,0,0,1,1,Germany
Mustafa Karim,1,48.0,0,0,1,0,1,Iraq
Mustafa Shehdeh,0,90.0,0,0,1,0,1,Jordan
Mustafa Zazai,1,128.0,0,0,1,1,2,Cambodia
Mustamu Yessy,0,67.0,0,0,0,1,1,Hong Kong
Mustapha Hadji,2,229.0,0,0,2,2,4,Ghana
Mustapha Jarju,0,112.0,0,0,2,1,3,Liberia
Mustapha Merry,0,242.0,0,1,3,1,4,Sierra Leone
Mustapha Tahir,1,62.0,0,0,0,2,2,Tunisia
Mustapha Yaghcha,0,25.0,0,1,0,1,1,Cameroon
Mustapha Yatabaré,0,90.0,0,0,0,1,1,Angola
Mustaqim,0,60.0,0,0,1,0,1,Indonesia
Mutaz Kablan,0,45.0,0,0,2,0,2,Libya
Muteba N'Daye,0,169.0,0,0,2,1,3,DR Congo
Mutiu Adepoju,4,204.0,0,0,2,3,5,Nigeria
Mwape Miti,0,85.0,0,0,1,0,1,Zambia
Mwepu Ilunga,0,41.0,1,0,1,0,1,Egypt
Mxolisi Lukhele,0,84.0,0,0,0,1,1,Djibouti
Myer Bevan,0,14.0,0,0,0,1,1,Solomon Islands
Mykola Shaparenko,0,44.0,0,0,1,0,1,Ukraine
Myles Weston,0,72.0,0,1,1,0,1,Antigua and Barbuda
Myron Boadu,0,87.0,0,0,1,0,1,Netherlands
Myron Samuel,0,145.0,0,1,2,2,4,Saint Vincent and the Grenadines
Myrto Uzuni,0,165.0,0,0,1,1,2,San Marino
Mágico González,0,277.0,0,0,4,2,6,Nicaragua
Márcio Amoroso,4,179.0,0,0,3,1,4,Brazil
Márcio Roberto dos Santos,1,66.0,0,0,1,0,1,Brazil
Márcio Santos,1,54.0,0,0,1,0,1,Brazil
Mário Coluna,0,328.0,0,0,5,1,6,German DR
Mário Fernandes,0,310.0,0,0,2,2,4,Russia
Mário Moínhos,0,87.0,0,0,0,1,1,Cyprus
Mário Zagallo,1,124.0,0,0,1,1,2,Sweden
Márton Esterházy,1,118.0,0,0,2,1,3,Hungary
Máté Fenyvesi,0,101.0,0,0,1,2,3,Netherlands
Máté Pátkai,0,156.0,0,0,2,0,2,Hungary
Máximo Alcócer,2,576.0,0,0,11,0,11,Bolivia
Máximo Mosquera,3,278.0,0,0,3,3,6,Paraguay
Máximo Rolón,6,306.0,0,1,3,4,7,Argentina
Máximo Tenorio,0,65.0,0,0,1,0,1,Ecuador
Mërgim Mavraj,0,81.0,1,0,1,1,2,Albania
Mërgim Vojvoda,0,105.0,1,0,2,0,2,Kosovo
Míchel,5,724.0,1,7,10,7,17,Spain
Müller,4,205.0,0,0,5,0,5,Brazil
Mārcis Ošs,0,65.0,0,0,1,0,1,Latvia
Māris Verpakovskis,1,952.0,0,1,9,14,23,Greece
N'Kiambi Mapuata,0,56.0,0,0,2,0,2,DR Congo
Na Sang-ho,0,13.0,0,0,0,1,1,Turkmenistan
Nabeel Mubar Al Siyabi,0,98.0,0,0,2,0,2,Oman
Nabil Al-Siyabi,1,74.0,0,0,0,1,1,Taiwan
Nabil Ashoor,0,27.0,1,0,0,1,1,Oman
Nabil Baha,1,90.0,0,0,1,0,1,Morocco
Nabil Bentaleb,1,148.0,0,0,0,2,2,Senegal
Nabil Dirar,0,24.0,0,0,0,1,1,Ivory Coast
Nabil El Zhar,0,49.0,0,0,1,0,1,Morocco
Nabil Ghilas,0,78.0,0,0,0,1,1,Benin
Nabil Maâloul,0,85.0,0,1,2,0,2,Tunisia
Nabil Nano,1,65.0,0,0,1,0,1,Syria
Nabil Taïder,0,24.0,0,0,0,1,1,Nigeria
Naby Keïta,2,199.0,0,0,3,2,5,Namibia
Naby Laye Camara,0,52.0,0,1,1,0,1,Guinea
Naby Soumah,1,86.0,0,0,0,1,1,Botswana
Nacer Bouiche,1,44.0,0,0,1,0,1,Algeria
Nacer Chadli,1,352.0,0,0,4,2,6,Belgium
Nacho,1,58.0,0,0,0,1,1,Portugal
Nacho Monreal,0,84.0,0,0,1,0,1,Spain
Nader Joukhadar,2,191.0,0,0,3,2,5,Japan
Nader Kara,0,168.0,0,0,2,1,3,Sudan
Nader Matar,0,64.0,0,0,1,0,1,Lebanon
Nadir Belhadj,0,45.0,0,0,1,0,1,Algeria
Naea Bennett,4,209.0,0,0,0,4,4,Vanuatu
Naeem Saddam,2,134.0,0,0,1,1,2,Pakistan
Naeim Saadavi,1,38.0,0,0,0,1,1,Thailand
Nahki Wells,2,419.0,0,2,5,2,7,Bermuda
Nahuel Molina,1,35.0,0,0,0,1,1,Netherlands
Nahum Stelmach,4,422.0,0,0,8,1,9,Hong Kong
Naif Hazazi,1,350.0,0,0,2,3,5,Iran
Naiz Hassan,0,90.0,0,0,1,0,1,Maldives
Najeh Braham,0,132.0,0,0,1,1,2,Tunisia
Najwan Ghrayib,0,157.0,0,0,1,1,2,San Marino
Naldo Kwasie,0,81.0,0,0,1,0,1,Suriname
Nam Song-Chol,0,61.0,0,0,0,1,1,Japan
Nam Tae-hee,1,234.0,0,0,3,1,4,Kuwait
Nana Arhin Duah,0,81.0,0,0,2,0,2,Ghana
Nando Maria Neves,1,33.0,1,0,0,1,1,Cape Verde
Nang Yan Leung,0,75.0,0,0,0,2,2,Indonesia
Nani,5,557.0,0,0,10,6,16,Belgium
Naohiro Takahara,9,360.0,0,0,6,4,10,Saudi Arabia
Naoki Soma,2,135.0,0,0,1,1,2,Japan
Narasek Boongeang,0,76.0,0,0,0,1,1,India
Narcisse Yaméogo,0,90.0,0,0,1,0,1,Burkina Faso
Narender Thapa,0,89.0,0,0,1,0,1,India
Narubadin Weerawatnodom,1,5.0,0,0,1,0,1,Thailand
Nasema,1,85.0,0,0,1,0,1,Fiji
Naser Al-Sauhi,1,72.0,0,0,0,1,1,Bahrain
Nashat Akram,4,415.0,0,1,3,6,9,Saudi Arabia
Nasir Khamees,0,10.0,0,0,1,0,1,Qatar
Nasir Khamees Mubarak,0,38.0,0,0,1,0,1,United Arab Emirates
Nasko Sirakov,2,640.0,0,0,8,6,14,Norway
Nasr Eddin Abbas,4,420.0,0,0,2,4,6,Egypt
Nasr El-Din Abbas,0,66.0,0,0,1,1,2,Nigeria
Nasreddine Kraouche,1,90.0,0,0,0,1,1,Liberia
Nasser Al-Gahwashi,1,85.0,0,0,1,0,1,Yemen
Nasser Al-Shamrani,0,368.0,0,0,5,2,7,Saudi Arabia
Nasser Bouiche,1,94.0,0,0,2,0,2,Algeria
Nasser Kamil Mubarak,0,42.0,0,0,0,1,1,Laos
Nasser Khaleefa,0,90.0,0,0,0,1,1,Iraq
Nasser Mohammadkhani,3,224.0,0,0,2,1,3,Iran
Nasser Nouraei,0,127.0,0,0,3,0,3,Iran
Nasser Zayid,0,62.0,0,1,1,0,1,Oman
Nassim Akrour,1,214.0,0,0,3,1,4,Liberia
Nassir Al-Ghanem,0,130.0,0,0,2,0,2,Kuwait
Nassoro Mashoto,0,58.0,0,0,1,0,1,Tanzania
Nastja Čeh,0,181.0,0,0,4,1,5,Slovenia
Nat Lofthouse,3,323.0,0,0,2,4,6,Wales
Nate Burkey,0,50.0,0,0,0,1,1,Sri Lanka
Nathalie Suiverstin,0,18.0,0,0,1,0,1,Madagascar
Nathan Aké,0,19.0,0,0,1,0,1,Netherlands
Nathan Blake,0,159.0,0,0,2,2,4,Moldova
Nathan Burns,0,183.0,0,0,3,0,3,Australia
Nathan Fasika,0,66.0,0,0,0,1,1,Tanzania
Nathan Patterson,0,38.0,0,0,0,1,1,Moldova
Nathan Pond,1,39.0,0,0,1,0,1,Montserrat
Nathan Sinkala,0,71.0,0,0,0,1,1,Ghana
Nathaniel Lepani,0,55.0,0,0,0,1,1,Samoa
Natia Natia,1,39.0,0,0,1,0,1,American Samoa
Natipong Sritong-In,0,122.0,0,0,1,1,2,Thailand
Natiq Hashim,0,85.0,0,0,1,0,1,Iraq
Nauris Bulvītis,0,20.0,0,0,1,0,1,Latvia
Nawaf Al-Abed,3,428.0,0,4,2,4,6,North Korea
Nawaf Al-Temyat,3,304.0,0,1,1,3,4,Mexico
Nawaf Humaidan,0,70.0,0,0,0,1,1,Hong Kong
Nawaf Mubarak,0,90.0,0,0,1,0,1,United Arab Emirates
Nawayug Shrestha,1,80.0,0,0,1,0,1,Nepal
Nayef Aguerd,2,131.0,2,0,3,0,3,Morocco
Nayef Mubarak Al Khater,0,75.0,0,0,1,0,1,Qatar
Nazar Ashraf,1,34.0,0,0,1,0,1,Iraq
Nazar Bayramov,1,6.0,0,0,0,1,1,Saudi Arabia
Nazar Baýramow,0,83.0,0,0,2,0,2,Turkmenistan
Nazim Suleymanov,1,198.0,0,2,2,1,3,Slovakia
Nazir McBurnette,0,90.0,0,0,0,1,1,Guatemala
Naïm Sliti,3,165.0,0,1,0,3,3,Algeria
Nchimunya Mweetwa,0,114.0,0,0,0,2,2,Liberia
Ndaye Mulamba,8,554.0,0,0,4,6,10,Guinea
Ndubuisi Okosieme,1,33.0,0,0,0,1,1,Kenya
Necati Ateş,0,55.0,0,2,2,0,2,Turkey
Neco,2,280.0,0,0,7,1,8,Argentina
Neco Williams,0,20.0,0,0,1,0,1,Wales
Ned Zelić,0,63.0,0,0,3,0,3,Australia
Nedim Doğan,0,48.0,0,0,1,0,1,Turkey
Nedžmedin Memedi,0,60.0,0,0,0,1,1,Iceland
Neeskens Kebano,1,154.0,0,0,1,2,3,Guinea
Neftali Díaz,0,70.0,0,0,1,0,1,Panama
Neider Morantes,3,73.0,0,0,3,0,3,Colombia
Neil Danns,3,314.0,0,3,4,1,5,Guyana
Neil Jones,1,72.0,0,0,1,0,1,New Zealand
Neil Lennon,0,92.0,0,0,2,0,2,Northern Ireland
Neil McCann,0,157.0,0,0,1,2,3,Latvia
Neil Paynter,0,66.0,0,0,0,1,1,Jamaica
Neil Slatter,0,68.0,0,0,0,1,1,Finland
Neil Taylor,1,20.0,0,0,0,1,1,Russia
Neil Webb,0,171.0,0,0,2,0,2,England
Nejc Pečnik,0,337.0,0,0,1,3,4,Slovakia
Nelinho,2,172.0,0,1,5,0,5,Brazil
Nelson Abeijon,0,83.0,0,0,1,0,1,Uruguay
Nelson Barahona,1,202.0,0,0,2,1,3,Panama
Nelson Bonilla,3,490.0,0,0,3,6,9,Saint Kitts and Nevis
Nelson Cuevas,3,235.0,0,0,1,2,3,Slovenia
Nelson Gabolwelwe,0,69.0,0,0,2,0,2,Botswana
Nelson Luís Kerchner,1,72.0,0,0,1,0,1,Brazil
Nelson Melgar,0,88.0,0,0,1,0,1,Guatemala
Nelson Moreno,1,30.0,0,0,0,1,1,Ecuador
Nelson Peña,0,73.0,0,0,1,0,1,Dominican Republic
Nelson Pérez,1,27.0,0,0,1,0,1,Colombia
Nelson Sale,0,21.0,1,0,0,1,1,Solomon Islands
Nelson Valdez,2,365.0,0,0,4,4,8,Venezuela
Nemanja Matić,0,144.0,0,0,0,2,2,Portugal
Nemanja Nikolić,0,214.0,0,1,1,2,3,Hungary
Nemanja Radonjić,0,125.0,0,0,1,1,2,Luxembourg
Nemesio Mosquera,1,54.0,0,0,0,2,2,Ecuador
Nemesio Rojas,1,77.0,0,0,1,0,1,Bolivia
Nenad Jestrović,0,98.0,0,0,0,2,2,San Marino
Nenad Milijaš,0,19.0,0,2,2,0,2,Serbia
Nenad Stojković,0,36.0,0,0,0,1,1,Bulgaria
Nené,1,493.0,0,0,6,6,12,Portugal
Nermin Šabić,0,69.0,0,0,1,0,1,Bosnia and Herzegovina
Nery Castillo,5,225.0,0,2,4,2,6,Mexico
Nery Medina,0,52.0,0,0,0,1,1,United States
Nesley Jean,0,160.0,0,0,1,2,3,Bahamas
Nestor Subiat,0,158.0,0,0,0,2,2,Hungary
Nestoras Mitidis,0,152.0,0,0,1,3,4,Andorra
Neto,1,5.0,0,1,0,1,1,Bolivia
Neven Subotić,0,69.0,0,0,0,1,1,Faroe Islands
Ney Avilés,3,324.0,0,0,3,3,6,Chile
Neymar,7,1504.0,0,8,24,7,31,Brazil
Ng Chi Kit,0,44.0,1,0,0,1,1,Macau
Ng Wai Chiu,0,17.0,0,0,0,1,1,Malaysia
Ngasanya Ilongo,0,58.0,0,0,1,0,1,DR Congo
Ngidi Yemweni,0,328.0,0,0,4,1,5,Djibouti
Nguyen Cong Vinh,0,71.0,0,0,0,1,1,Turkmenistan
Nguyen Hong Son,1,30.0,0,0,0,1,1,Indonesia
Nguyễn Công Phượng,3,160.0,0,0,1,2,3,Iraq
Nguyễn Hồng Sơn,5,241.0,0,2,2,3,5,Mongolia
Nguyễn Lương Phúc,2,90.0,0,0,2,0,2,Vietnam
Nguyễn Minh Hải,0,13.0,0,0,1,0,1,Vietnam
Nguyễn Ngọc Thanh,0,67.0,0,0,1,0,1,Vietnam
Nguyễn Quang Hải,2,241.0,0,0,4,2,6,Macau
Nguyễn Thanh Bình,0,19.0,0,0,0,1,1,Japan
Nguyễn Tiến Linh,3,413.0,0,0,3,5,8,Indonesia
Nguyễn Trung Vĩnh,1,77.0,0,0,0,1,1,Bangladesh
Nguyễn Trọng Hoàng,0,60.0,0,0,1,0,1,Vietnam
Nguyễn Vinh Quang,1,54.0,1,0,0,1,1,Vietnam Republic
Nguyễn Văn Quyết,0,89.0,0,0,1,0,1,Vietnam
Nguyễn Văn Sỹ,1,65.0,0,0,0,1,1,Bangladesh
Nguyễn Văn Toàn,0,71.0,0,0,2,0,2,Vietnam
Nguyễn Văn Tu,0,70.0,0,0,0,1,1,South Korea
Niall McGinn,1,310.0,0,0,1,4,5,Portugal
Niall Quinn,1,646.0,0,0,10,4,14,Republic of Ireland
Niall Reid-Stephen,0,42.0,0,0,0,1,1,Dominican Republic
Nian Weisi,0,9.0,0,0,1,0,1,China PR
Nicaise Ondeno,0,32.0,0,0,1,0,1,Gabon
Nicaise Zimbori-Auzingoni,0,79.0,0,0,0,2,2,Botswana
Nicholas Gioacchini,0,90.0,0,0,1,0,1,United States
Nicholas Ioannou,0,98.0,0,0,0,2,2,Kazakhstan
Nick Dasovic,1,166.0,1,0,2,1,3,Canada
Nick Deacy,0,135.0,0,0,2,0,2,Wales
Nick Papadakis,0,100.0,0,0,2,0,2,Canada
Nicki Bille Nielsen,0,84.0,0,0,1,0,1,Denmark
Nicklas Bendtner,3,936.0,0,1,9,8,17,Northern Ireland
Nicko Williams,0,67.0,1,0,0,1,1,Grenada
Nicky Barmby,0,24.0,0,0,0,1,1,Moldova
Nicky Saliba,1,6.0,0,0,0,1,1,Serbia
Niclas Alexandersson,1,261.0,0,0,3,2,5,Sweden
Niclas Füllkrug,2,172.0,0,0,0,2,2,Spain
Niclas Nyhlén,0,90.0,0,0,1,0,1,Sweden
Nico Braun,0,122.0,0,1,4,1,5,Luxembourg
Nico Claesen,3,580.0,0,1,5,6,11,Belgium
Nico Schulz,0,90.0,0,0,0,1,1,Netherlands
Nico Van Kerckhoven,0,28.0,0,0,1,0,1,Belgium
Nicodème Kabamba,2,78.0,0,1,0,2,2,Congo
Nicola Albani,0,59.0,0,0,0,1,1,Latvia
Nicola Bacciocchi,0,53.0,0,0,0,1,1,Turkey
Nicola Nanni,0,48.0,0,0,1,0,1,San Marino
Nicolae Dică,0,200.0,0,1,2,2,4,Albania
Nicolae Dobrin,0,211.0,0,0,4,2,6,Italy
Nicolae Georgescu,0,56.0,0,0,1,1,2,Romania
Nicolae Josan,0,43.0,0,0,1,1,2,Moldova
Nicolae Lupescu,0,46.0,0,0,1,1,2,Finland
Nicolae Milinceanu,0,140.0,0,0,1,1,2,Moldova
Nicolae Mitea,0,76.0,0,0,0,2,2,North Macedonia
Nicolae Oaidă,0,62.0,0,0,1,0,1,Romania
Nicolae Pantea,0,55.0,0,0,1,0,1,Romania
Nicolae Stanciu,0,112.0,0,0,0,2,2,Armenia
Nicolae Tătaru,0,66.0,0,0,2,0,2,Romania
Nicolae Ungureanu,0,48.0,0,0,1,0,1,Romania
Nicolai Jørgensen,0,166.0,0,0,1,2,3,Sweden
Nicolas Anelka,0,495.0,0,0,4,5,9,Russia
Nicolas Hasler,0,61.0,0,0,0,1,1,Bosnia and Herzegovina
Nicolas Hoffmann,0,83.0,0,0,1,0,1,Luxembourg
Nicolas Lombaerts,0,89.0,0,0,1,0,1,Belgium
Nicolas Nkoulou,1,59.0,0,0,0,1,1,Egypt
Nicolas Pépé,3,121.0,0,0,3,0,3,Ivory Coast
Nicolas Vallar,3,47.0,1,2,2,1,3,Tahiti
Nicolás Falero,7,376.0,0,0,0,9,9,Bolivia
Nicolás González,0,92.0,0,0,2,1,3,Argentina
Nicolás Lodeiro,2,165.0,0,0,3,1,4,Uruguay
Nicolás Martínez,0,6.0,0,0,1,0,1,Cuba
Nicolás Olivera,2,282.0,0,1,3,3,6,United Arab Emirates
Nicolás Otamendi,1,89.0,0,0,1,1,2,Argentina
Nicolás Ramírez,0,78.0,1,0,1,1,2,United States
Nicolás Suazo,0,359.0,0,0,5,3,8,Honduras
Nicolás Tellez,0,34.0,0,0,1,0,1,Mexico
Nicolò Barella,1,90.0,0,0,2,2,4,Italy
Nicolò Zaniolo,0,73.0,0,0,2,0,2,Italy
Nicos Kantzilieris,0,47.0,0,0,0,1,1,Austria
Nicușor Bancu,0,87.0,0,0,0,1,1,Liechtenstein
Niel Hans,1,89.0,0,1,1,0,1,Papua New Guinea
Niels Tune-Hansen,0,19.0,0,0,0,1,1,Cyprus
Nigel Bishop,0,34.0,0,0,1,0,1,Grenada
Nigel Codrington,0,84.0,0,0,1,0,1,Guyana
Nigel Dabinyaba,0,259.0,0,0,4,0,4,Papua New Guinea
Nigel Hasselbaink,4,307.0,0,0,4,3,7,Aruba
Nigel Pierre,0,164.0,0,1,2,1,3,Dominican Republic
Nigel de Jong,0,8.0,0,0,0,1,1,Iceland
Niginho,2,134.0,0,0,2,0,2,Brazil
Nihad Al Boushi,0,166.0,0,0,4,0,4,Syria
Nihad Boshi,1,244.0,0,0,2,2,4,Syria
Nihat Kahveci,3,699.0,0,0,6,6,12,Moldova
Nihat Yayöz,0,83.0,0,0,0,1,1,Poland
Nik Viljoen,0,80.0,0,0,1,0,1,New Zealand
Nika Kacharava,0,6.0,0,0,1,0,1,Georgia
Niki Temiha,1,4.0,0,0,0,1,1,Solomon Islands
Niki Zimling,0,83.0,0,0,0,1,1,Czech Republic
Nikica Jelavić,1,112.0,0,0,1,1,2,Republic of Ireland
Nikita Naumov,0,48.0,0,0,0,1,1,Estonia
Nikita Simonyan,2,121.0,0,0,1,4,5,Russia
Niklas Moisander,0,77.0,0,0,1,0,1,Finland
Niko Kata,1,75.0,1,0,1,0,1,South Sudan
Niko Kovač,2,307.0,0,0,5,3,8,San Marino
Niko Kranjčar,0,468.0,0,1,3,7,10,Bulgaria
Nikodimos Papavasiliou,0,143.0,0,0,1,2,3,Faroe Islands
Nikola Drinčić,0,27.0,0,0,1,0,1,Montenegro
Nikola Jerkan,0,58.0,0,0,1,0,1,Croatia
Nikola Jurčević,0,55.0,0,0,0,1,1,Slovenia
Nikola Kalinić,2,432.0,0,0,6,1,7,Croatia
Nikola Kotkov,0,199.0,0,1,6,0,6,Bulgaria
Nikola Lazetić,1,52.0,0,0,1,0,1,Serbia
Nikola Milenković,0,245.0,1,0,3,0,3,Serbia
Nikola Tsanev,0,61.0,0,0,2,0,2,Bulgaria
Nikola Vlašić,0,217.0,0,0,2,3,5,Slovakia
Nikola Vujnović,0,86.0,0,0,1,0,1,Montenegro
Nikola Vukčević,0,59.0,0,0,1,0,1,Montenegro
Nikola Žigić,1,869.0,0,0,9,5,14,Ivory Coast
Nikolai Pisarev,0,72.0,0,0,1,0,1,Russia
Nikolaos Karelis,0,24.0,0,0,0,1,1,Finland
Nikolas Ledgerwood,0,53.0,0,0,1,0,1,Canada
Nikolay Bodurov,0,79.0,1,0,0,2,2,Bulgaria
Nikolay Iliev,0,84.0,0,0,1,0,1,Bulgaria
Nikolay Komlichenko,0,78.0,0,0,0,1,1,San Marino
Nikolay Larionov,0,86.0,0,0,1,0,1,Russia
Nikolay Shirshov,0,257.0,0,0,4,2,6,Uzbekistan
Nikolay Todorov,0,198.0,0,0,1,2,3,Romania
Nikoloz Gelashvili,1,9.0,0,0,0,1,1,Gibraltar
Nikolče Noveski,0,107.0,0,0,1,2,3,Andorra
Nikos Anastopoulos,1,515.0,0,1,8,5,13,Greece
Nikos Charalambous,0,42.0,0,0,1,0,1,Cyprus
Nikos Liberopoulos,0,404.0,0,0,4,2,6,Greece
Nikos Machlas,0,669.0,0,1,8,3,11,Luxembourg
Nikos Nioplias,0,49.0,0,0,1,0,1,Greece
Nikos Pantziaras,0,93.0,1,0,2,0,2,Cyprus
Nikos Patikkis,0,58.0,1,0,0,1,1,Cyprus
Nikos Spyropoulos,0,188.0,1,0,1,2,3,Greece
Nikos Tsiantakis,0,37.0,0,0,1,0,1,Greece
Nildeson,0,123.0,0,0,2,1,3,El Salvador
Nilmar,0,300.0,0,0,4,1,5,Brazil
Nilo Braga,3,228.0,0,0,2,4,6,Argentina
Nils Liedholm,0,130.0,0,1,3,0,3,Sweden
Nils Rikberg,0,70.0,0,0,1,0,1,Finland
Nils-Åke Sandell,0,165.0,0,0,2,2,4,Finland
Nininho,0,141.0,0,0,3,0,3,Brazil
Nir Bitton,0,131.0,0,0,2,1,3,Israel
Nir Klinger,0,37.0,0,0,0,1,1,New Zealand
Nir Sivilia,0,84.0,0,0,1,0,1,Israel
Nirajan Rayamajhi,6,310.0,0,0,2,5,7,Iraq
Nirut Surasiang,0,114.0,0,0,0,2,2,Yemen
Nissim Cohen,0,67.0,0,0,1,0,1,Israel
Nitder Pizzani,0,94.0,0,0,2,0,2,Uruguay
Nitsavong Khouphachansy,0,135.0,1,0,0,2,2,Philippines
Niwat Srisawat,2,124.0,0,0,1,1,2,Malaysia
Niweat Siriwong,0,168.0,0,0,2,0,2,Thailand
Nizar Khalfan,0,19.0,0,0,0,1,1,Mauritius
Nizar Mahrous,1,363.0,0,0,3,3,6,Bahrain
Njiva Rakotoharimalala,0,135.0,0,0,3,1,4,Madagascar
Njogu Demba-Nyrén,0,90.0,0,0,2,0,2,Gambia
Nkau Lerotholi,0,50.0,1,0,0,1,1,Lesotho
Nkiere Wawa,0,61.0,0,0,1,0,1,DR Congo
Nnamdi Oduamadi,3,202.0,0,0,1,3,4,Nigeria
Noah Frick,0,80.0,0,0,0,1,1,Armenia
Noah Frommelt,0,83.0,1,0,0,1,1,Liechtenstein
Noah Hickey,0,130.0,0,0,2,0,2,New Zealand
Noah Okafor,0,48.0,0,0,1,0,1,Switzerland
Noel Barkley,0,57.0,0,0,1,0,1,New Zealand
Noel Berry,3,321.0,0,0,6,1,7,Solomon Islands
Noel Brotherston,0,24.0,0,0,1,0,1,Northern Ireland
Noel Cantwell,0,406.0,0,2,5,1,6,Republic of Ireland
Noel Mkandawire,0,230.0,0,0,3,1,4,Guinea
Noel Valladares,1,48.0,1,0,1,0,1,France
Noh Alam Shah,1,197.0,0,0,1,2,3,Singapore
Noh Jung-yoon,1,143.0,0,0,2,0,2,South Korea
Noh Soo-Jin,0,176.0,0,0,1,2,3,South Korea
Nolberto Molina,0,60.0,0,1,1,0,1,Colombia
Nolberto Solano,1,439.0,0,2,5,4,9,Mexico
Nolito,1,100.0,0,0,1,1,2,Spain
Nontapan Jeansatawong,0,10.0,0,0,1,0,1,Thailand
Norbert Eschmann,0,81.0,0,0,1,0,1,Switzerland
Norbert Hof,0,85.0,0,0,1,0,1,Austria
Norbert Owona,0,101.0,0,0,1,1,2,Nigeria
Norberto Conde,0,61.0,0,0,0,1,1,Chile
Norberto Doroteo Méndez,10,667.0,0,0,15,2,17,Argentina
Norberto Maurito,1,86.0,0,0,1,0,1,Angola
Norberto Menéndez,1,173.0,0,0,3,1,4,Chile
Norfran Lazo,0,63.0,0,0,1,0,1,Nicaragua
Norio Omura,1,86.0,0,0,0,2,2,Oman
Norival Pereira Da Silva,1,63.0,0,0,1,0,1,Brazil
Norjmoogiin Tsedenbal,0,113.0,0,2,2,1,3,Mongolia
Norlla Amiri,2,122.0,0,0,1,1,2,Syria
Norm McLeod,0,32.0,0,0,1,0,1,Canada
Norman Forde,0,35.0,0,0,0,1,1,Grenada
Norman Hunter,0,122.0,0,0,1,1,2,Spain
Norman Lockhart,0,72.0,0,1,1,0,1,Northern Ireland
Norman Patterson,0,79.0,0,0,1,0,1,Canada
Norman Whiteside,1,331.0,0,0,5,2,7,Northern Ireland
Norshahrul Idlan,0,43.0,0,0,1,0,1,Malaysia
Noud van Melis,0,97.0,0,0,1,2,3,Austria
Noureddine Naybet,0,24.0,0,0,1,0,1,Morocco
Nourken Mazbaev,0,57.0,0,0,1,1,2,Pakistan
Nourredine Kourichi,0,53.0,0,0,1,0,1,Algeria
Novatus Dismas,0,26.0,0,0,1,0,1,Tanzania
Nowend Lorenzo,2,71.0,0,0,0,2,2,Anguilla
Noël Birindi Minga,1,112.0,0,0,1,1,2,Cameroon
Noël Kouamé,0,59.0,0,0,1,1,2,Ivory Coast
Noël Minga,0,88.0,0,0,1,0,1,Congo
Nqobizitha Ncube,0,20.0,0,0,1,0,1,Zimbabwe
Nsumbu Ngoy,0,55.0,0,0,0,1,1,Tunisia
Numon Khasanov,0,45.0,0,0,1,1,2,Yemen
Numondzhon Khakimov,0,280.0,0,2,3,2,5,Bangladesh
Nuno Gomes,9,1007.0,0,0,7,11,18,Portugal
Nuno Miguel Monteiro Rocha,0,71.0,0,1,2,0,2,Cape Verde
Nurbol Zhumaskaliyev,0,61.0,0,0,1,0,1,Kazakhstan
Nurdin Bakari,0,80.0,0,0,0,1,1,Chad
Nwankwo Kanu,0,379.0,0,1,5,1,6,Nigeria
Nyam-Osor Naranbold,0,69.0,0,0,1,0,1,Mongolia
Nyasha Mushekwi,1,29.0,0,1,0,1,1,Algeria
Nyron Nosworthy,0,18.0,0,0,1,0,1,Jamaica
Nzelo Hervé Lembi,0,13.0,0,0,1,0,1,DR Congo
Nándor Hidegkuti,4,192.0,0,0,1,5,6,Germany
Néjib Ghommidh,1,79.0,0,0,0,1,1,Mexico
Néjib Liman,0,40.0,0,0,2,0,2,Tunisia
Nélson Oliveira,0,85.0,0,0,1,0,1,Portugal
Nélson Veiga,0,62.0,1,0,1,0,1,Ghana
Néstor Araujo,1,115.0,0,0,1,2,3,Chile
Néstor Ayala,0,82.0,0,0,1,0,1,Paraguay
Néstor Azón,1,84.0,0,0,0,1,1,Brazil
Néstor Clausen,0,88.0,0,0,1,0,1,Argentina
Néstor Combin,0,73.0,0,0,2,2,4,Hungary
Néstor Craviotto,1,63.0,1,0,1,1,2,Argentina
Néstor Gorosito,0,41.0,0,1,0,1,1,Bolivia
Nílton Santos,2,62.0,0,0,1,1,2,Brazil
Oalex Anderson,1,211.0,0,1,2,4,6,Guyana
Obafemi Martins,3,923.0,0,2,7,6,13,Nigeria
Obaidullah Karimi,1,16.0,0,0,1,0,1,Afghanistan
Obby Kapita,1,149.0,0,0,0,4,4,DR Congo
Obdulio Varela,4,263.0,0,0,1,4,5,Peru
Obeid Al-Dosari,2,744.0,0,0,10,3,13,Taiwan
Obinna Nwaneri,0,45.0,0,0,1,0,1,Nigeria
Oceano da Cruz,0,82.0,0,1,2,0,2,Portugal
Octavio Mora,0,68.0,0,0,3,0,3,Mexico
Octavio Sergio da Costa,0,10.0,0,0,1,0,1,Brazil
Octávio Machado,0,79.0,0,0,0,1,1,Denmark
Odai Al-Saify,1,59.0,0,0,1,0,1,Jordan
Oday Al-Jafal,1,59.0,0,0,1,0,1,Syria
Oday Dabbagh,3,210.0,0,0,4,0,4,Palestine
Odaïr Fortes,0,26.0,0,0,1,0,1,Cape Verde
Odd Iversen,0,354.0,0,1,4,2,6,Norway
Oded Machnes,0,84.0,0,0,2,0,2,Israel
Odil Ahmedov,4,724.0,0,0,8,7,15,Lebanon
Odilon Polleunis,0,479.0,0,0,7,1,8,Finland
Odion Ighalo,5,263.0,0,1,4,2,6,Nigeria
Odise Roshi,0,223.0,0,0,3,1,4,Albania
Odkhuu Selenge,0,90.0,0,0,1,0,1,Mongolia
Oeki Hoekema,0,54.0,0,0,1,0,1,Netherlands
Ofentse Nato,0,124.0,0,0,2,0,2,Botswana
Oghenekaro Etebo,1,32.0,1,0,1,0,1,Croatia
Ognjen Koroman,1,53.0,0,0,1,0,1,Serbia
Ognjen Vukojević,0,21.0,0,0,0,2,2,Kazakhstan
Oguchi Onyewu,0,179.0,0,0,2,0,2,United States
Ogün Altıparmak,0,175.0,0,0,1,2,3,Republic of Ireland
Ogün Temizkanoğlu,0,130.0,0,0,1,1,2,Switzerland
Oh Seok-Jae,1,68.0,0,0,1,0,1,South Korea
Oh Yong-Nam,0,88.0,1,0,1,0,1,Japan
Okan Buruk,1,336.0,0,0,5,3,8,Turkey
Okan Yılmaz,3,207.0,0,1,1,2,3,Turkey
Okeem Challenger,0,86.0,0,0,1,0,1,Antigua and Barbuda
Okey Isima,1,136.0,1,0,3,0,3,Nigeria
Okita Katschi,0,85.0,0,1,1,0,1,DR Congo
Oktay Derelioğlu,0,313.0,0,0,8,0,8,Turkey
Ola Dybwad-Olsen,0,306.0,0,0,4,0,4,Norway
Ola Kamara,0,90.0,0,0,1,0,1,Norway
Ola Toivonen,1,350.0,0,0,5,2,7,Moldova
Olaf Marschall,0,85.0,0,0,1,0,1,Germany
Olaf Thon,0,85.0,0,0,1,0,1,Germany
Olav Nilsen,0,269.0,0,0,1,3,4,Norway
Olavi Lahtinen,1,192.0,0,0,1,2,3,Finland
Olavi Rissanen,0,198.0,0,0,3,0,3,Finland
Oldřich Nejedlý,7,636.0,0,1,8,1,9,Czechoslovakia
Ole Bjørnmose,0,15.0,0,0,1,0,1,Denmark
Ole Fritsen,0,60.0,0,0,1,1,2,Denmark
Ole Gunnar Solskjær,0,795.0,0,1,6,8,14,Norway
Ole Madsen,1,508.0,0,0,9,5,14,Denmark
Ole Martin Årst,0,89.0,0,0,1,0,1,Norway
Ole Rasmussen,0,21.0,0,0,0,1,1,Cyprus
Ole Selnæs,0,58.0,0,0,0,1,1,San Marino
Ole Stavrum,0,8.0,0,0,0,1,1,Yugoslavia
Ole Sørensen,0,103.0,0,0,3,0,3,Denmark
Ole Tobiasen,0,90.0,0,0,0,1,1,Switzerland
Oleg Blokhin,5,682.0,0,0,10,4,14,Russia
Oleg Kuzmin,0,33.0,0,0,1,0,1,Russia
Oleg Litvinenko,3,128.0,0,0,2,2,4,Nepal
Oleg Salenko,6,251.0,0,2,5,1,6,Sweden
Oleg Shatskikh,1,598.0,0,0,3,6,9,China PR
Oleg Zoteev,0,72.0,0,0,1,0,1,Uzbekistan
Oleg Șișchin,0,76.0,0,0,0,1,1,Germany
Oleh Husyev,0,268.0,0,0,3,4,7,Turkey
Oleh Kuznetsov,0,60.0,0,0,1,0,1,Russia
Oleh Protasov,10,643.0,0,0,9,4,13,Russia
Oleh Shelayev,0,7.0,0,0,0,1,1,Georgia
Oleksandr Kucher,0,60.0,0,0,1,0,1,Ukraine
Oleksandr Zavarov,3,250.0,0,0,3,2,5,Russia
Oleksandr Zinchenko,1,93.0,0,0,0,3,3,Lithuania
Oleksiy Byelik,0,26.0,0,0,1,1,2,Kazakhstan
Oleksiy Gai,0,54.0,0,0,0,1,1,Croatia
Oleksiy Mykhaylychenko,2,273.0,0,0,3,3,6,Russia
Oli,0,28.0,0,0,1,0,1,Spain
Oliver Bierhoff,6,1122.0,0,0,11,8,19,Czech Republic
Oliver Burke,0,89.0,0,0,1,0,1,Scotland
Oliver Makor,1,345.0,0,0,3,1,4,Liberia
Oliver Neuville,1,226.0,0,0,4,0,4,Germany
Olivier Dacourt,0,71.0,0,0,0,1,1,Slovenia
Olivier Deschacht,0,82.0,1,0,1,0,1,Lithuania
Olivier Djappa,0,20.0,0,0,1,0,1,Cameroon
Olivier Giroud,5,1032.0,0,2,12,8,20,Spain
Olivier Kapo,0,17.0,0,0,1,0,1,France
Olivier Karekezi,0,161.0,0,0,4,0,4,Rwanda
Olivier Niere,0,128.0,0,0,2,0,2,Congo
Olivier Niyonzima,0,66.0,0,0,0,1,1,Kenya
Olivier Occéan,0,167.0,0,0,1,3,4,Saint Lucia
Olivier Thill,0,80.0,0,0,1,1,2,Luxembourg
Ollie Watkins,0,83.0,0,0,1,0,1,England
Olof Mellberg,1,289.0,0,0,6,2,8,Poland
Olumuyiwa Oshode,0,154.0,0,0,1,1,2,Cameroon
Omar Abdulrahman,0,74.0,0,0,1,1,2,Malaysia
Omar Al Ariki,0,148.0,0,0,5,0,5,Yemen
Omar Al Khouja,0,43.0,0,0,0,1,1,Angola
Omar Al Somah,9,689.0,0,2,7,6,13,Iran
Omar Al-Dahi,2,91.0,0,0,2,0,2,Yemen
Omar Ali Hasab El-Rasoul,1,174.0,0,0,4,0,4,Sudan
Omar Berdiýew,0,42.0,0,0,1,0,1,Turkmenistan
Omar Betrouni,0,83.0,0,0,1,0,1,Algeria
Omar Bravo,6,523.0,0,0,9,0,9,Mexico
Omar Cummings,1,155.0,0,0,1,1,2,Jamaica
Omar Daley,1,173.0,0,0,2,0,2,Jamaica
Omar Daoud,0,50.0,0,0,1,0,1,Libya
Omar Gonzalez,0,156.0,1,0,4,0,4,United States
Omar Hawsawi,0,90.0,0,0,0,1,1,Japan
Omar Higinio García,1,2.0,0,0,1,0,1,Argentina
Omar Khribin,8,591.0,0,2,6,7,13,Afghanistan
Omar Marmoush,0,49.0,0,0,1,0,1,Egypt
Omar Midani,0,50.0,0,0,0,1,1,Cambodia
Omar Mohamed,0,85.0,0,0,0,1,1,Zimbabwe
Omar Mubarak,2,73.0,0,0,2,0,2,Yemen
Omar Méndez,1,12.0,0,0,0,1,1,Ecuador
Omar Sivori,0,221.0,0,0,4,0,4,Italy
Omar Sívori,3,114.0,0,0,3,1,4,Argentina
Omar Traoré,0,80.0,0,0,0,1,1,Togo
Omar Zapata,1,190.0,0,0,3,1,4,Dominican Republic
Omari Glasgow,1,75.0,0,0,1,0,1,Guyana
Omari Sterling-James,0,82.0,0,0,0,1,1,Bahamas
Omari Tetradze,1,54.0,0,0,1,0,1,Russia
Omer Damari,0,209.0,0,0,1,4,5,Cyprus
Omer Golan,0,296.0,0,0,3,2,5,Israel
Omid Popalzay,1,23.0,0,0,1,0,1,Afghanistan
Omri Afek,1,4.0,0,0,1,1,2,Cyprus
Onandi Lowe,1,246.0,0,0,3,4,7,Saint Vincent and the Grenadines
Ondrej Duda,1,387.0,0,1,3,4,7,Wales
Ondrej Krištofík,0,27.0,1,0,1,0,1,France
Ondřej Čelůstka,0,79.0,0,0,1,0,1,Czech Republic
Onel Hernández,2,95.0,0,0,2,0,2,Cuba
Oniel Fisher,0,79.0,0,0,0,1,1,Honduras
Onur Dogan,0,52.0,0,0,0,1,1,Brunei
Opa Nguette,0,55.0,0,0,1,0,1,Senegal
Opoku Afriyie,0,206.0,0,0,4,0,4,Ghana
Opoku Nti,2,248.0,0,0,2,2,4,Libya
Oppe Quiñónez,1,82.0,0,0,0,1,1,Ecuador
Orbelín Pineda,4,262.0,0,2,3,2,5,Mexico
Orestas Buitkus,0,222.0,0,0,1,2,3,North Macedonia
Oreste Corbatta,5,486.0,0,6,12,2,14,Argentina
Orhan Çıkırıkçı,0,87.0,0,0,1,0,1,Turkey
Oribe Peralta,8,827.0,0,0,11,7,18,Guyana
Orin de Waard,0,12.0,0,0,1,0,1,Curaçao
Orkun Kökçü,0,60.0,0,0,0,1,1,Montenegro
Orlando Gando,0,50.0,0,0,0,1,1,Congo
Orlando Maturana,1,18.0,0,1,1,0,1,Colombia
Orlando Mesa,0,18.0,0,0,0,1,1,Brazil
Orlando Mitchum,0,302.0,0,0,4,1,5,Saint Kitts and Nevis
Orlando Torres,0,8.0,0,0,1,0,1,Venezuela
Orlando de Azevedo Viarina,0,132.0,0,0,2,0,2,Brazil
Orly Klinger,0,48.0,0,0,1,0,1,Ecuador
Osael Romero,3,533.0,0,1,6,5,11,El Salvador
Osama Al Fazzani,0,4.0,0,0,1,0,1,Libya
Osama Al-Muwallad,0,132.0,0,0,1,1,2,Iran
Osama Hawsawi,0,189.0,0,0,1,2,3,Saudi Arabia
Osama Idris,0,7.0,0,0,1,0,1,Sudan
Osama Omari,4,213.0,0,0,4,1,5,Cambodia
Osamu Maeda,0,16.0,0,0,1,0,1,Japan
Osaze Odemwingie,3,216.0,0,0,3,0,3,Nigeria
Oscar,1,228.0,0,0,3,0,3,Brazil
Oscar Arriaza,0,22.0,0,0,1,0,1,Chile
Oscar Black,0,11.0,0,0,1,0,1,Jamaica
Oscar Chirimini,1,198.0,0,0,1,2,3,Chile
Oscar Crino,0,67.0,0,0,2,0,2,Australia
Oscar Fornari,0,17.0,0,0,0,1,1,Bolivia
Oscar Heisserer,0,10.0,0,0,1,0,1,France
Oscar Hiljemark,0,45.0,0,0,1,0,1,Sweden
Oscar Mas,1,23.0,0,0,1,0,1,Argentina
Oscar Ruggeri,2,46.0,0,0,2,0,2,Argentina
Oscar Santis,0,16.0,0,0,1,0,1,Guatemala
Oscar Zubía,0,60.0,0,0,0,1,1,Ecuador
Osea Vakatalesau,0,113.0,0,0,2,0,2,Fiji
Osei Kofi,6,486.0,0,1,4,5,9,DR Congo
Oskars Kļava,0,27.0,0,0,0,1,1,Iceland
Osman Arpacıoğlu,0,45.0,0,0,2,0,2,Turkey
Osman Bukari,1,89.0,0,0,0,1,1,Portugal
Osmin Hernández,0,19.0,0,0,1,0,1,Cuba
Ossama Khalil,1,99.0,0,0,2,0,2,Egypt
Ostap Steckiw,0,14.0,0,0,0,1,1,United States
Osvaldo Ardiles,1,185.0,0,0,2,1,3,Venezuela
Osvaldo Balseiro,4,260.0,0,0,0,4,4,Chile
Osvaldo Castro,0,40.0,0,0,1,0,1,Chile
Osvaldo Fernando Saturnino de Oliveira,0,78.0,0,0,0,1,1,Algeria
Osvaldo Héctor Cruz,2,95.0,0,0,2,0,2,Argentina
Osvaldo Sáez,3,207.0,0,0,2,1,3,Chile
Osvaldo de Oliveira,0,73.0,0,0,1,1,2,Cameroon
Oswalding Mackay,0,85.0,0,0,1,0,1,Aruba
Oswaldo Alanís,0,35.0,0,0,1,0,1,Mexico
Oswaldo Calero,0,42.0,0,0,1,0,1,Colombia
Oswaldo Palencia,0,14.0,0,0,1,0,1,Venezuela
Oswaldo Ramírez,0,219.0,0,1,2,3,5,Argentina
Oswaldo Taurisano,3,121.0,0,0,3,0,3,Brazil
Oswaldo Vizcarrondo,1,59.0,0,0,1,1,2,Chile
Otabek Shukurov,0,141.0,0,1,2,0,2,Uzbekistan
Otar Kakabadze,0,76.0,1,0,1,0,1,Greece
Othman Ferjani,0,50.0,0,0,0,1,1,Egypt
Otis Roberts,0,124.0,0,0,1,1,2,Guyana
Otis Steede,0,43.0,0,0,1,0,1,Bermuda
Ottmar Walter,4,286.0,0,0,3,2,5,Germany
Otto Addo,0,37.0,0,0,1,0,1,Ghana
Otto Siffling,1,108.0,0,0,2,1,3,Belgium
Otto Walzhofer,0,51.0,0,0,1,0,1,Austria
Otávio,0,15.0,0,0,1,0,1,Portugal
Oumar Barro,0,62.0,0,0,2,0,2,Burkina Faso
Oumar Ben Salah,1,187.0,0,0,5,1,6,Ivory Coast
Oumar Kalabane,0,103.0,0,0,0,2,2,Ghana
Oumar N'Diaye,0,22.0,0,0,1,0,1,Mauritania
Oumar Tchomogo,0,210.0,0,2,5,0,5,Benin
Oumed Alidodov,0,32.0,0,0,1,1,2,Tajikistan
Oumed Oukri,0,5.0,0,0,1,0,1,Ethiopia
Oupa Manyisa,1,47.0,0,0,1,0,1,South Africa
Ousman Jallow,0,26.0,0,0,1,0,1,Gambia
Ousmane Badara Bangoura,0,15.0,0,0,0,1,1,Togo
Ousmane Bangoura,2,253.0,0,0,0,4,4,Botswana
Ousmane Dembélé,0,19.0,0,0,0,1,1,Kazakhstan
Ousmane Sanou,2,169.0,0,0,2,1,3,Burkina Faso
Ousmane Sidibé,0,61.0,1,0,1,0,1,DR Congo
Ousmane Thiam Tollo,1,50.0,0,1,1,1,2,Ghana
Oussama Darragi,0,355.0,0,2,2,3,5,Tunisia
Ovays Azizi,1,75.0,1,0,1,0,1,India
Ove Bech Nielsen,0,91.0,0,0,0,2,2,England
Ove Grahn,1,254.0,0,1,3,1,4,Norway
Ove Kindvall,0,386.0,0,1,5,4,9,Cyprus
Ove Ødegaard,0,54.0,0,0,0,2,2,Austria
Ovidio Mezza,0,198.0,0,1,2,2,4,Bolivia
Ovidiu Hanganu,0,86.0,0,0,0,1,1,Cyprus
Ovidiu Hoban,0,90.0,0,0,1,0,1,Romania
Ovidiu Petre,0,29.0,0,0,1,0,1,Romania
Oyunbaataryn Mijiddorj,1,34.0,0,0,0,1,1,Kyrgyzstan
Ozan Tufan,4,344.0,0,0,2,4,6,Czech Republic
Oğuz Çetin,0,130.0,0,0,2,0,2,Turkey
Oğuzhan Özyakup,0,8.0,0,0,1,0,1,Turkey
Oļegs Aleksejenko,0,3.0,0,0,0,1,1,Albania
Pa Dibba,0,9.0,0,0,0,1,1,Namibia
Paa Nii Lutterodt,1,52.0,0,0,1,0,1,Ghana
Pablo Aimar,2,312.0,0,0,4,2,6,Argentina
Pablo Armero,1,95.0,0,0,2,0,2,Colombia
Pablo Barrera,3,286.0,0,0,2,3,5,Nicaragua
Pablo Bengoechea,2,218.0,0,0,2,2,4,Chile
Pablo Cardozo,1,43.0,0,0,0,1,1,Solomon Islands
Pablo Contreras,0,28.0,0,0,1,0,1,Chile
Pablo César Aguilar,0,52.0,0,0,1,0,1,Paraguay
Pablo Daniel Escobar,0,195.0,0,0,4,0,4,Bolivia
Pablo Dorado,0,19.0,0,0,2,0,2,Uruguay
Pablo Fornals,0,32.0,0,0,0,1,1,Kosovo
Pablo Ganet,1,122.0,0,0,1,1,2,Equatorial Guinea
Pablo García,0,90.0,0,0,1,1,2,Uruguay
Pablo Herrera Barrantes,1,158.0,0,0,1,1,2,Costa Rica
Pablo León,1,89.0,0,0,0,1,1,Brazil
Pablo Lima,1,87.0,0,0,1,0,1,Uruguay
Pablo Palacios,0,83.0,0,0,1,0,1,Ecuador
Pablo Paz,0,58.0,0,0,1,0,1,Argentina
Pablo Punyed,0,45.0,0,0,1,0,1,El Salvador
Pablo Ramírez,1,76.0,0,0,0,1,1,Bolivia
Pablo Rojas,0,38.0,0,0,0,1,1,Venezuela
Pablo Sarabia,1,246.0,0,1,3,2,5,Spain
Pablo Tamburrini,0,51.0,0,0,0,1,1,Saudi Arabia
Pablo Thiam,0,24.0,0,0,0,1,1,Uganda
Paco Alcácer,2,515.0,0,0,5,3,8,Spain
Paco Clos,0,48.0,0,0,1,0,1,Spain
Paddy McCourt,0,158.0,0,0,2,0,2,Northern Ireland
Paddy McNair,0,168.0,0,1,0,2,2,Belarus
Paddy Moore,4,263.0,0,0,4,1,5,Republic of Ireland
Pai Soe,0,62.0,0,0,1,0,1,Myanmar
Paik Seung-ho,1,76.0,0,0,0,1,1,Brazil
Paisano Urbita Sosa,0,77.0,0,0,0,1,1,Uruguay
Pajtim Kasami,0,75.0,0,0,1,0,1,Switzerland
Pak Chol-min,0,96.0,0,0,2,1,3,Mongolia
Pak Doo-ik,2,57.0,0,0,1,1,2,North Korea
Pak Jong-hun,2,109.0,0,1,0,2,2,Iran
Pak Kwang-ryong,1,58.0,0,1,2,1,3,North Korea
Pak Nam-Chol,0,115.0,0,0,3,0,3,North Korea
Pak Seung-zin,5,276.0,0,0,3,2,5,North Korea
Pak Song-Gwan,0,63.0,0,0,1,0,1,North Korea
Pak Sung-Jin,0,48.0,0,0,0,1,1,Iran
Palhinha,3,573.0,0,0,5,4,9,Venezuela
Pambos Papadopoulos,0,46.0,0,0,1,0,1,Cyprus
Pambos Pittas,1,184.0,0,3,4,0,4,Cyprus
Panagiotis Kone,0,86.0,0,0,1,0,1,Greece
Panagiotis Sofianopoulos,0,25.0,0,0,1,0,1,Greece
Panagiotis Tachtsidis,0,57.0,0,0,1,0,1,Greece
Panagiotis Tsalouchidis,0,392.0,0,0,1,6,7,Greece
Panajot Pano,0,67.0,0,0,2,0,2,Albania
Panayiotis Engomitis,0,70.0,0,0,2,0,2,Cyprus
Panayiotis Marangos,0,8.0,0,0,0,1,1,Netherlands
Panayiotis Xiourouppas,0,20.0,0,0,1,1,2,Hungary
Panayot Panayotov,0,61.0,0,0,2,0,2,Bulgaria
Pang Gwang-Chol,1,4.0,0,0,0,1,1,Indonesia
Panicos Efthimiadis,0,89.0,0,0,1,0,1,Cyprus
Paolo Amodio,0,14.0,0,0,1,0,1,Luxembourg
Paolo Barison,1,265.0,0,0,3,1,4,Italy
Paolo Guerrero,14,1484.0,0,1,13,12,25,Peru
Paolo Hurtado,0,95.0,0,0,0,2,2,Venezuela
Paolo Maldini,0,226.0,0,0,5,0,5,Italy
Paolo Montero,1,256.0,0,0,4,1,5,Uruguay
Paolo Rossi,9,418.0,0,1,5,5,10,France
Papa Bouba Diop,6,350.0,0,0,3,5,8,Nigeria
Papa Camara,2,178.0,0,0,4,0,4,Guinea
Papa Dia,0,84.0,0,0,0,1,1,Mali
Papa Yakhya Lette,0,34.0,0,0,0,1,1,Gabon
Papakouli Diop,1,43.0,0,0,1,0,1,Senegal
Pape Abou Cissé,0,45.0,1,0,1,0,1,Togo
Pape Fall,1,28.0,0,0,0,1,1,Mozambique
Pape Sarr,1,45.0,0,0,0,1,1,Burkina Faso
Pape Seydou Diop,0,16.0,0,0,0,1,1,Algeria
Pape Thiaw,0,45.0,0,0,0,2,2,Namibia
Papi Kimoto,2,117.0,0,1,1,1,2,Tunisia
Papiss Cissé,0,221.0,0,1,0,5,5,Uganda
Papito Merencia,0,24.0,0,0,1,1,2,Curaçao
Papu Gómez,2,16.0,0,0,2,0,2,Argentina
Papy Okitankoy Kimoto,0,90.0,0,0,1,0,1,DR Congo
Paramasivan Ravindran,2,162.0,0,0,0,2,2,Macau
Park Chang-Sun,1,85.0,0,0,1,1,2,South Korea
Park Chu-young,2,620.0,1,2,6,8,14,Uzbekistan
Park Ji-sung,2,565.0,0,0,6,3,9,South Korea
Park Jin-seop,1,51.0,1,0,0,1,1,South Korea
Park Jung-bae,1,57.0,0,0,1,1,2,South Korea
Park Kun-Ha,0,86.0,0,0,1,0,1,South Korea
Park Kyung-Hoon,1,41.0,0,0,0,1,1,Nepal
Park Lee-chun,3,260.0,0,1,1,3,4,Cambodia
Park Nam-Yeol,0,63.0,0,0,1,0,1,South Korea
Park Sang-in,0,234.0,0,0,3,0,3,South Korea
Park Seung-ok,1,74.0,0,0,0,1,1,Hong Kong
Park Soo-Il,0,68.0,0,0,2,0,2,South Korea
Park Su-deok,1,37.0,0,0,0,1,1,Cambodia
Park Yi-Chun,0,52.0,0,0,1,0,1,South Korea
Parviz Ghelichkhani,1,240.0,0,1,5,0,5,Iran
Pascal Anicet,0,53.0,1,0,1,0,1,Benin
Pascal Feindouno,8,1010.0,0,4,10,9,19,Uganda
Pascal Miézan,0,91.0,0,0,1,1,2,Congo
Pascal Ochieng,0,41.0,0,0,0,1,1,Seychelles
Paschalis Christoforou,0,72.0,0,0,1,0,1,Cyprus
Pascual Somma,0,88.0,0,0,1,0,1,Uruguay
Pat Nevin,0,262.0,0,1,4,0,4,Scotland
Pat Stanton,0,22.0,1,0,1,0,1,Portugal
Patesko,6,205.0,0,0,6,0,6,Brazil
Patiparn Phetphun,0,82.0,0,0,1,0,1,Thailand
Patou Ebunga-Simbi,0,81.0,0,0,0,1,1,Togo
Patrice Abanda,0,18.0,0,0,1,0,1,Cameroon
Patrice Bernier,1,25.0,0,0,0,1,1,Costa Rica
Patrice Loko,2,146.0,0,0,1,1,2,Azerbaijan
Patricio Urrutia,0,69.0,0,0,0,1,1,Argentina
Patricio Yáñez,1,209.0,0,0,3,1,4,Chile
Patrick Aisa,0,123.0,0,0,0,2,2,Tahiti
Patrick Battiston,0,73.0,0,0,0,2,2,Sweden
Patrick Blair,0,51.0,0,0,1,0,1,Jamaica
Patrick Bühlmann,0,59.0,0,0,0,1,1,Wales
Patrick Diaike,0,87.0,0,0,1,0,1,New Caledonia
Patrick Kaddu,1,14.0,0,0,0,1,1,DR Congo
Patrick Kluivert,5,1154.0,0,0,13,9,22,Netherlands
Patrick M'Boma,13,1351.0,0,0,14,10,24,Cameroon
Patrick Mabedi,0,174.0,0,1,1,1,2,Malawi
Patrick Mayo,1,29.0,0,0,0,1,1,Morocco
Patrick Mkontwana,0,53.0,0,0,0,1,1,Egypt
Patrick Modeste,0,105.0,0,0,1,1,2,Haiti
Patrick Mutesa Mafisango,0,19.0,0,0,0,1,1,Algeria
Patrick Müller,0,74.0,0,0,1,0,1,Switzerland
Patrick Nachok,0,88.0,0,0,1,0,1,Kenya
Patrick Percin,1,51.0,0,0,0,1,1,Trinidad and Tobago
Patrick Phiri,1,20.0,0,0,0,1,1,Burkina Faso
Patrick Ranaivoson,0,42.0,1,0,1,0,1,Congo
Patrick Reichelt,0,12.0,0,0,0,1,1,Guam
Patrick Ronaldinho Wleh,0,32.0,0,0,1,0,1,Liberia
Patrick Vervoort,2,123.0,0,0,2,1,3,Belgium
Patrick Vieira,2,197.0,0,0,1,4,5,South Korea
Patrick Zinhagel,0,153.0,0,0,1,1,2,Aruba
Patrik Andersson,0,110.0,0,0,1,1,2,Sweden
Patrik Berger,1,737.0,0,4,12,2,14,Czech Republic
Patrik Schick,5,467.0,0,2,4,7,11,Czech Republic
Patson Daka,0,125.0,0,0,2,1,3,Algeria
Patterson Daudau,4,156.0,0,0,4,0,4,Solomon Islands
Pau Torres,0,62.0,0,0,1,0,1,Spain
Paul Agostino,3,139.0,0,0,3,0,3,Australia
Paul Aguilar,1,64.0,0,0,1,1,2,Mexico
Paul Arriola,0,200.0,0,0,4,0,4,United States
Paul Bodin,0,166.0,0,2,1,1,2,Germany
Paul Bravo,1,27.0,0,0,1,0,1,United States
Paul Breitner,1,354.0,0,2,6,1,7,Germany
Paul Caligiuri,1,60.0,0,0,1,0,1,United States
Paul Cam,0,22.0,0,0,0,1,1,British Virgin Islands
Paul Cann,0,70.0,0,0,0,1,1,Antigua and Barbuda
Paul Cominges,2,72.0,0,0,2,0,2,Peru
Paul Courant,0,60.0,0,0,1,0,1,Belgium
Paul Davis,2,333.0,0,0,3,3,6,Jamaica
Paul Dickov,0,45.0,0,0,1,0,1,Scotland
Paul Fenech,0,40.0,0,0,1,0,1,Malta
Paul Fenwick,0,81.0,1,0,1,0,1,Mexico
Paul Gascoigne,0,445.0,0,0,6,2,8,England
Paul Hall,2,159.0,0,0,0,3,3,El Salvador
Paul Hartley,0,84.0,0,0,0,1,1,Slovenia
Paul Ince,2,95.0,0,0,0,2,2,San Marino
Paul Kakai,1,16.0,0,0,0,1,1,Fiji
Paul Kay,2,213.0,0,0,2,2,4,New Caledonia
Paul Komboi,2,81.0,0,0,0,2,2,Fiji
Paul Lambert,0,62.0,0,0,0,1,1,Faroe Islands
Paul Mariner,1,385.0,0,0,4,3,7,Luxembourg
Paul May,0,33.0,0,0,0,1,1,Netherlands
Paul McGee,0,46.0,0,0,0,2,2,Cyprus
Paul McGrath,0,368.0,0,0,4,3,7,Republic of Ireland
Paul McStay,1,190.0,0,0,5,2,7,Scotland
Paul Moukila,2,91.0,0,0,2,0,2,Congo
Paul Papp,0,153.0,0,0,2,0,2,Romania
Paul Peschisolido,0,148.0,0,0,4,0,4,Canada
Paul Philipp,0,129.0,0,2,2,1,3,Luxembourg
Paul Poatinda,3,147.0,0,0,3,0,3,New Caledonia
Paul Pogba,3,394.0,0,0,5,2,7,Belarus
Paul Ritchie,0,30.0,0,0,0,1,1,Czech Republic
Paul Ruben Corte,0,180.0,0,0,2,0,2,Suriname
Paul Scholes,3,476.0,0,0,5,6,11,England
Paul Sixsmith,0,69.0,0,0,1,0,1,Malta
Paul Stalteri,1,59.0,0,0,0,1,1,Costa Rica
Paul Sturrock,0,84.0,0,0,1,1,2,Portugal
Paul Trimboli,3,572.0,0,0,10,1,11,Australia
Paul Urlovic,0,189.0,0,0,3,0,3,New Zealand
Paul Van Himst,0,694.0,0,1,10,5,15,Belgium
Paul Vandenberg,0,246.0,0,0,1,3,4,Belgium
Paul Wade,1,169.0,0,1,2,1,3,Tahiti
Paul Young,0,125.0,0,0,1,2,3,Saint Vincent and the Grenadines
Paul-Gaston N'Dongo,2,224.0,0,0,4,1,5,Cameroon
Paul-José M'Poku,2,195.0,0,0,2,1,3,Togo
Pauleta,5,1283.0,0,0,17,8,25,Portugal
Paulinho,1,524.0,0,1,5,5,10,Brazil
Paulinho Santos,0,82.0,0,0,0,2,2,Liechtenstein
Paulino Vieira Dias,0,30.0,0,0,1,0,1,Angola
Paulo Alves,0,383.0,0,0,2,3,5,Portugal
Paulo António Alves,1,445.0,0,1,8,2,10,Angola
Paulo César Chávez,0,1.0,0,0,1,0,1,Mexico
Paulo Dybala,2,112.0,0,0,1,1,2,Argentina
Paulo Figueiredo,0,60.0,0,0,0,1,1,Nigeria
Paulo Futre,0,232.0,0,1,2,3,5,Switzerland
Paulo Jorge Da Silva,2,136.0,0,2,2,2,4,Uganda
Paulo Madeira,0,181.0,0,0,1,2,3,Portugal
Paulo Pisaneschi,3,142.0,0,0,3,1,4,Brazil
Paulo Roberto Falcão,3,248.0,0,0,3,1,4,Brazil
Paulo Roberto Jamelli Júnior,2,92.0,0,0,0,2,2,Honduras
Paulo Silas,0,37.0,0,0,1,0,1,Brazil
Paulo Valentim,5,275.0,0,0,3,2,5,Bolivia
Paulo Wanchope,15,1962.0,0,0,22,15,37,Costa Rica
Paulo da Silva,0,110.0,0,0,1,2,3,Chile
Paulus Arajuuri,0,181.0,0,0,3,0,3,Finland
Paulus Roiha,0,87.0,0,0,0,1,1,North Macedonia
Paulus Shipanga,0,83.0,0,0,2,0,2,Namibia
Pavel Badea,0,77.0,0,0,1,0,1,Romania
Pavel Chaloupka,0,70.0,0,0,0,1,1,Italy
Pavel Hapal,1,23.0,0,0,1,0,1,Czech Republic
Pavel Kadeřábek,0,69.0,0,0,1,1,2,Czech Republic
Pavel Kuka,1,715.0,0,0,8,5,13,Albania
Pavel Matyash,1,50.0,1,0,1,0,1,China PR
Pavel Nedvěd,3,511.0,0,0,8,6,14,Czech Republic
Pavel Panov,0,210.0,0,0,3,2,5,Bulgaria
Pavel Pashayev,0,26.0,1,0,1,0,1,Wales
Pavel Pogrebnyak,0,237.0,0,1,2,2,4,Russia
Pavel Savitski,0,241.0,0,0,3,0,3,Belarus
Pavel Sedko,1,31.0,0,0,1,0,1,Belarus
Pavel Sitko,0,28.0,0,0,1,0,1,Belarus
Pavel Solomin,1,82.0,0,0,0,1,1,Saudi Arabia
Pavel Verbíř,0,84.0,0,0,1,0,1,Czech Republic
Pavel Yevteyev,0,187.0,0,0,2,1,3,Kazakhstan
Pavlo Yakovenko,1,2.0,0,0,1,0,1,Russia
Pavlos Savva,0,60.0,0,0,0,1,1,Greece
Pavol Molnár,0,89.0,0,0,1,0,1,Czechoslovakia
Pawel Janas,0,5.0,1,0,0,1,1,Poland
Paweł Brożek,0,27.0,0,0,1,0,1,Poland
Paweł Kaczorowski,0,75.0,0,0,0,1,1,San Marino
Paweł Kryszałowicz,1,122.0,0,0,2,1,3,Wales
Paweł Król,0,90.0,0,0,0,1,1,Portugal
Pedri,1,20.0,1,0,1,0,1,Croatia
Pedro,1,392.0,0,0,3,4,7,Belarus
Pedro Acosta,1,105.0,1,1,3,0,3,Venezuela
Pedro Alcides Bareiro,0,10.0,0,0,1,0,1,Paraguay
Pedro Alejandro García,0,76.0,0,0,0,1,1,Paraguay
Pedro Amorim,2,99.0,0,0,2,0,2,Brazil
Pedro Antonio Cabral,1,90.0,0,0,0,1,1,Argentina
Pedro Aquino,0,101.0,0,0,0,2,2,Aruba
Pedro Araya,2,160.0,0,0,3,0,3,Chile
Pedro Arnauda,0,192.0,0,0,3,0,3,Mexico
Pedro Barbosa,0,240.0,0,0,3,1,4,Portugal
Pedro Calomino,1,15.0,0,0,1,0,1,Argentina
Pedro Cea,0,249.0,0,0,5,0,5,Uruguay
Pedro Eugenio Callá,0,86.0,0,0,2,0,2,Argentina
Pedro Febles,0,106.0,0,0,1,1,2,Venezuela
Pedro Fernández,1,51.0,0,0,0,1,1,Bolivia
Pedro González Vera,0,44.0,0,0,0,1,1,Bolivia
Pedro Hugo López,2,294.0,0,1,1,4,5,Ecuador
Pedro Lago,3,149.0,0,0,0,3,3,Ecuador
Pedro Monzón,1,62.0,0,0,1,0,1,Argentina
Pedro Munitis,1,51.0,0,0,0,1,1,Serbia
Pedro Pablo León,1,338.0,0,0,1,5,6,Ecuador
Pedro Pasculli,1,165.0,0,0,2,2,4,Colombia
Pedro Petrone,3,544.0,0,0,7,3,10,Uruguay
Pedro Reyes,2,199.0,0,0,3,1,4,Chile
Pedro Rocha,1,347.0,0,0,6,3,9,Uruguay
Pedro Sarmiento,0,40.0,0,0,0,1,1,Uruguay
Pedro Troglio,1,27.0,0,0,1,0,1,Argentina
Pedro Waldemar Manfredini,0,55.0,0,0,2,0,2,Argentina
Pedro Zaballa,0,113.0,0,0,0,2,2,Republic of Ireland
Pedro Zingone,0,73.0,0,0,1,0,1,Uruguay
Pelayo Ayala,1,83.0,0,0,0,1,1,Brazil
Pele Kaimana,0,69.0,0,0,1,0,1,Zambia
Pelé,17,1370.0,0,0,20,6,26,Brazil
Peng Weiguo,3,183.0,0,0,2,3,5,China PR
Penieli Moa,1,71.0,0,1,0,1,1,American Samoa
Pep Guardiola,1,114.0,0,1,3,1,4,Spain
Pepe,5,273.0,0,0,3,3,6,Portugal
Per Edmund Mordt,0,71.0,0,0,1,0,1,Norway
Per Kristoffersen,0,77.0,0,0,1,0,1,Norway
Per Mertesacker,0,84.0,0,0,2,1,3,Germany
Per Pedersen,0,28.0,0,0,1,0,1,Denmark
Per Pettersen,0,80.0,0,0,0,1,1,Iceland
Per Røntved,0,258.0,0,2,4,0,4,Denmark
Percival Piggott,0,33.0,0,0,0,1,1,United States
Percy Colque,0,54.0,0,0,1,0,1,Bolivia
Percy Rojas,1,149.0,0,0,2,1,3,Chile
Percy Tau,0,65.0,0,0,1,1,2,South Africa
Peregrino Anselmo,0,82.0,0,0,3,0,3,Uruguay
Pereira Tavares,0,47.0,0,0,2,0,2,Guinea-Bissau
Peri Neufeld,1,36.0,0,0,1,0,1,Israel
Pertti Mäkipää,0,57.0,0,0,0,1,1,Greece
Pervis Estupiñán,0,99.0,0,0,1,1,2,Ecuador
Petar Radaković,1,152.0,0,0,1,1,2,Yugoslavia
Petar Stojanović,0,42.0,0,0,1,0,1,Slovenia
Petar Velichkov,0,86.0,0,0,1,0,1,Bulgaria
Petar Zhekov,0,299.0,0,0,4,2,6,Bulgaria
Pete Matevich,2,65.0,0,0,2,0,2,United States
Peter Anieke,0,90.0,0,0,0,1,1,Cameroon
Peter Ankersen,0,78.0,0,0,1,0,1,Denmark
Peter Artner,0,9.0,1,0,0,1,1,Austria
Peter Barnes,0,54.0,0,0,0,1,1,Bulgaria
Peter Beardsley,1,286.0,0,0,5,1,6,England
Peter Byers,0,526.0,0,1,5,6,11,Antigua and Barbuda
Peter Cargill,0,66.0,0,0,1,0,1,Jamaica
Peter Crouch,1,509.0,0,0,8,2,10,England
Peter Crève,0,81.0,0,0,1,0,1,Belgium
Peter Dahl,0,86.0,0,0,0,1,1,Romania
Peter Dawo,0,47.0,0,0,1,0,1,Kenya
Peter Dubovský,4,738.0,0,4,10,4,14,Czechoslovakia
Peter Ducke,0,455.0,0,0,2,5,7,German DR
Peter Dzúrik,0,56.0,0,0,0,1,1,North Macedonia
Peter Farrell,0,65.0,0,0,0,1,1,Finland
Peter Fregene,1,81.0,1,0,0,1,1,Nigeria
Peter Greenaway,0,23.0,0,0,0,1,1,Antigua and Barbuda
Peter Hlinka,0,72.0,0,0,1,0,1,Slovakia
Peter Houtman,0,270.0,0,0,4,1,5,Netherlands
Peter Hrstic,0,2.0,0,0,1,0,1,Austria
Peter Isaacs,0,52.0,0,0,0,1,1,Trinidad and Tobago
Peter Jehle,0,12.0,1,0,0,1,1,Liechtenstein
Peter Kaumba,2,56.0,0,0,0,3,3,Nigeria
Peter Kotte,0,3.0,0,1,1,0,1,German DR
Peter Larsson,0,97.0,0,1,1,2,3,Sweden
Peter Lorimer,1,72.0,0,0,1,1,2,Scotland
Peter McParland,5,276.0,0,0,0,7,7,Wales
Peter Mgangira,0,88.0,0,0,0,1,1,Ethiopia
Peter Millar,0,175.0,0,0,3,0,3,United States
Peter Méndez,3,134.0,0,1,0,3,3,Ecuador
Peter Møller,1,89.0,0,0,3,1,4,Denmark
Peter Ndlovu,3,548.0,0,1,6,8,14,Zimbabwe
Peter Nicholas,0,15.0,0,0,0,1,1,Malta
Peter Nielsen,0,70.0,0,0,1,0,1,Denmark
Peter Németh,0,126.0,0,0,1,1,2,Slovakia
Peter O'Sullivan,0,18.0,0,0,1,0,1,Wales
Peter Odemwingie,3,278.0,0,0,6,0,6,Nigeria
Peter Ollerton,0,273.0,0,0,2,4,6,Australia
Peter Ouma,1,100.0,0,0,2,0,2,Kenya
Peter Pekarík,0,52.0,0,0,2,0,2,Slovakia
Peter Pumm,0,78.0,0,0,1,0,1,Austria
Peter Rasmussen,2,163.0,0,0,2,0,2,Denmark
Peter Risi,0,125.0,0,0,0,2,2,Russia
Peter Rock,0,89.0,0,0,1,0,1,German DR
Peter Roronamahava,1,45.0,0,0,0,1,1,New Zealand
Peter Shalulile,1,209.0,0,0,2,2,4,Eritrea
Peter Sharne,4,388.0,0,0,4,1,5,Australia
Peter Stöger,0,438.0,0,0,8,1,9,Austria
Peter Tino,0,142.0,0,0,3,0,3,Tanzania
Peter Van Der Heyden,0,75.0,0,0,0,1,1,Japan
Peter Vermes,0,70.0,0,0,2,0,2,United States
Peter Wilson,2,165.0,0,0,3,0,3,Australia
Peter Withe,0,70.0,0,0,1,0,1,England
Peter van Vossen,0,398.0,0,1,3,3,6,Netherlands
Peterkins Kayira,0,150.0,0,0,3,0,3,Malawi
Petit,0,239.0,1,0,3,0,3,Portugal
Petit Sory,1,126.0,0,0,1,2,3,DR Congo
Petko Petkov,0,48.0,0,0,1,0,1,Bulgaria
Petr Janečka,0,388.0,0,0,6,2,8,Turkey
Petr Jiráček,1,156.0,0,0,0,3,3,Montenegro
Petr Kachuro,0,73.0,0,1,0,1,1,Scotland
Petr Rada,0,139.0,0,1,2,0,2,Czechoslovakia
Petr Vrabec,1,13.0,0,0,1,0,1,Czech Republic
Petri Helin,0,83.0,0,0,0,1,1,Faroe Islands
Petri Järvinen,0,105.0,0,0,1,1,2,Finland
Petri Pasanen,0,23.0,1,0,1,0,1,Russia
Petri Tiainen,0,82.0,0,0,1,0,1,Finland
Petros Mantalos,0,89.0,0,0,2,0,2,Greece
Petros Marinakis,0,67.0,0,0,0,1,1,Malta
Petru Racu,0,65.0,1,0,0,1,1,Moldova
Petter Hansson,1,72.0,0,0,0,1,1,Greece
Petter Rudi,0,21.0,0,0,0,2,2,Hungary
Petter Villegas,0,137.0,0,1,2,0,2,Puerto Rico
Phan Thanh Bình,0,32.0,0,0,1,0,1,Vietnam
Phan Thanh Hùng,1,77.0,0,0,1,0,1,Vietnam
Phan Văn Tài Em,0,118.0,0,0,3,0,3,Vietnam
Phan Văn Đức,0,76.0,0,0,1,0,1,Vietnam
Phengta Phounsamay,0,15.0,0,0,1,0,1,Laos
Phil Babb,0,88.0,1,0,1,0,1,Russia
Phil Evans,1,28.0,0,0,1,0,1,South Africa
Phil Foden,1,51.0,0,0,0,1,1,Wales
Phil Gray,0,321.0,0,0,3,2,5,Northern Ireland
Phil Jagielka,0,25.0,0,0,1,0,1,England
Phil Masinga,1,231.0,0,0,5,2,7,South Africa
Phil Neal,0,174.0,0,0,1,1,2,Denmark
Phil Roberts,0,70.0,0,0,1,0,1,Wales
Phil Woosnam,0,7.0,0,0,1,0,1,Wales
Phil Younghusband,0,100.0,0,1,2,0,2,Philippines
Philip Mulryne,0,118.0,0,0,0,2,2,Czech Republic
Philip Zialor,0,137.0,0,0,3,0,3,Seychelles
Philipp Hosiner,0,28.0,0,0,2,0,2,Austria
Philipp Lahm,2,135.0,0,0,3,0,3,Germany
Philippe Albert,2,272.0,0,0,1,3,4,Faroe Islands
Philippe Anziani,0,89.0,0,0,1,0,1,France
Philippe Clement,0,55.0,0,0,0,1,1,Bulgaria
Philippe Coutinho,5,713.0,0,2,14,0,14,Brazil
Philippe Erne,0,7.0,0,0,1,0,1,Liechtenstein
Philippe Fargeon,0,55.0,0,0,1,0,1,France
Philippe Gondet,0,112.0,0,0,3,0,3,France
Philippe Mahut,0,5.0,1,0,1,0,1,Republic of Ireland
Philippe Mexès,0,28.0,0,0,0,1,1,Luxembourg
Philippe Michel Mouthé,0,34.0,0,0,1,0,1,Cameroon
Philippe Senderos,1,149.0,0,0,2,3,5,Cyprus
Philippe Vorbe,0,52.0,0,0,1,0,1,Haiti
Phillemon Tegire,1,22.0,1,0,0,1,1,Zimbabwe
Phillip Cocu,3,349.0,0,0,6,4,10,Netherlands
Phillip Omondi,3,95.0,0,0,0,3,3,Congo
Phillip Skeal,0,68.0,1,0,0,1,1,Antigua and Barbuda
Phutthadavong Chanthalome,0,88.0,0,0,1,0,1,Laos
Phạm Thành Lương,0,62.0,0,0,1,0,1,Vietnam
Phạm Văn Quyến,0,80.0,0,1,1,0,1,Vietnam
Pier Domenico Della Valle,0,34.0,0,0,0,1,1,Finland
Pier Janssen,0,48.0,0,0,1,0,1,Belgium
Pierino Prati,0,250.0,0,0,3,2,5,Bulgaria
Pierluigi Casiraghi,2,295.0,0,0,4,3,7,Portugal
Piero Alva,0,47.0,0,0,2,0,2,Peru
Piero Hincapié,0,86.0,1,0,2,0,2,Ecuador
Pieros Sotiriou,1,479.0,0,2,7,2,9,Cyprus
Pierre Flamion,0,160.0,0,0,0,2,2,Luxembourg
Pierre Issa,0,77.0,1,0,1,0,1,France
Pierre Kalala Mukendi,3,154.0,0,1,3,0,3,DR Congo
Pierre Lingongo,0,23.0,0,0,1,0,1,Congo
Pierre Littbarski,2,416.0,0,0,5,5,10,Austria
Pierre Njanka,1,77.0,0,0,1,0,1,Cameroon
Pierre Tchibota,2,58.0,0,0,0,2,2,Algeria
Pierre Wacapo,1,90.0,0,0,1,0,1,New Caledonia
Pierre Wajoka,3,180.0,0,1,5,0,5,New Caledonia
Pierre Webó,0,360.0,0,0,3,5,8,Cameroon
Pierre Womé,1,44.0,0,0,1,0,1,Cameroon
Pierre van Hooijdonk,3,703.0,0,2,6,5,11,Wales
Pierre-Emerick Aubameyang,1,733.0,0,5,11,2,13,Gabon
Pierre-Emile Højbjerg,0,208.0,0,0,2,1,3,Denmark
Piet Keizer,0,412.0,0,1,6,2,8,German DR
Piet Kruiver,0,41.0,0,0,1,1,2,Switzerland
Piet Wildschut,0,19.0,0,0,0,1,1,Switzerland
Piet de Boer,0,228.0,0,0,3,0,3,Netherlands
Pietro Anastasi,1,145.0,0,0,2,1,3,Italy
Pietro Ferraris,1,2.0,0,0,1,0,1,Italy
Pietro Marsetti,0,72.0,0,0,1,0,1,Ecuador
Pietro Vierchowod,0,63.0,0,0,1,1,2,Cyprus
Pinga,4,176.0,0,0,2,2,4,Bolivia
Pini Balili,1,215.0,0,0,2,1,3,Israel
Pinula Contreras,0,169.0,0,0,3,1,4,Guatemala
Piotr Czachowski,0,59.0,0,0,1,0,1,Poland
Piotr Nowak,0,70.0,0,0,2,0,2,Poland
Piotr Trochowski,0,72.0,0,0,1,0,1,Germany
Piotr Włodarczyk,0,36.0,0,0,0,1,1,Northern Ireland
Piotr Zieliński,1,187.0,0,0,2,2,4,San Marino
Pipat Thonkanya,0,148.0,0,0,2,0,2,Thailand
Piqueti,1,60.0,0,0,0,3,3,Cameroon
Pirmurod Burkhanov,0,84.0,0,0,0,2,2,Kyrgyzstan
Pirri,1,388.0,0,2,8,2,10,Argentina
Pita David Maki,1,74.0,0,0,0,1,1,Cook Islands
Pita Rabo,1,24.0,0,0,1,0,1,Fiji
Pius Ndiefi,1,73.0,0,0,1,1,2,Zambia
Piyapong Pue-on,9,468.0,0,1,5,6,11,South Korea
Pizzi,0,52.0,0,0,1,0,1,Portugal
Plamen Getov,1,96.0,0,0,2,1,3,Bulgaria
Plamen Markov,0,28.0,0,0,0,1,1,Finland
Plamen Nikolov,0,68.0,0,0,1,0,1,Bulgaria
Platini,1,35.0,0,0,0,1,1,Morocco
Pokklaw Anan,0,214.0,0,0,2,1,3,Thailand
Pollen Ndlanya,1,77.0,0,0,0,1,1,Uruguay
Polly Ouma,0,163.0,0,0,1,1,2,Ethiopia
Polo Carrera,0,96.0,0,0,2,0,2,Ecuador
Ponaryo Astaman,1,48.0,0,0,0,1,1,Qatar
Ponciano Castro,0,121.0,0,0,1,1,2,Ecuador
Pongthorn Thiubthong,1,54.0,0,0,0,1,1,Bangladesh
Pontus Wernbloom,0,124.0,0,0,2,0,2,Sweden
Porfirio Jiménez,0,141.0,0,0,2,1,3,Bolivia
Porfirio Rolón,1,14.0,0,0,0,1,1,Chile
Poul Pedersen,0,17.0,0,0,1,0,1,Denmark
Prapon Tantariyanond,0,237.0,0,0,3,0,3,Thailand
Prasert Changmool,0,79.0,0,0,0,1,1,Bangladesh
Preben Elkjær,6,1214.0,0,0,19,7,26,Denmark
Predrag Mijatović,12,1067.0,0,4,13,10,23,Serbia
Predrag Pašić,0,73.0,0,0,1,0,1,Yugoslavia
Predrag Spasić,0,11.0,0,0,1,0,1,Yugoslavia
Predrag Đorđević,1,51.0,0,0,1,0,1,Serbia
Preguinho,3,202.0,0,0,1,2,3,Brazil
Preki,1,232.0,0,0,3,1,4,Guatemala
Presley Carson,1,40.0,0,0,0,1,1,Canada
Primož Gliha,0,346.0,0,0,2,4,6,Slovenia
Prince Akim Daye,1,7.0,0,0,1,0,1,Liberia
Prince Daye,0,5.0,0,0,1,0,1,Liberia
Prince Mumba,0,57.0,0,0,0,1,1,Mauritania
Prince Oniangué,1,102.0,0,0,0,2,2,São Tomé and Príncipe
Prince Opoku Polley,1,42.0,0,0,1,0,1,Ghana
Prince Polley,1,54.0,0,0,0,1,1,Nigeria
Prince Tagoe,0,47.0,0,0,3,0,3,Ghana
Prvoslav Mihajlović,2,96.0,0,1,0,2,2,France
Przemysław Frankowski,0,74.0,0,0,1,0,1,Poland
Przemysław Kaźmierczak,0,84.0,0,0,1,0,1,Poland
Préjuce Nakoulma,1,490.0,0,0,6,3,9,Burkina Faso
Putut Widjanarko,1,55.0,0,0,1,0,1,Indonesia
Pyry Soiri,0,168.0,0,0,0,2,2,Croatia
Pál Dárdai,0,108.0,0,0,0,2,2,Azerbaijan
Pál Teleki,1,11.0,0,0,0,1,1,Egypt
Pál Titkos,2,138.0,0,0,4,0,4,Hungary
Pável Pardo,2,491.0,0,1,7,1,8,Mexico
Pär Zetterberg,0,217.0,0,1,2,2,4,Sweden
Pål Jacobsen,0,49.0,0,0,2,0,2,Norway
Pål Lydersen,0,49.0,0,1,1,0,1,Norway
Péter Hannich,0,56.0,0,0,0,1,1,Luxembourg
Péter Juhász,0,51.0,0,0,1,0,1,Hungary
Péter Kovács,0,93.0,0,0,0,1,1,Malta
Péter Palotás,2,158.0,0,0,2,0,2,Hungary
Péter Rajczi,0,175.0,0,0,2,0,2,Hungary
Pétur Marteinsson,0,70.0,0,0,0,1,1,Faroe Islands
Pétur Ormslev,0,65.0,0,0,2,0,2,Iceland
Pétur Pétursson,0,219.0,0,1,3,2,5,German DR
Pól Jóhannus Justinussen,0,73.0,1,0,0,1,1,Faroe Islands
Pāvels Šteinbors,0,76.0,1,0,1,0,1,Austria
Přemysl Bičovský,0,177.0,0,0,3,2,5,Czechoslovakia
Qahtan Chathir,1,175.0,0,0,1,3,4,Pakistan
Qasim Said,0,1.0,0,0,0,1,1,India
Qazim Laçi,0,58.0,0,0,1,0,1,Albania
Qi Hong,3,372.0,0,0,5,2,7,China PR
Qiu Li,0,22.0,0,0,1,0,1,Singapore
Qu Bo,0,194.0,0,0,3,2,5,Cambodia
Quah Kim Song,0,85.0,0,0,2,0,2,Singapore
Quentin Clarke,1,135.0,0,0,1,2,3,Curaçao
Quincy Owusu-Abeyie,0,70.0,0,0,1,0,1,Ghana
Quincy Promes,0,116.0,0,0,3,0,3,Netherlands
Quini,1,133.0,0,0,0,3,3,Scotland
Quino Sierra,0,35.0,0,0,2,0,2,Spain
Quinton Fortune,1,111.0,0,2,1,1,2,Paraguay
Quinton Griffith,0,182.0,0,1,1,3,4,Antigua and Barbuda
Quinzinho,1,52.0,0,0,0,1,1,Ivory Coast
Qusay Munir,4,294.0,0,0,3,2,5,Turkmenistan
Quế Ngọc Hải,2,201.0,0,3,1,2,3,Vietnam
Raafat Attia,0,21.0,0,1,0,1,1,Sudan
Rabah Gamouh,0,129.0,0,0,0,2,2,Guinea
Rabah Madjer,3,808.0,0,1,11,3,14,Algeria
Rabia Al-Alawi,1,331.0,0,0,1,4,5,India
Rabih Ataya,1,73.0,0,0,0,1,1,Turkmenistan
Rachad Chitou,0,60.0,0,0,1,0,1,Benin
Rached Meddeb,1,128.0,0,0,1,1,2,Morocco
Rachid Alioui,1,64.0,0,0,1,0,1,Morocco
Rachid Benmahmoud,1,94.0,0,1,0,2,2,Algeria
Rachid Daoudi,0,123.0,0,0,0,3,3,Benin
Rachid Maâtar,1,86.0,0,0,1,0,1,Algeria
Rachid Rokki,0,49.0,0,0,1,0,1,Morocco
Radamel Falcao,3,923.0,0,4,12,4,16,Colombia
Rade Krunić,0,47.0,0,0,2,0,2,Bosnia and Herzegovina
Radek Bejbl,1,142.0,0,0,2,1,3,Czech Republic
Radek Drulák,0,170.0,0,0,3,0,3,Czech Republic
Radhi Jaïdi,2,239.0,0,0,2,2,4,Tunisia
Radhi Shenaishil,1,90.0,0,0,1,0,1,Iraq
Radhwan Nairooz,0,52.0,0,0,1,0,1,Oman
Radike Nawasu,0,110.0,0,0,0,2,2,Vanuatu
Radivoje Ognjanović,1,18.0,0,0,0,1,1,Paraguay
Radja Nainggolan,2,167.0,0,0,0,4,4,Bosnia and Herzegovina
Radomir Đalović,0,53.0,0,0,1,0,1,Montenegro
Radoslav Batak,0,13.0,0,0,1,0,1,Montenegro
Radoslav Dimitrov,0,9.0,0,0,0,1,1,Malta
Radoslav Kováč,0,69.0,0,0,1,1,2,Czech Republic
Radoslav Látal,1,78.0,0,0,2,0,2,Czech Republic
Radoslav Zabavník,0,90.0,0,0,1,0,1,Slovakia
Radostin Kishishev,0,77.0,1,0,2,0,2,Albania
Radosław Kałużny,0,229.0,0,0,3,3,6,Ukraine
Radosław Matusiak,0,95.0,0,0,1,2,3,Poland
Radu Gînsari,0,15.0,0,0,1,0,1,Moldova
Radu Nunweiller,0,129.0,0,0,1,1,2,Romania
Radu Rebeja,0,158.0,0,0,0,2,2,Germany
Radwan Abduljabar,0,49.0,0,0,1,0,1,Yemen
Radwan Al-Sheikh Hassan,1,52.0,0,0,2,0,2,Syria
Raed Ibrahim Saleh,0,7.0,0,0,1,0,1,Oman
Raf de Gregorio,1,117.0,0,0,1,1,2,New Zealand
Rafael Albrecht,1,231.0,0,1,3,0,3,Argentina
Rafael Alsua,0,65.0,0,0,1,0,1,Spain
Rafael Arlex Castillo,0,82.0,0,0,0,1,1,Paraguay
Rafael Burgos,0,236.0,0,0,2,1,3,El Salvador
Rafael Castellín,0,55.0,0,0,0,1,1,Uruguay
Rafael Dick,0,56.0,0,0,1,0,1,Honduras
Rafael Dudamel,0,87.0,0,0,1,0,1,Venezuela
Rafael García Torres,0,42.0,0,0,1,0,1,Mexico
Rafael Gordillo,1,201.0,0,0,1,2,3,Malta
Rafael Granados,1,90.0,0,0,0,1,1,Chile
Rafael Iriarte,0,86.0,0,0,1,0,1,Venezuela
Rafael Leão,2,170.0,0,0,2,0,2,Portugal
Rafael Maldonado,1,74.0,0,0,0,1,1,Colombia
Rafael Morales,0,85.0,0,0,2,0,2,Guatemala
Rafael Márquez,6,684.0,0,0,8,5,13,Mexico
Rafael Olarra,1,40.0,0,0,0,1,1,Costa Rica
Rafael Santana,3,295.0,0,0,3,2,5,Venezuela
Rafael Urazbakhtin,1,21.0,0,0,0,1,1,Nepal
Rafael van der Vaart,1,673.0,0,1,8,7,15,Netherlands
Rafael Ávalos,0,6.0,0,0,0,1,1,Haiti
Rafał Boguski,0,28.0,0,0,2,0,2,Poland
Rafał Murawski,0,28.0,0,0,0,1,1,Serbia
Rafał Siadaczka,0,22.0,0,0,0,1,1,Luxembourg
Rafał Wolski,0,89.0,0,0,0,1,1,Armenia
Rafi Ali,1,60.0,0,0,0,1,1,Kyrgyzstan
Rafi Joulfagi,1,122.0,0,0,1,1,2,Lebanon
Rafi Levi,1,13.0,0,0,1,0,1,Israel
Rafik Djebbour,0,91.0,0,0,2,0,2,Algeria
Rafik Halliche,2,71.0,0,0,0,2,2,Mali
Rafik Saïfi,0,231.0,0,0,4,1,5,Algeria
Rafik Yusupov,1,28.0,0,0,1,0,1,Kyrgyzstan
Rafiou Moutairou,1,56.0,0,0,0,1,1,Cameroon
Raghdan Shehadeh,0,92.0,0,0,2,0,2,Syria
Ragnar Klavan,0,165.0,3,0,2,1,3,Hungary
Ragnar Margeirsson,0,48.0,0,0,0,1,1,Austria
Ragnar Sigurðsson,1,158.0,0,0,3,2,5,Czech Republic
Rahamim Talbi,0,48.0,0,0,1,0,1,Israel
Raheem Sterling,1,830.0,0,0,12,4,16,England
Raheim Sargeant,0,4.0,0,0,0,1,1,United States Virgin Islands
Rahid Amirguliyev,0,177.0,0,0,0,3,3,Israel
Rahmad Darmawan,1,35.0,0,0,1,0,1,Indonesia
Rahman Hisham Abdullah,0,66.0,0,0,1,0,1,Bahrain
Rahman Rezaei,1,61.0,1,0,1,1,2,Iran
Rahmatullo Fuzailov,1,52.0,0,0,1,0,1,Tajikistan
Raimondo Ponte,0,59.0,0,0,0,1,1,Iceland
Raimonds Krollis,0,75.0,0,0,0,1,1,Gibraltar
Raimundo Infante,3,208.0,0,1,2,1,3,Bolivia
Raimundo Orsi,0,170.0,0,0,3,0,3,Italy
Raimundo Sandoval,1,9.0,0,0,1,0,1,Argentina
Rainer Bonhof,0,71.0,0,1,2,0,2,Germany
Rainer Ernst,0,591.0,0,1,4,5,9,German DR
Rainer Rauffmann,0,111.0,0,0,2,0,2,Cyprus
Rainford Kalaba,2,126.0,0,0,1,2,3,Zambia
Raio Piiroja,0,488.0,3,0,4,5,9,Faroe Islands
Raja Rafe,2,481.0,0,0,4,4,8,Syria
Rajab Elharbi,0,35.0,0,0,1,0,1,Libya
Rajabu Mwinyi,0,16.0,1,0,1,0,1,Gabon
Rajko Mitić,1,59.0,0,0,0,1,1,Switzerland
Raju Kaji Shakya,1,1.0,1,0,0,1,1,Nepal
Ralf Edström,3,367.0,0,0,7,2,9,Sweden
Ralf Minge,0,213.0,0,0,2,3,5,Luxembourg
Ralph Bean,0,122.0,0,0,2,1,3,Bermuda
Ralph Brand,0,140.0,0,0,2,1,3,Scotland
Ralph McPate,0,108.0,0,0,2,0,2,Canada
Ramadan Agab,0,154.0,0,0,0,3,3,Chad
Ramadan El Sayed,1,47.0,0,0,0,1,1,Algeria
Ramadan Sobhi,0,72.0,0,0,0,1,1,Libya
Raman Vasilyuk,0,351.0,0,2,5,2,7,Belarus
Raman Vijayan,1,81.0,0,0,1,0,1,India
Ramaz Shengelia,4,299.0,0,0,5,1,6,Russia
Ramazan Rragami,0,25.0,0,1,1,0,1,Albania
Ramez Dayoub,0,72.0,1,0,0,1,1,Lebanon
Rami Bedoui,1,90.0,1,0,1,0,1,Ghana
Rami Gershon,0,160.0,0,0,1,1,2,Malta
Ramil Sheydayev,0,82.0,0,0,1,2,3,Germany
Ramin Ott,1,94.0,0,0,1,1,2,American Samoa
Ramin Rezaeian,1,139.0,0,0,0,2,2,Guam
Ramiro Blacut,0,83.0,0,0,2,0,2,Bolivia
Ramiro Borja,0,57.0,0,0,0,1,1,Dominican Republic
Ramiro Castillo,0,119.0,0,0,1,1,2,Venezuela
Ramiro Funes Mori,0,15.0,0,0,0,1,1,Peru
Ramiro Navarro,0,57.0,0,0,1,0,1,Mexico
Ramiro Tobar,0,79.0,1,0,1,0,1,Chile
Ramiro Vaca,0,83.0,0,0,1,0,1,Bolivia
Ramiz Zerrouki,0,69.0,0,0,1,0,1,Algeria
Ramkel Lok,0,74.0,0,0,1,0,1,Ethiopia
Ramon Djamali,1,98.0,0,0,1,1,2,New Caledonia
Ramon Gjamaci,0,66.0,0,0,0,1,1,Fiji
Ramon Menezes,1,30.0,0,0,0,1,1,France
Ramoseli Thietsi,0,30.0,0,0,0,1,1,Zambia
Ramy Bensebaini,0,27.0,0,0,1,0,1,Algeria
Ramón Bóveda,0,80.0,0,0,1,0,1,Argentina
Ramón Calderé,2,164.0,0,0,0,3,3,Algeria
Ramón Castro,3,172.0,0,0,0,4,4,Ecuador
Ramón Colmán,1,81.0,0,0,0,1,1,Venezuela
Ramón Díaz,1,89.0,0,0,1,0,1,Argentina
Ramón Grosso,0,63.0,0,0,1,0,1,Spain
Ramón Heredia,1,60.0,0,0,0,1,1,Poland
Ramón Hicks,0,15.0,0,0,1,0,1,Paraguay
Ramón Iriarte,0,14.0,0,0,1,0,1,Venezuela
Ramón Mariano,0,50.0,0,0,1,0,1,Dominican Republic
Ramón Medina Bello,0,217.0,0,0,1,3,4,Paraguay
Ramón Morales,2,62.0,0,0,0,3,3,Argentina
Ramón Núñez,0,168.0,0,0,1,2,3,Canada
Ramón Quevedo,0,29.0,0,0,1,0,1,Bolivia
Ramón Ramírez,4,531.0,0,0,7,4,11,Mexico
Ramón Santos,2,91.0,0,0,2,0,2,Bolivia
Ramón Sánchez,1,38.0,0,0,1,0,1,El Salvador
Ramón Víctor Castro,1,73.0,0,0,0,1,1,Bolivia
Ramūnas Stonkus,0,47.0,0,0,1,0,1,Lithuania
Randal Kolo Muani,1,79.0,0,0,1,0,1,France
Randall Azofeifa,0,160.0,0,0,1,1,2,Costa Rica
Randall Brenes,3,368.0,0,1,5,1,6,Costa Rica
Randolph Burton,0,262.0,0,0,2,2,4,United States Virgin Islands
Randolph Peltier,0,80.0,0,0,1,0,1,Dominica
Rangelo Janga,0,87.0,0,0,0,1,1,Panama
Rangsan Viwatchaichok,1,15.0,1,0,1,0,1,Oman
Ranjae Christian,0,18.0,0,0,0,1,1,United States Virgin Islands
Raouf Bouzaiene,1,17.0,0,0,1,0,1,Tunisia
Raoul Lambert,2,709.0,0,5,11,2,13,Belgium
Raphael Chukwu,0,45.0,0,0,1,0,1,Nigeria
Raphael Lea'i,4,233.0,0,0,4,0,4,Solomon Islands
Raphael Rohrer,0,69.0,0,0,0,1,1,Iceland
Raphaël Guerreiro,1,178.0,1,0,2,1,3,Hungary
Raphaël Mirval,1,45.0,0,0,0,1,1,Costa Rica
Raphaël Varane,1,102.0,0,0,1,2,3,Uruguay
Raphaël Wicky,0,25.0,0,0,0,1,1,Faroe Islands
Raphel Ortiz,0,19.0,0,0,1,1,2,Aruba
Raphinha,0,104.0,0,0,3,0,3,Brazil
Rashad Sadygov,0,348.0,3,0,6,0,6,Azerbaijan
Rasheed Yekini,0,176.0,0,0,2,1,3,Nigeria
Rashid Abdulrahman,0,24.0,0,0,1,0,1,United Arab Emirates
Rashid Al-Wahaibi,2,116.0,0,0,0,2,2,Taiwan
Rashid Juma Al-Farsi,0,90.0,1,0,1,0,1,Thailand
Rashid Mohammed Rashid,0,90.0,0,0,1,0,1,Libya
Rashida Williams,0,43.0,0,0,0,1,1,Dominica
Rashidi Yekini,14,781.0,0,1,15,6,21,Kenya
Rasmus Elm,0,127.0,0,0,1,1,2,Sweden
Rateb Al-Awadat,0,85.0,0,0,1,0,1,Jordan
Rateb Al-Dawud,0,139.0,0,0,1,1,2,Jordan
Rathnayake Mudyanselage,0,57.0,0,0,1,0,1,Sri Lanka
Ratu Jone,0,200.0,0,0,2,1,3,Fiji
Rauf Aliyev,0,144.0,0,0,2,1,3,Azerbaijan
Raul Meireles,2,231.0,0,0,3,2,5,Portugal
Raul Rusescu,0,45.0,0,0,1,0,1,Romania
Rauno Sappinen,1,12.0,0,0,1,0,1,Estonia
Ravel Morrison,0,45.0,0,0,1,0,1,Jamaica
Ravshan Bazarav,0,90.0,0,0,1,0,1,Uzbekistan
Ravshan Bozorov,0,101.0,0,0,1,2,3,Cambodia
Ravuame Madigi,0,66.0,0,0,1,0,1,Fiji
Ray Baartz,1,272.0,0,0,2,3,5,Japan
Ray Daniel,0,21.0,1,0,1,0,1,Czechoslovakia
Ray Houghton,2,229.0,0,0,3,3,6,England
Ray Kennedy,0,96.0,0,0,1,1,2,England
Ray Pointer,0,46.0,0,0,2,0,2,England
Ray Richards,0,121.0,0,0,2,0,2,Australia
Ray Treacy,0,168.0,0,0,2,1,3,Czechoslovakia
Ray Wilkins,1,26.0,0,0,0,1,1,Belgium
Raydell Schuurman,1,88.0,0,0,0,1,1,Montserrat
Rayed Al-Boloushi,1,65.0,0,0,0,1,1,Vietnam
Raymond Braine,0,55.0,0,0,0,1,1,Luxembourg
Raymond Cicci,0,41.0,0,0,0,1,1,Luxembourg
Raymond Davelaar,0,98.0,0,1,1,1,2,Dominican Republic
Raymond Gunemba,0,382.0,0,0,6,1,7,Papua New Guinea
Raymond Kalla,1,29.0,0,0,1,0,1,Cameroon
Raymond Kopa,4,323.0,0,3,5,2,7,Luxembourg
Raymond Valette,0,90.0,0,0,0,1,1,New Zealand
Raymond Xuereb,0,84.0,0,0,1,0,1,Malta
Razak Omotoyossi,2,597.0,0,2,6,7,13,Ivory Coast
Razali Saad,0,214.0,0,0,3,0,3,Singapore
Razimie Ramlli,0,39.0,0,0,2,0,2,Brunei
Razmik Grigoryan,0,84.0,0,0,1,1,2,Armenia
Razundara Tjikuzu,0,150.0,0,0,4,0,4,Namibia
Razzaq Farhan,4,116.0,0,0,2,2,4,Palestine
Raí,1,126.0,0,2,2,2,4,Venezuela
Raúl,6,1496.0,0,0,18,14,32,Spain
Raúl Alvarez,0,139.0,0,0,2,0,2,Bolivia
Raúl Armando Savoy,4,210.0,0,0,4,0,4,Argentina
Raúl Avilés,0,166.0,0,0,1,1,2,Paraguay
Raúl Belén,0,150.0,0,0,3,0,3,Argentina
Raúl Bernao,2,197.0,0,0,3,1,4,Argentina
Raúl Cárdenas,1,77.0,1,0,2,0,2,France
Raúl Díaz Arce,2,1046.0,0,2,14,6,20,El Salvador
Raúl Echeverría,2,191.0,0,0,2,1,3,Uruguay
Raúl Fernández,1,57.0,0,0,1,0,1,Bolivia
Raúl Jiménez,9,1041.0,0,6,12,5,17,Mexico
Raúl Justiniano,0,38.0,0,0,1,0,1,Bolivia
Raúl Leguías,0,174.0,0,0,1,4,5,Dominica
Raúl Morales,0,30.0,0,0,1,0,1,Bolivia
Raúl Muñoz,1,3.0,0,0,1,0,1,Chile
Raúl Noriega,0,104.0,0,0,2,0,2,Ecuador
Raúl Núñez Velloso,1,78.0,0,0,0,1,1,Chile
Raúl Palacios,1,81.0,0,0,1,0,1,Chile
Raúl Pérez,0,20.0,0,0,1,0,1,Chile
Raúl Ruidíaz,1,165.0,0,0,1,1,2,Peru
Raúl Sarro,1,38.0,0,0,0,2,2,Chile
Raúl Schiaffino,1,57.0,0,0,0,1,1,Paraguay
Raúl Servín,0,61.0,0,0,1,0,1,Mexico
Raúl Tamudo,0,14.0,0,0,0,1,1,Denmark
Raúl Toro Julio,7,327.0,0,0,6,3,9,Argentina
Raşit Çetiner,0,73.0,1,0,1,0,1,Albania
Recep Adanır,0,31.0,0,0,0,1,1,Spain
Recep Çetin,0,39.0,0,0,1,0,1,Turkey
Reda Al-Senussi,0,33.0,0,0,1,0,1,Libya
Redha Abujabarah,0,90.0,0,0,1,0,1,Kuwait
Redha Tukar,0,188.0,0,0,3,0,3,Saudi Arabia
Redjep Agabaev,0,39.0,0,0,1,0,1,Turkmenistan
Redouane Guezzar,1,87.0,0,0,1,0,1,Morocco
Redwan Abrash,2,170.0,0,0,0,2,2,Maldives
Reece Styche,0,147.0,0,1,1,2,3,Gibraltar
Reg Ryan,0,106.0,0,2,2,0,2,Republic of Ireland
Reginal Garo,0,27.0,0,0,0,1,1,Papua New Guinea
Reginald Davani,6,237.0,0,0,1,6,7,Papua New Guinea
Reid Klopp,0,147.0,0,0,1,1,2,United States Virgin Islands
Reidar Kvammen,2,143.0,0,0,2,2,4,Norway
Reinaldo Gomes,0,42.0,0,0,1,0,1,Portugal
Reinaldo Navia,1,256.0,0,1,1,3,4,Peru
Reinhard Häfner,0,177.0,0,0,0,3,3,Belgium
Reinhard Libuda,1,99.0,0,0,1,1,2,Germany
Reinhold Hintermaier,1,68.0,0,0,1,0,1,Austria
Rejepmyrat Agabaýew,1,262.0,0,0,4,0,4,Turkmenistan
Remo Eyoma,0,34.0,0,0,1,0,1,Equatorial Guinea
Remo Freuler,1,157.0,0,0,2,1,3,Switzerland
Renan Bardini Bressan,0,6.0,0,0,1,0,1,Belarus
Renato Augusto,3,357.0,0,0,5,1,6,Brazil
Renato Gaúcho,1,41.0,0,0,2,0,2,Brazil
Renato Sanches,1,35.0,0,0,1,1,2,Poland
Renato Steffen,0,42.0,0,0,0,1,1,Lithuania
Renato Tapia,1,185.0,1,0,4,0,4,Peru
Renato Zaccarelli,1,125.0,0,0,1,1,2,Italy
Rene Krhin,0,163.0,0,0,0,2,2,Iceland
Rene N'Djeya,1,32.0,0,0,1,0,1,Cameroon
Renedy Singh,0,68.0,0,0,2,0,2,India
Renne Regis,0,46.0,0,0,1,0,1,Saint Lucia
Renny Ribera,1,40.0,0,0,1,0,1,Bolivia
Renson Haynes,0,58.0,0,0,0,2,2,Nicaragua
Rensy Barradas,0,76.0,0,0,0,1,1,Saint Lucia
Renán Bengoche,0,89.0,0,0,0,1,1,Saint Vincent and the Grenadines
Renán López,0,16.0,0,0,1,0,1,Bolivia
René Aufhauser,0,295.0,0,0,5,0,5,Austria
René Bader,1,10.0,0,0,0,1,1,Mexico
René Borjas,1,44.0,0,0,0,2,2,Chile
René Dereuddre,0,36.0,0,0,1,0,1,France
René Girard,1,13.0,0,0,0,1,1,Poland
René Higuita,2,121.0,1,1,1,1,2,Venezuela
René Houseman,3,125.0,0,0,4,0,4,Argentina
René Maillard,0,21.0,0,0,1,1,2,Switzerland
René Meléndez,2,188.0,0,0,3,2,5,Bolivia
René Nsi-Akoue,0,25.0,1,0,1,0,1,Angola
René Peters,1,52.0,0,0,1,1,2,Serbia
René Pontoni,8,225.0,0,0,8,0,8,Argentina
René Vandereycken,1,96.0,0,2,2,0,2,Belgium
René van de Kerkhof,1,212.0,0,0,2,2,4,Netherlands
René-Pierre Quentin,1,259.0,0,0,6,3,9,Switzerland
Renārs Rode,0,90.0,0,0,1,0,1,Latvia
Reon Moore,1,12.0,0,0,0,1,1,Guatemala
Reung Bunheing,1,89.0,0,0,0,1,1,Pakistan
Reuven Atar,0,90.0,0,0,0,1,1,France
Reuven Young,0,38.0,0,0,1,0,1,Israel
Rey Manaj,0,240.0,0,0,2,2,4,Moldova
Reynald Pedros,0,49.0,0,0,1,0,1,France
Reynald Temarii,1,8.0,0,1,1,0,1,Tahiti
Reynaldo Clavasquín,1,32.0,0,0,1,0,1,Honduras
Reynaldo Mejia,0,73.0,0,0,1,0,1,Honduras
Reynaldo Parks,1,58.0,0,0,1,0,1,Costa Rica
Reynier Alcántara,2,97.0,0,0,0,2,2,Mexico
Reynold Carrington,0,30.0,0,0,1,0,1,Trinidad and Tobago
Reynold Saint Surin,0,90.0,0,0,1,0,1,Haiti
Reza Enayati,1,139.0,0,0,1,2,3,Laos
Reza Ghoochannejhad,3,553.0,0,0,4,3,7,Qatar
Reza Hassanzadeh,1,45.0,0,0,0,1,1,Japan
Reza Shahroudi,1,134.0,0,0,2,1,3,Maldives
Rezaul Karim,0,56.0,0,0,1,0,1,Bangladesh
Rhyan Grant,0,43.0,0,0,0,1,1,Vietnam
Rhys Browne,0,20.0,0,0,1,0,1,Antigua and Barbuda
Ri Han-jae,0,1.0,0,0,1,0,1,North Korea
Ri Hyok-chol,0,146.0,0,0,2,2,4,North Korea
Ri Hyok-chon,0,102.0,0,0,2,0,2,North Korea
Riadh Bouazizi,1,53.0,0,0,1,0,1,Tunisia
Riadh Jelassi,1,177.0,0,0,1,1,2,Liberia
Ricard Fernández,0,89.0,0,0,0,1,1,San Marino
Ricardo Adé,1,111.0,0,0,1,1,2,Haiti
Ricardo Alcón,3,122.0,0,0,3,1,4,Bolivia
Ricardo Altamirano,1,67.0,0,0,1,0,1,Argentina
Ricardo Aquino,1,88.0,0,0,0,1,1,Chile
Ricardo Bonelli,1,11.0,0,0,1,0,1,Argentina
Ricardo Buitrago,0,82.0,0,0,1,1,2,Dominica
Ricardo Cabanas,0,71.0,0,0,1,0,1,Switzerland
Ricardo Carvalho,0,151.0,1,0,3,1,4,Portugal
Ricardo Clark,1,97.0,0,0,1,1,2,United States
Ricardo Costa,0,28.0,0,0,1,0,1,Portugal
Ricardo Díaz,0,89.0,0,0,1,0,1,Colombia
Ricardo Francisco Rojas,0,64.0,0,0,0,1,1,Colombia
Ricardo Fuller,1,127.0,0,0,1,2,3,Guatemala
Ricardo Gardner,0,73.0,0,0,2,0,2,Jamaica
Ricardo Gareca,0,136.0,0,0,2,0,2,Argentina
Ricardo Gomes,0,135.0,0,0,3,0,3,Brazil
Ricardo González,0,15.0,1,0,1,0,1,Argentina
Ricardo Horta,1,5.0,0,0,0,1,1,South Korea
Ricardo Hyde,0,57.0,0,0,1,0,1,Jamaica
Ricardo José Maria Ramaciotti,0,75.0,0,0,0,1,1,Ecuador
Ricardo Mannetti,1,70.0,0,0,0,1,1,Ivory Coast
Ricardo Oliveira,1,239.0,0,0,1,2,3,Mexico
Ricardo Osorio,1,97.0,1,0,2,0,2,Mexico
Ricardo Pavoni,1,87.0,0,0,0,1,1,Bulgaria
Ricardo Peláez,4,351.0,0,0,2,4,6,Mexico
Ricardo Pepi,0,186.0,0,0,2,1,3,Honduras
Ricardo Phillips,2,123.0,0,0,1,2,3,Panama
Ricardo Páez,0,111.0,0,0,1,1,2,Chile
Ricardo Quaresma,4,354.0,0,0,2,3,5,Portugal
Ricardo Rivera,1,140.0,0,1,3,1,4,Puerto Rico
Ricardo Rodríguez,0,228.0,0,2,1,3,4,Hungary
Ricardo Sá Pinto,1,396.0,0,0,4,4,8,Denmark
Riccardo Carapellese,2,19.0,0,0,2,0,2,Italy
Riccardo Ferri,0,12.0,0,0,0,1,1,Malta
Riccardo Montolivo,0,34.0,0,0,1,0,1,Italy
Riccardo Orsolini,0,78.0,0,0,1,0,1,Italy
Richard Aquilina,0,33.0,0,0,1,0,1,Malta
Richard Báez,0,5.0,0,0,0,1,1,Ecuador
Richard Daddy Owubokiri,0,34.0,0,0,1,0,1,Nigeria
Richard Daniel,0,15.0,0,0,1,0,1,Papua New Guinea
Richard Dunne,0,187.0,0,0,3,3,6,Republic of Ireland
Richard Dürr,0,56.0,0,1,1,0,1,Switzerland
Richard Gough,0,175.0,0,0,1,2,3,Cyprus
Richard Hastings,1,92.0,0,0,0,1,1,Mexico
Richard Herrmann,1,84.0,0,0,1,0,1,Germany
Richard Iwai,9,414.0,0,0,2,7,9,New Zealand
Richard José Blanco,0,55.0,0,0,0,1,1,Bolivia
Richard Kreß,0,29.0,0,0,1,0,1,Germany
Richard Kuremaa,0,117.0,0,0,0,2,2,Sweden
Richard Mbulu,1,10.0,0,0,1,0,1,Malawi
Richard Morales,2,238.0,0,0,2,2,4,Mexico
Richard O'Connor,0,40.0,0,1,0,1,1,Bahamas
Richard Odada,0,15.0,0,1,1,0,1,Kenya
Richard Orlans,0,61.0,0,0,2,0,2,Belgium
Richard Ortiz,0,260.0,0,0,2,1,3,Paraguay
Richard Pacquette,0,21.0,0,0,1,0,1,Dominica
Richard Rodríguez,0,25.0,0,0,1,0,1,Nicaragua
Richard Sele,0,73.0,0,0,1,0,1,New Caledonia
Richard Smith,0,142.0,0,0,3,0,3,Costa Rica
Richard Socrier,1,20.0,0,0,0,1,1,Honduras
Richard Sánchez,1,37.0,0,0,0,1,1,Argentina
Richard Witschge,0,20.0,0,0,1,0,1,Netherlands
Richard Zambrano,2,110.0,0,0,0,2,2,Brazil
Richardo Nabuth,0,18.0,0,0,1,0,1,Mauritius
Richardson Smith,0,208.0,1,1,2,2,4,Costa Rica
Richarlison,3,743.0,0,1,7,4,11,Brazil
Richie Laryea,1,53.0,0,0,1,0,1,Canada
Richmond Boakye,1,215.0,0,0,1,3,4,Congo
Richárd Guzmics,0,133.0,0,0,0,2,2,Northern Ireland
Ricki Herbert,0,130.0,0,0,2,0,2,New Zealand
Rickie Lambert,0,26.0,0,0,1,0,1,England
Ricky Charles,0,384.0,0,0,6,2,8,Guyana
Ricky Phuka,0,44.0,0,0,0,1,1,Mauritius
Ricky Shakes,0,168.0,0,0,1,2,3,Bermuda
Ridle Baku,0,80.0,0,0,1,0,1,Germany
Rifaat Turk,0,137.0,0,0,3,0,3,Israel
Rifat Zhemaletdinov,0,55.0,0,0,0,1,1,Cyprus
Rigobert Song,0,72.0,0,0,2,1,3,Cameroon
Rigoberto Gómez,1,82.0,0,0,2,0,2,Honduras
Rigoberto Rojas,0,28.0,0,0,1,0,1,Costa Rica
Rihairo Meulens,0,9.0,0,0,0,1,1,Antigua and Barbuda
Rija Rakotomandimby,0,127.0,0,0,1,1,2,Madagascar
Riki van Steeden,0,85.0,0,0,1,0,1,New Zealand
Riku Riski,0,131.0,0,0,0,2,2,Faroe Islands
Rildo da Costa Menezes,1,73.0,0,0,1,0,1,Brazil
Riley McGree,0,76.0,0,0,1,0,1,Australia
Rinaldo Martino,4,232.0,0,0,5,0,5,Argentina
Rinat Abdulin,0,27.0,0,0,1,1,2,Kazakhstan
Rino Moretta,1,80.0,0,0,1,0,1,Tahiti
Rinus Israël,0,208.0,0,1,2,1,3,Denmark
Rio Ferdinand,1,141.0,0,0,2,1,3,Denmark
Risdianto,1,44.0,0,0,0,1,1,Thailand
Risto Božinov,0,67.0,0,0,2,0,2,North Macedonia
Risto Radunović,0,90.0,0,0,0,1,1,Turkey
Ritsu Dōan,4,251.0,0,1,2,2,4,Japan
Rivaldo,12,1043.0,0,3,17,4,21,Brazil
Rivaldo Vítor Borba Ferreira,1,42.0,0,0,0,1,1,Mexico
Rivellino,6,368.0,0,0,5,2,7,Brazil
Riyad Mahrez,6,534.0,0,1,10,2,12,Senegal
Riyadh Nouri,1,161.0,0,0,1,1,2,Australia
Rizvi Karim Rumi,2,80.0,0,0,1,1,2,Sri Lanka
Ro Hak-su,0,34.0,0,0,1,0,1,North Korea
Roald Jensen,0,59.0,0,0,0,1,1,Turkey
Rob Rensenbrink,6,565.0,0,5,6,5,11,German DR
Rob Witschge,1,109.0,0,0,3,0,3,Netherlands
Rob de Wit,0,141.0,0,0,1,1,2,Hungary
Robbie Brady,1,259.0,0,1,1,3,4,Bosnia and Herzegovina
Robbie Dunn,0,91.0,0,1,2,0,2,Australia
Robbie Earle,1,45.0,0,0,1,0,1,Jamaica
Robbie Fowler,0,88.0,0,0,1,0,1,England
Robbie Hooker,0,11.0,0,0,1,0,1,Australia
Robbie James,0,159.0,0,0,2,1,3,Wales
Robbie Keane,5,1935.0,0,10,28,16,44,Republic of Ireland
Robbie Kruse,2,229.0,0,0,2,2,4,Uzbekistan
Robbie Rogers,0,60.0,0,0,1,0,1,United States
Robbie Savage,0,30.0,0,0,0,2,2,Turkey
Robbie Slater,0,15.0,0,0,1,0,1,Australia
Robby Darwis,1,77.0,1,0,1,0,1,North Korea
Robby Langers,0,365.0,0,0,5,1,6,German DR
Robert Arboleda,0,7.0,0,0,1,0,1,Ecuador
Robert Arzumanyan,0,172.0,0,0,3,1,4,Kazakhstan
Robert Ballaman,0,254.0,0,0,8,0,8,Switzerland
Robert Berić,0,63.0,0,0,1,0,1,Slovenia
Robert Cavallo,1,21.0,1,0,1,0,1,Peru
Robert Clarke,1,25.0,0,0,1,0,1,Liberia
Robert Dienst,0,106.0,0,0,1,1,2,Austria
Robert Earnshaw,0,272.0,0,0,4,1,5,Wales
Robert Edmond,0,28.0,0,0,1,0,1,Madagascar
Robert Gadocha,0,209.0,0,0,7,0,7,Poland
Robert Herbin,0,175.0,0,0,2,1,3,France
Robert Hosp,0,10.0,0,0,1,0,1,Switzerland
Robert Huth,0,79.0,0,0,1,0,1,Germany
Robert Ironside,0,64.0,0,0,1,0,1,New Zealand
Robert Jama Mba,0,42.0,0,0,2,0,2,Cameroon
Robert Jarni,1,129.0,0,0,0,2,2,Denmark
Robert Jashari,0,49.0,0,0,0,1,1,Northern Ireland
Robert Kaumé,1,72.0,0,0,1,0,1,New Caledonia
Robert Kizito,0,3.0,0,0,0,1,1,Angola
Robert Koren,1,216.0,0,0,3,1,4,Slovenia
Robert Lewandowski,9,2838.0,0,11,29,27,56,San Marino
Robert Lüthi,0,75.0,0,0,0,1,1,Romania
Robert Morales,0,10.0,0,0,1,0,1,Paraguay
Robert Nauseb,1,33.0,0,0,0,1,1,Angola
Robert Ng'ambi,0,214.0,0,0,3,0,3,Malawi
Robert Pires,2,266.0,0,1,5,1,6,Russia
Robert Prosinečki,3,526.0,0,1,5,5,10,Yugoslavia
Robert Prytz,0,274.0,0,2,3,3,6,Sweden
Robert Sara,0,59.0,0,0,0,1,1,Italy
Robert Seni,2,389.0,0,0,4,2,6,Tahiti
Robert Skov,0,163.0,0,0,3,1,4,Gibraltar
Robert Snodgrass,0,297.0,0,1,1,5,6,Croatia
Robert St. Fort,0,110.0,0,2,2,0,2,Haiti
Robert Suzette,0,69.0,0,0,0,1,1,Zambia
Robert Tasso,3,216.0,0,0,2,1,3,Vanuatu
Robertas Fridrikas,0,133.0,0,0,1,1,2,Northern Ireland
Robertas Poškus,0,37.0,0,0,1,0,1,Lithuania
Roberto Acuña,1,147.0,0,1,1,2,3,Chile
Roberto Alvarado,1,40.0,0,0,1,0,1,Mexico
Roberto Ayala,2,228.0,3,0,2,4,6,Venezuela
Roberto Baggio,7,1018.0,0,4,9,8,17,Italy
Roberto Batata,0,139.0,0,0,3,0,3,Brazil
Roberto Bettega,1,662.0,0,0,6,7,13,Luxembourg
Roberto Boninsegna,2,147.0,0,0,2,4,6,Germany
Roberto Brown,0,315.0,0,1,5,2,7,Panama
Roberto Cabañas,3,256.0,0,0,6,0,6,Paraguay
Roberto Carlos,1,147.0,0,0,2,1,3,Brazil
Roberto Castillo,1,11.0,0,0,1,0,1,Peru
Roberto Challe,1,118.0,0,0,0,2,2,Bolivia
Roberto Chen,0,90.0,0,0,0,1,1,Honduras
Roberto Cherro,3,94.0,0,0,4,0,4,Argentina
Roberto Colautti,0,231.0,0,0,3,3,6,Estonia
Roberto Di Matteo,0,24.0,0,0,1,0,1,Italy
Roberto Dinamite,4,380.0,0,2,8,3,11,Brazil
Roberto Donadoni,0,24.0,0,0,4,0,4,Italy
Roberto Drago,5,292.0,0,0,0,5,5,Paraguay
Roberto Emílio da Cunha,3,137.0,0,0,3,0,3,Brazil
Roberto Fernández,0,90.0,0,0,1,0,1,Bolivia
Roberto Fernández Bonillo,0,30.0,0,0,0,1,1,Czechoslovakia
Roberto Figueroa,3,155.0,0,0,0,3,3,Bolivia
Roberto Firmino,2,527.0,0,0,9,0,9,Brazil
Roberto Gayón,1,75.0,0,0,0,1,1,Argentina
Roberto Guadalupe Martínez,0,14.0,0,0,1,0,1,El Salvador
Roberto Gámez,2,131.0,0,0,1,1,2,Colombia
Roberto Holsen,4,210.0,0,0,3,1,4,Peru
Roberto Jonas,1,42.0,0,0,1,0,1,Andorra
Roberto Juan Martínez,0,119.0,0,0,1,1,2,Spain
Roberto Kettlun,3,210.0,0,0,3,0,3,Palestine
Roberto Linares,0,133.0,0,0,3,1,4,Cuba
Roberto Luco,1,39.0,0,0,1,0,1,Chile
Roberto López Ufarte,0,65.0,0,1,1,0,1,Spain
Roberto Mancini,0,258.0,0,0,2,2,4,Germany
Roberto Mosquera,0,71.0,0,0,1,0,1,Peru
Roberto Nurse,0,55.0,0,0,0,1,1,United States
Roberto Orlando Affonso Júnior,0,83.0,0,0,1,0,1,Hong Kong
Roberto Osvaldo Díaz,0,71.0,0,0,1,0,1,Argentina
Roberto Palacios,4,837.0,0,0,8,6,14,Argentina
Roberto Perfumo,1,35.0,1,0,0,1,1,Argentina
Roberto Porta,6,582.0,0,0,5,7,12,Ecuador
Roberto Rivellino,0,85.0,0,0,1,0,1,Brazil
Roberto Soldado,1,118.0,0,0,1,1,2,Georgia
Roberto Troncoso,0,55.0,1,0,1,0,1,Uruguay
Roberto Zárate,3,203.0,0,0,5,0,5,Argentina
Roberts Savaļnieks,0,35.0,0,0,0,1,1,Turkey
Roberts Uldriķis,0,113.0,0,0,0,2,2,Turkey
Robin Betancourth,1,147.0,0,0,1,1,2,British Virgin Islands
Robin Gosens,0,60.0,0,0,1,0,1,Germany
Robin Lod,0,90.0,0,0,0,2,2,Iceland
Robin Ngalande,0,47.0,0,0,1,0,1,Malawi
Robin Quaison,0,469.0,0,0,4,4,8,Sweden
Robin Singh,0,10.0,0,0,1,0,1,India
Robin van Persie,8,1915.0,1,4,23,13,36,Finland
Robinho,12,764.0,0,2,10,8,18,Brazil
Robiul Hasan,0,72.0,0,0,0,1,1,Laos
Roby Young,1,70.0,0,0,0,1,1,Hong Kong
Rocky Putiray,0,126.0,0,0,3,0,3,Indonesia
Rocky Siberie,1,256.0,0,0,3,4,7,Curaçao
Roda Antar,2,612.0,0,0,8,4,12,Lebanon
Roderick Briffa,0,38.0,0,0,0,1,1,Czech Republic
Roderick Reid,2,110.0,0,0,2,1,3,Mexico
Rodger Gray,0,74.0,0,0,0,1,1,Vanuatu
Rodion Cămătaru,0,359.0,0,0,3,5,8,Romania
Rodney Jack,0,244.0,0,0,8,2,10,Saint Vincent and the Grenadines
Rodney Wallace,1,79.0,0,0,1,0,1,Costa Rica
Rodolfo Bodipo,0,83.0,0,1,0,1,1,Sierra Leone
Rodolfo Carvajal,0,70.0,0,0,1,0,1,Venezuela
Rodolfo Dubó,0,34.0,0,0,2,0,2,Chile
Rodolfo Herrera González,0,144.0,0,0,3,0,3,Costa Rica
Rodolfo Micheli,7,355.0,0,1,7,1,8,Argentina
Rodolfo Pizarro,1,4.0,0,0,1,0,1,Mexico
Rodolfo Zelaya,8,660.0,0,3,12,3,15,El Salvador
Rodolph Austin,1,172.0,0,1,3,0,3,Jamaica
Rodrigo,2,185.0,0,0,4,1,5,Spain
Rodrigo Barrera,0,23.0,0,0,1,0,1,Chile
Rodrigo Bentancur,0,1.0,0,0,1,0,1,Uruguay
Rodrigo Cordero,0,90.0,0,0,1,0,1,Costa Rica
Rodrigo De Paul,1,84.0,0,0,2,0,2,Argentina
Rodrigo Lemos,1,61.0,0,1,1,0,1,Uruguay
Rodrigo Meléndez,0,21.0,0,0,0,1,1,Uruguay
Rodrigo Millar,1,100.0,0,0,2,0,2,Chile
Rodrigo Palacio,0,137.0,0,0,2,0,2,Argentina
Rodrigo Ramallo,0,85.0,0,0,3,0,3,Bolivia
Rodrigo Tello,0,29.0,0,0,0,1,1,Argentina
Rodrygo,0,88.0,0,0,1,0,1,Brazil
Rogelio Delgado,0,46.0,0,0,1,0,1,Paraguay
Rogelio Farias,1,58.0,0,0,1,0,1,Chile
Rogelio Funes Mori,3,186.0,0,0,2,2,4,Guatemala
Roger Beck,0,20.0,0,0,0,1,1,North Macedonia
Roger Claessen,0,185.0,0,0,1,2,3,Switzerland
Roger Espinoza,1,25.0,0,0,1,0,1,Honduras
Roger Guerreiro,0,30.0,0,0,0,1,1,Austria
Roger Hunt,0,228.0,0,0,3,1,4,England
Roger Ljung,1,93.0,0,0,1,1,2,Sweden
Roger Lukaku,1,162.0,0,1,2,1,3,DR Congo
Roger Mandin,1,90.0,0,0,1,0,1,New Caledonia
Roger Marche,0,85.0,1,0,1,0,1,Greece
Roger Martínez,1,140.0,0,0,0,2,2,Argentina
Roger Milla,11,996.0,0,1,15,5,20,Congo
Roger Nilsen,0,113.0,0,0,2,0,2,Norway
Roger Piantoni,3,486.0,0,0,6,2,8,Luxembourg
Roger Proverbs,0,63.0,0,0,0,1,1,Dominica
Roger Rojas,0,88.0,0,0,1,0,1,Honduras
Roger Suárez,0,162.0,0,0,3,0,3,Bolivia
Roger Van Gool,0,56.0,0,0,2,0,2,Belgium
Roger Vonlanthen,0,92.0,0,0,1,1,2,Switzerland
Roguy Méyé,1,226.0,0,0,2,2,4,Gabon
Roh Sang-Rae,0,18.0,0,0,0,1,1,Thailand
Rohan Ince,1,60.0,0,0,1,0,1,Montserrat
Rohan Lennon,0,68.0,0,0,0,1,1,Bahamas
Rohann Simons,0,83.0,0,0,1,0,1,Bermuda
Roihau Degage,1,86.0,0,0,1,0,1,Tahiti
Rok Kronaveter,0,74.0,0,0,1,0,1,Slovenia
Rokonuzzaman Kanchan,1,85.0,0,0,0,1,1,Mongolia
Roland Alberg,1,74.0,0,0,0,1,1,Aruba
Roland Citherlet,0,28.0,0,0,1,0,1,Switzerland
Roland Ducke,0,26.0,0,0,0,1,1,Hungary
Roland Grip,0,49.0,0,0,0,1,1,Norway
Roland Hattenberger,1,82.0,0,0,1,1,2,Austria
Roland Juhász,0,184.0,0,0,2,1,3,Hungary
Roland Kirchler,0,53.0,0,0,1,0,1,Austria
Roland Kollmann,0,115.0,0,0,2,0,2,Austria
Roland Linz,0,231.0,0,0,1,2,3,Poland
Roland Sallai,0,101.0,0,1,1,2,3,Hungary
Roland Sandberg,2,371.0,0,0,4,4,8,Sweden
Roland Ugrai,0,89.0,0,0,0,1,1,Switzerland
Roland de Marigny,1,90.0,0,0,0,1,1,Fiji
Rolandas Baravykas,0,55.0,0,0,1,0,1,Lithuania
Rolando Blackburn,2,232.0,0,0,4,4,8,Panama
Rolando Fonseca,5,828.0,0,1,9,7,16,Costa Rica
Rolando Vargas,0,55.0,0,0,0,1,1,Argentina
Rolf Blättler,0,207.0,0,0,6,0,6,Switzerland
Rolf Feltscher,0,54.0,1,0,1,0,1,Argentina
Rolf Wüthrich,0,74.0,0,0,1,1,2,Switzerland
Rolf-Christel Guié-Mien,0,67.0,0,0,0,1,1,Sierra Leone
Roly Paniagua,0,85.0,0,0,1,0,1,Bolivia
Romain Michaux,0,73.0,0,0,1,0,1,Luxembourg
Romain Saïss,2,94.0,0,0,1,1,2,Morocco
Romain Schreiner,0,55.0,0,0,1,0,1,Luxembourg
Romaine Sawyers,0,138.0,0,0,2,0,2,Saint Kitts and Nevis
Roman Bezjak,0,190.0,0,0,3,0,3,Slovenia
Roman Bezus,0,218.0,0,0,1,2,3,Montenegro
Roman Eremenko,0,156.0,0,1,0,2,2,Georgia
Roman Hubník,0,69.0,0,0,1,0,1,Czech Republic
Roman Kosecki,0,292.0,0,0,3,1,4,Poland
Roman Lentner,0,52.0,0,0,1,0,1,Poland
Roman Ogaza,0,185.0,0,1,3,0,3,Poland
Roman Pavlyuchenko,4,872.0,0,5,13,3,16,Russia
Roman Shirokov,1,252.0,0,2,3,2,5,Republic of Ireland
Roman Szewczyk,0,32.0,0,0,1,0,1,Poland
Roman Týce,0,40.0,0,0,0,1,1,Denmark
Roman Uzdenov,0,44.0,0,0,1,0,1,Kazakhstan
Roman Wallner,0,142.0,0,1,2,0,2,Austria
Roman Wójcicki,0,142.0,1,0,0,2,2,Poland
Roman Yaremchuk,1,320.0,0,0,5,5,10,Ukraine
Roman Zozulya,0,107.0,0,0,1,1,2,Poland
Romar Frank,1,76.0,0,0,0,1,1,Panama
Romaric,1,93.0,0,0,1,2,3,Ivory Coast
Romario Ibarra,0,83.0,0,0,1,1,2,Chile
Romario Williams,2,108.0,0,0,1,1,2,Curaçao
Romell Quioto,3,458.0,0,0,6,4,10,Honduras
Romelu Lukaku,9,1936.0,0,3,23,13,36,Croatia
Romeo Benetti,2,208.0,0,0,1,2,3,Italy
Romeo Castelen,0,3.0,0,0,1,0,1,Netherlands
Romeo Kambou,0,117.0,0,0,2,0,2,Burkina Faso
Romeu Evangelista,0,2.0,0,0,0,1,1,Venezuela
Romeu Pellicciari,3,156.0,0,0,3,0,3,Brazil
Romik Khachatryan,0,73.0,0,0,1,0,1,Armenia
Romulo Gómez,1,100.0,2,0,1,2,3,Ecuador
Román Torres,2,341.0,1,0,6,0,6,Nicaragua
Romário,17,1850.0,0,4,23,10,33,Brazil
Ron Davies,1,213.0,0,1,2,2,4,Russia
Ron Flowers,2,217.0,0,3,2,2,4,Portugal
Ronald Cerritos,2,344.0,0,0,4,2,6,Trinidad and Tobago
Ronald García Nacho,0,106.0,0,0,2,0,2,Bolivia
Ronald Hernández,1,90.0,0,0,1,0,1,Venezuela
Ronald Koeman,2,471.0,0,4,4,4,8,Netherlands
Ronald Kreer,0,115.0,0,0,2,0,2,German DR
Ronald Leaky,0,21.0,0,0,1,0,1,Honduras
Ronald Raldes,1,89.0,1,0,1,1,2,Ecuador
Ronald Rivero,0,33.0,1,0,0,1,1,Bolivia
Ronald Spelbos,0,40.0,0,0,1,0,1,Netherlands
Ronald Vargas,0,121.0,0,0,1,1,2,Uruguay
Ronald Worm,0,32.0,0,0,2,0,2,Germany
Ronald de Boer,3,669.0,0,1,6,5,11,Netherlands
Ronaldinho,11,799.0,0,5,13,4,17,Brazil
Ronaldo,28,1800.0,0,5,29,10,39,Brazil
Ronaldo Rodrigues de Jesus,1,73.0,0,0,1,0,1,Brazil
Ronan Carolino Falcão,0,47.0,0,0,1,0,1,Equatorial Guinea
Ronen Harazi,1,474.0,0,0,7,3,10,Bulgaria
Rong Zhixing,2,90.0,0,0,3,0,3,China PR
Roni Porokara,0,78.0,0,0,2,0,2,Finland
Ronnie Allen,0,68.0,0,0,0,1,1,Scotland
Ronnie McKinnon,0,117.0,1,0,2,0,2,Scotland
Ronnie Rees,0,93.0,0,0,2,0,2,Wales
Ronnie Whelan,1,144.0,0,0,2,1,3,Luxembourg
Ronny Johnsen,0,106.0,0,0,1,1,2,Poland
Ronny Pattinasarany,0,4.0,0,0,0,1,1,Singapore
Ronny Rosenthal,1,246.0,0,0,3,4,7,Israel
Ronny Wabia,2,165.0,0,0,3,1,4,Indonesia
Rony Martínez,1,4.0,0,0,0,1,1,Haiti
Rony Morales,0,54.0,0,0,0,1,1,Trinidad and Tobago
Roody Lormera,1,10.0,0,1,0,1,1,Turks and Caicos Islands
Roosevelt Desir,0,69.0,0,0,0,1,1,Dominica
Roque Júnior,0,90.0,0,0,1,0,1,Brazil
Roque Santa Cruz,5,1071.0,0,0,17,4,21,Paraguay
Rory Fallon,2,188.0,0,0,3,1,4,New Zealand
Rosdee Sulong,0,16.0,0,0,1,0,1,Malaysia
Rosdi Talib,1,48.0,0,0,1,1,2,Qatar
Rosemond Pierre,1,84.0,0,0,0,1,1,Cuba
Roshan Pereta,2,135.0,0,0,0,2,2,Philippines
Ross Barkley,0,225.0,0,0,0,6,6,San Marino
Ross McCormack,0,39.0,0,0,1,0,1,Scotland
Rostislav Vojáček,0,34.0,0,0,1,0,1,Czechoslovakia
Rotson Kilambe,1,136.0,0,0,1,2,3,Zambia
Roudolphe Douala,0,20.0,0,0,1,0,1,Cameroon
Rouzbeh Cheshmi,1,90.0,0,0,0,1,1,Wales
Rowan Liburd,0,53.0,0,1,0,1,1,Bahamas
Roxey Fer,0,3.0,0,0,1,0,1,Suriname
Roy Bentley,0,64.0,0,0,0,1,1,Scotland
Roy Chipolina,1,84.0,1,0,1,1,2,Gibraltar
Roy Contout,1,69.0,0,0,1,0,1,French Guiana
Roy Karang,0,89.0,0,0,1,0,1,Papua New Guinea
Roy Kayara,4,161.0,0,0,4,2,6,Vanuatu
Roy Keane,0,456.0,0,0,4,5,9,Northern Ireland
Roy Krishna,3,406.0,0,2,4,2,6,Fiji
Roy Lassiter,0,184.0,0,0,1,2,3,United States
Roy Makaay,1,114.0,0,0,1,1,2,Austria
Roy Miller,1,58.0,0,0,2,0,2,Costa Rica
Roy Myers,3,154.0,0,0,1,2,3,Canada
Roy Myrie,0,264.0,0,0,1,3,4,Costa Rica
Roy Sáenz,0,89.0,0,0,1,0,1,Costa Rica
Roy Vanenburg,0,180.0,0,0,2,0,2,Suriname
Roy Vernon,0,250.0,0,0,5,0,5,Wales
Roy Wegerle,0,226.0,0,0,1,2,3,Canada
Ruben Mendoza,0,73.0,0,0,1,1,2,Haiti
Ruben Schaken,0,134.0,0,0,2,0,2,Netherlands
Ruben Vargas,0,107.0,0,0,1,1,2,Gibraltar
Ruberth Morán,1,633.0,0,0,9,2,11,Venezuela
Rubilio Castillo,1,155.0,0,0,1,1,2,Jamaica
Rubin Okotie,0,97.0,0,0,2,0,2,Austria
Rubén Aveiro,2,161.0,0,0,0,2,2,Argentina
Rubén Ayala,1,318.0,0,1,5,1,6,Argentina
Rubén Baraja,0,135.0,0,0,2,1,3,Austria
Rubén Cano,0,219.0,0,0,2,1,3,Spain
Rubén Darío Bustos,0,144.0,0,0,2,0,2,Colombia
Rubén Darío Hernández,0,67.0,0,0,1,0,1,Colombia
Rubén Espinoza,0,51.0,0,0,1,0,1,Chile
Rubén Fernández,3,206.0,0,0,0,4,4,Chile
Rubén Guevara,0,112.0,0,0,1,1,2,Belize
Rubén Héctor Sosa,0,391.0,0,0,5,2,7,Argentina
Rubén Jiménez,0,140.0,0,0,2,2,4,Guatemala
Rubén Jiménez Rodríguez,0,29.0,0,0,1,1,2,Guatemala
Rubén Marcos,5,250.0,0,1,6,1,7,Chile
Rubén Paz,1,192.0,0,0,2,1,3,Uruguay
Rubén Sosa,4,499.0,0,0,5,6,11,Uruguay
Rubén Toribio Díaz,1,83.0,0,0,0,1,1,Italy
Rubén de la Red,1,61.0,0,0,0,1,1,Greece
Rubén Óscar Valdez,0,126.0,0,0,0,2,2,Greece
Rudel Calero,0,79.0,0,0,1,0,1,Nicaragua
Rudi Elsener,0,75.0,0,0,1,0,1,Switzerland
Rudi Flögel,0,102.0,0,0,1,1,2,Republic of Ireland
Rudi Istenič,0,15.0,1,0,1,0,1,Norway
Rudi Smidts,0,27.0,0,0,1,0,1,Belgium
Rudi Vata,0,158.0,0,0,0,2,2,Moldova
Rudi Völler,10,1060.0,0,0,17,9,26,Albania
Rudinilson Silva,1,12.0,1,0,0,1,1,Guinea-Bissau
Rudis Corrales,1,374.0,0,0,7,1,8,El Salvador
Rudolf Belin,0,2.0,0,0,1,0,1,Yugoslavia
Rudolf Bester,0,138.0,0,0,2,2,4,Namibia
Rudolf Brunnenmeier,0,194.0,0,0,1,2,3,Germany
Rudolf Kučera,0,90.0,0,0,0,1,1,German DR
Rudolf Noack,1,62.0,0,0,0,1,1,Czechoslovakia
Rudolf Pichler,0,65.0,0,0,0,1,1,France
Rudolf Viertl,0,62.0,0,0,1,0,1,Austria
Rudolph Smith,0,8.0,1,0,0,1,1,Bermuda
Rudy Barrientos,0,12.0,0,0,1,0,1,Guatemala
Rudy Bhebey,0,76.0,0,0,0,2,2,Liberia
Rudy Cardozo,0,66.0,0,0,1,1,2,Uruguay
Rudy Gestede,0,57.0,0,0,1,1,2,Algeria
Rudy Ramírez,1,98.0,0,0,0,2,2,Trinidad and Tobago
Rufat Dadashov,0,58.0,0,0,1,0,1,Azerbaijan
Rufino Gama,0,72.0,0,0,0,1,1,Malaysia
Ruggiero Rizzitelli,0,83.0,0,0,1,0,1,Italy
Rui Barros,1,147.0,0,0,2,1,3,Luxembourg
Rui Campos,1,20.0,0,0,1,0,1,Brazil
Rui Costa,1,1002.0,0,4,8,9,17,Portugal
Rui Jordão,0,479.0,0,1,7,4,11,Portugal
Rui Jorge,1,45.0,0,0,0,1,1,Andorra
Rui Rodrigues,0,89.0,0,0,2,1,3,Portugal
Rui da Gracia,0,14.0,0,0,1,0,1,Equatorial Guinea
Rui Águas,2,468.0,0,0,3,6,9,Switzerland
Rumen Hristov,0,78.0,0,0,1,0,1,Bulgaria
Rune Bratseth,0,119.0,0,0,2,0,2,Norway
Rune Börjesson,0,142.0,0,0,3,0,3,Sweden
Rune Ottesen,0,34.0,0,0,1,0,1,Norway
Rupak Ray Sharma,0,35.0,1,0,0,1,1,Nepal
Rupena Raumati,0,31.0,1,0,1,0,1,Australia
Rupert Ryan,2,99.0,0,0,2,0,2,New Zealand
Ruphin Menakely,0,58.0,0,0,1,0,1,Madagascar
Rusi Gochev,0,93.0,0,0,1,1,2,Bulgaria
Ruslan Abishov,0,152.0,0,0,2,1,3,Belgium
Ruslan Baltiyev,1,492.0,0,2,4,4,8,Kazakhstan
Ruslan Barburoş,0,72.0,0,0,0,1,1,North Macedonia
Ruslan Koryan,0,95.0,0,0,1,1,2,Montenegro
Ruslan Malinovskyi,0,149.0,0,0,2,1,3,Lithuania
Ruslan Mingazow,0,45.0,0,0,1,0,1,Turkmenistan
Ruslan Qurbanov,0,45.0,0,0,0,1,1,San Marino
Ruslan Rotan,1,367.0,0,0,3,2,5,Kazakhstan
Ruslan Valiullin,0,164.0,0,0,2,0,2,Kazakhstan
Rusli Ramang,0,207.0,0,0,2,2,4,Indonesia
Russel Mwafulirwa,2,142.0,0,0,3,1,4,Malawi
Russell Latapy,3,641.0,0,0,9,3,12,Barbados
Russell Teibert,0,64.0,0,1,0,1,1,Dominica
Rustam Khojaev,3,135.0,0,0,3,0,3,Tajikistan
Rustam Usmonov,1,87.0,0,0,1,0,1,Tajikistan
Rutger Backe,0,24.0,0,0,1,0,1,Sweden
Ruud Geels,0,634.0,0,2,6,4,10,Netherlands
Ruud Gullit,2,677.0,0,0,7,8,15,Netherlands
Ruud Krol,2,198.0,1,0,4,0,4,Bulgaria
Ruud Schoonhoven,0,180.0,0,0,2,0,2,Suriname
Ruud van Nistelrooy,7,1656.0,0,1,21,8,29,Netherlands
Ruy Ramos,1,31.0,0,0,0,1,1,Sri Lanka
Ryan Babel,0,148.0,0,0,0,3,3,Romania
Ryan Bertrand,0,86.0,0,0,0,1,1,Malta
Ryan Camilleri,0,52.0,1,0,0,1,1,Malta
Ryan Christie,0,64.0,0,0,0,2,2,Cyprus
Ryan Donk,0,38.0,0,1,1,0,1,Suriname
Ryan Fraser,0,126.0,0,0,1,1,2,Israel
Ryan Giggs,0,498.0,0,0,7,4,11,Wales
Ryan Johnson,2,121.0,0,0,2,1,3,Jamaica
Ryan Malmberg,0,84.0,0,0,0,1,1,Dominican Republic
Ryan Mendes,0,90.0,0,0,1,0,1,Cape Verde
Ryan Mmaee,0,114.0,0,1,4,0,4,Morocco
Ryan Nelsen,2,331.0,0,0,5,0,5,New Zealand
Ryan Robbins,0,73.0,0,0,0,1,1,Turks and Caicos Islands
Ryan Simpson,0,90.0,0,0,1,0,1,Belize
Ryan Telfer,1,44.0,0,0,1,0,1,Trinidad and Tobago
Ryan Thomas,0,151.0,0,0,3,0,3,New Zealand
Ryang Yong-gi,1,12.0,0,0,1,0,1,North Korea
Ryoichi Maeda,3,282.0,0,0,4,3,7,Saudi Arabia
Ryszard Grzegorczyk,0,134.0,0,0,1,1,2,Poland
Ryszard Tarasiewicz,0,342.0,0,0,3,2,5,Poland
Ryu Song-Gun,4,347.0,0,0,3,3,6,North Korea
Ryuzo Morioka,1,90.0,1,0,1,0,1,Saudi Arabia
Réginal Goreux,0,64.0,0,0,0,1,1,United States Virgin Islands
Régis Manon,0,33.0,0,0,1,0,1,Gabon
Rémy Ebanega,0,57.0,0,0,1,0,1,Gabon
Ríkharður Daðason,0,160.0,1,0,5,0,5,Iceland
Ríkharður Jónsson,0,205.0,0,0,1,3,4,Belgium
Róaldur Jakobsen,0,11.0,0,0,0,1,1,Hungary
Róbert Boženík,0,139.0,0,0,1,3,4,Hungary
Róbert Feczesin,0,34.0,0,0,1,0,1,Hungary
Róbert Mak,0,235.0,0,0,3,3,6,Ukraine
Róbert Tomaschek,0,165.0,0,0,0,3,3,Liechtenstein
Róbert Vittek,4,750.0,0,1,6,8,14,Liechtenstein
Róger Flores,1,75.0,0,0,0,1,1,Sweden
Róger Gómez,1,14.0,0,0,1,0,1,Costa Rica
Rógvi Baldvinsson,0,213.0,1,0,2,2,4,Faroe Islands
Rógvi Jacobsen,0,548.0,0,0,3,5,8,Iceland
Rómulo Otero,0,231.0,0,1,4,1,5,Venezuela
Rónald González Brenes,2,146.0,1,0,1,2,3,Czechoslovakia
Rónald Gómez,5,773.0,0,0,8,6,14,Trinidad and Tobago
Rónald Matarrita,0,174.0,0,0,1,1,2,Costa Rica
Rôni,1,109.0,0,0,1,1,2,Brazil
Rúben Bareño,0,31.0,0,0,0,1,1,Ecuador
Rúben Dias,0,35.0,1,0,1,0,1,Germany
Rúnar Kristinsson,0,46.0,0,0,1,0,1,Iceland
Rúnar Már Sigurjónsson,0,90.0,0,1,0,1,1,Liechtenstein
Rúrik Gíslason,0,90.0,0,0,0,1,1,Latvia
Rüdiger Abramczik,1,3.0,0,0,1,0,1,Germany
Rüdiger Schnuphase,0,116.0,0,2,3,1,4,German DR
Răzvan Cociş,0,59.0,0,0,0,1,1,Faroe Islands
Răzvan Marin,0,12.0,0,0,0,1,1,Armenia
Rıdvan Dilmen,0,152.0,0,0,2,1,3,German DR
Rıza Çalımbay,0,13.0,0,1,1,0,1,Turkey
Saad Abdul-Amir,0,145.0,0,1,0,2,2,Japan
Saad Al-Harthi,0,351.0,0,0,5,1,6,Saudi Arabia
Saad Al-Houti,0,27.0,0,0,2,0,2,Kuwait
Saad Al-Mukhaini,0,52.0,0,0,1,0,1,Oman
Saad Al-Shammari,0,174.0,0,0,1,1,2,Laos
Saad Attiya,0,75.0,0,0,0,1,1,Taiwan
Saad Bakheet Mubarak,0,80.0,0,0,1,0,1,United Arab Emirates
Saad Bguir,0,84.0,0,0,1,0,1,Tunisia
Saad Dahane,0,126.0,0,2,2,0,2,Morocco
Saad Qais,6,408.0,0,0,3,3,6,Yemen
Saad Uddin,0,42.0,0,0,0,1,1,India
Saado Al-Suwaiti,1,57.0,0,0,1,0,1,Saudi Arabia
Saba Lobzhanidze,0,25.0,0,0,0,1,1,Denmark
Sabah Abdul-Jalil,1,46.0,0,0,1,0,1,Iraq
Sabah Bizi,0,87.0,0,0,1,0,1,Albania
Sabah Hatim,4,126.0,0,0,4,0,4,Iraq
Sabah Jeayer,0,170.0,0,0,2,2,4,Lebanon
Sabbir,1,100.0,0,0,2,0,2,Bangladesh
Sabelo Ndzinisa,0,61.0,0,0,0,1,1,Djibouti
Saber Ben Frej,0,20.0,0,0,1,0,1,Tunisia
Saber Khelifa,1,55.0,0,0,0,2,2,Ghana
Sabri Sarıoğlu,0,39.0,0,0,0,1,1,Bosnia and Herzegovina
Sacha Kljestan,0,122.0,0,0,1,1,2,Saint Vincent and the Grenadines
Sacha Schneider,0,49.0,0,0,1,0,1,Luxembourg
Sadio Diallo,2,120.0,0,1,2,2,4,Botswana
Sadio Mané,10,955.0,0,4,7,9,16,Senegal
Sadiq Saadoun,0,58.0,1,0,2,0,2,Iraq
Saeed Al Kass,2,407.0,0,1,5,2,7,United Arab Emirates
Saeed Al-Owairan,6,427.0,0,0,7,4,11,Saudi Arabia
Saeed Murjan,0,96.0,0,0,0,2,2,Nepal
Saeed Shaaban Al Busaidy,1,88.0,0,0,1,1,2,Oman
Saeid Daghighi,0,86.0,0,0,1,0,1,Iran
Saeid Ezatolahi,0,64.0,0,0,1,0,1,Iran
Safaa Hadi,1,90.0,0,0,1,0,1,Iraq
Safar Iranpak,2,64.0,0,0,2,0,2,Iran
Safawi Rasid,1,259.0,0,1,4,1,5,Malaysia
Safee Sali,0,129.0,0,0,1,2,3,Singapore
Safet Sušić,1,382.0,0,0,5,4,9,Romania
Saffet Akyüz,0,8.0,0,0,1,0,1,Turkey
Saffet Sancaklı,0,37.0,0,0,2,0,2,Turkey
Safuwan Baharudin,0,183.0,0,1,2,2,4,Cambodia
Safwan Habaib,2,52.0,0,0,2,0,2,Palestine
Sahib Abbas,0,160.0,0,0,2,0,2,Iraq
Saibi Eklou Dodji,0,79.0,0,0,1,0,1,Togo
Said Bayazid,0,522.0,0,0,11,0,11,Syria
Said Brahimi,0,49.0,0,0,1,0,1,France
Said Riyad,0,90.0,1,0,1,0,1,Egypt
Said Rokbi,1,89.0,0,0,1,0,1,Morocco
Saif Eldin Ali Idris Farah,1,76.0,0,0,0,1,1,Chad
Saif Mohammed Al Bishr,0,90.0,0,0,0,1,1,Kuwait
Saimon Msuva,1,158.0,0,0,0,5,5,Kenya
Saio Ernest Mokili,1,42.0,0,0,1,0,1,DR Congo
Sairusi Nalaubu,2,100.0,0,0,0,2,2,New Caledonia
Sakdarin,0,90.0,0,0,1,0,1,Thailand
Salaah Al-Yahyaei,0,63.0,0,1,1,0,1,Oman
Saladin Said,1,290.0,0,0,2,3,5,Mauritania
Salah Al-Hasawi,2,287.0,0,0,3,2,5,Kuwait
Salah Assad,5,220.0,0,1,5,0,5,Algeria
Salah Ibrahim,0,70.0,0,0,0,1,1,Zambia
Salah Obeid,1,33.0,0,0,1,0,1,Iraq
Salaheddine Bassir,3,352.0,0,0,1,6,7,Ghana
Salam Kouko,0,65.0,0,0,1,0,1,Togo
Saleh Ahmed Farhan,1,57.0,0,0,0,1,1,Iran
Saleh Al-Mutlaq,1,20.0,0,0,0,1,1,Syria
Saleh Al-Shehri,2,515.0,0,1,4,5,9,Thailand
Saleh Eid Al-Mehaizaa,0,18.0,0,0,0,1,1,Iraq
Saleh Khalifa Al-Dosari,1,66.0,0,0,0,1,1,Syria
Saleh Obaid,0,58.0,0,0,1,0,1,United Arab Emirates
Saleh Rabiah Ben,1,62.0,0,0,1,0,1,Yemen
Saleh Selim,1,57.0,0,0,1,0,1,Egypt
Salem Al-Ajalin,0,43.0,0,0,1,0,1,Jordan
Salem Al-Dawsari,5,778.0,0,3,8,5,13,Australia
Salem Ould Ely,0,85.0,0,0,1,0,1,Mauritania
Salesh Kumar,0,7.0,0,0,1,0,1,Fiji
Salif Coulibaly,0,31.0,1,0,1,0,1,Ivory Coast
Salif Diao,3,233.0,0,0,1,3,4,Senegal
Salif Keita,1,86.0,0,0,0,1,1,Burkina Faso
Salif Kéïta,1,22.0,0,0,1,0,1,Central African Republic
Salih Sadir,0,47.0,0,0,0,2,2,Taiwan
Salim Moin,0,76.0,0,0,2,0,2,Singapore
Salim Tuama,0,81.0,0,0,0,1,1,Luxembourg
Saliou Ciss,0,4.0,1,0,1,0,1,Egypt
Salissou Ali,0,69.0,0,0,1,0,1,Togo
Salman Al-Faraj,1,241.0,0,2,4,2,6,Saudi Arabia
Salman Al-Moasher,0,90.0,0,0,0,1,1,Thailand
Salman Ghuloom,0,139.0,0,0,1,1,2,Trinidad and Tobago
Salman Isa,1,201.0,0,0,3,1,4,Bahrain
Salomon Kalou,7,673.0,0,1,9,4,13,Nigeria
Salomon Olembé,1,221.0,0,0,2,2,4,Cameroon
Salomón Rondón,4,683.0,0,0,6,8,14,Paraguay
Salvador Cabañas,3,484.0,0,1,4,6,10,Ecuador
Salvador Kaçaj,0,41.0,0,0,1,0,1,Albania
Salvador Reyes Monteón,0,538.0,0,0,8,3,11,Mexico
Salvador Soto,0,78.0,0,0,0,1,1,Haiti
Salvador Villalba,1,89.0,0,0,0,1,1,Argentina
Salvatore Bagni,0,4.0,0,0,1,0,1,Italy
Salvatore Schillaci,0,370.0,0,1,6,1,7,Italy
Sam Adekugbe,0,90.0,0,0,1,0,1,Canada
Sam El Nasa,0,185.0,1,0,3,1,4,Indonesia
Sam Garba,0,19.0,0,0,0,1,1,Ghana
Sam Johnson,0,88.0,0,0,1,0,1,Liberia
Sam Ojebode,2,174.0,0,2,2,1,3,Nigeria
Sam Tabu,0,57.0,0,0,1,0,1,Kenya
Sam Vines,0,8.0,0,0,1,0,1,United States
Sam Vokes,1,207.0,0,0,3,0,3,Wales
Samad Marfavi,0,81.0,0,0,1,0,1,Iran
Saman Ghoddos,1,78.0,0,0,1,0,1,Iran
Samat Smakov,0,164.0,0,2,1,1,2,Kazakhstan
Samba Sow,0,56.0,0,0,0,1,1,Botswana
Sambou Yatabaré,1,89.0,0,0,1,1,2,Mali
Sambégou Bangoura,1,458.0,0,0,4,4,8,Guinea
Sameh Maraaba,0,97.0,0,0,0,2,2,Malaysia
Sami Al-Hashash,0,89.0,0,0,1,0,1,Kuwait
Sami Al-Husaini,1,45.0,0,0,0,1,1,Yemen
Sami Al-Jaber,7,956.0,0,3,15,6,21,Macau
Sami Al-Najei,0,53.0,0,0,2,0,2,Saudi Arabia
Sami Hyypiä,0,218.0,0,0,3,1,4,Finland
Sami Khedira,2,207.0,0,0,3,3,6,Uruguay
Samir Aliyev,0,26.0,0,0,1,0,1,Azerbaijan
Samir Kamouna,2,271.0,0,1,3,2,5,Zambia
Samir Mubarak,1,46.0,0,0,1,0,1,Bahrain
Samir Nasri,1,221.0,0,1,3,1,4,France
Samir Said,1,101.0,0,0,2,0,2,Syria
Samir Sultan Al Fahad,0,22.0,0,0,1,0,1,Saudi Arabia
Sammy Ayoyi,0,48.0,0,0,0,1,1,Ethiopia
Sammy Baird,1,58.0,0,0,0,1,1,France
Sammy Lee,0,87.0,0,0,0,2,2,Greece
Sammy McIlroy,0,109.0,0,0,3,0,3,Northern Ireland
Sammy Morgan,2,77.0,0,0,3,0,3,Northern Ireland
Sammy Onyango,0,88.0,0,0,0,1,1,Ethiopia
Sammy Owino,0,137.0,0,1,2,0,2,Kenya
Sammy Swan,0,76.0,0,0,0,1,1,Canada
Samson Siasia,2,224.0,0,0,2,4,6,Nigeria
Samuel Barlay,0,22.0,0,0,0,1,1,Equatorial Guinea
Samuel Caballero,2,519.0,0,0,3,5,8,Jamaica
Samuel Camille,0,23.0,1,0,1,0,1,United States
Samuel Chukwueze,2,30.0,0,0,2,0,2,Nigeria
Samuel Eto'o,21,2205.0,0,7,30,10,40,Cameroon
Samuel Garcia,2,54.0,0,1,1,1,2,Tahiti
Samuel Holmén,0,64.0,0,0,1,0,1,Sweden
Samuel Hyanine,1,78.0,0,0,1,0,1,Tahiti
Samuel Johnson,1,230.0,0,1,3,0,3,Ghana
Samuel Kuffour,0,40.0,0,0,1,1,2,Tanzania
Samuel Musenze,1,71.0,0,0,0,1,1,Tunisia
Samuel Okwaraji,1,2.0,0,0,0,1,1,Cameroon
Samuel Opone,0,72.0,0,0,0,1,1,Sudan
Samuel Smyth,0,164.0,0,0,2,1,3,Northern Ireland
Samuel Tray,0,70.0,0,0,1,0,1,Sierra Leone
Samuel Umtiti,1,63.0,0,0,2,0,2,France
Samuela Kautoga,1,51.0,0,0,1,0,1,Fiji
Sanad Al Warfali,0,139.0,0,1,2,0,2,Libya
Sanda Seydou,0,36.0,0,0,1,0,1,Niger
Sander Berge,0,34.0,0,0,1,0,1,Norway
Sander Puri,0,83.0,0,0,1,0,1,Estonia
Sandesh Jhingan,0,26.0,0,0,1,0,1,India
Sandi Lovrić,0,60.0,0,1,2,0,2,Slovenia
Sandile Hlatjwako,0,121.0,0,0,2,1,3,Djibouti
Sandro Mazzola,1,491.0,0,0,10,4,14,Italy
Sandro Wagner,0,205.0,0,0,4,1,5,Germany
Sandro Wieser,0,20.0,0,0,1,0,1,Liechtenstein
Sandy Kaposa,0,58.0,0,0,1,0,1,Zambia
Sanel Jahić,0,75.0,0,0,0,1,1,Belgium
Saneliso Dlamini,0,74.0,0,0,0,1,1,Djibouti
Sanharib Malki,2,280.0,0,0,1,3,4,United Arab Emirates
Sanjar Kodirkulov,0,3.0,0,0,1,0,1,Uzbekistan
Santana Vander Kross,0,43.0,0,0,0,1,1,Puerto Rico
Santi Cazorla,0,250.0,0,0,4,0,4,Spain
Santiago Acasiete,0,110.0,0,0,2,0,2,Peru
Santiago Ostolaza,3,141.0,0,0,3,0,3,Uruguay
Santiago Salfate,1,84.0,0,1,0,1,1,Brazil
Santiago Veiga,1,50.0,0,0,0,1,1,United States
Santillana,1,589.0,0,0,8,5,13,Romania
Santino Quaranta,0,74.0,0,0,1,0,1,United States
Santos Cabrera,1,58.0,0,0,0,1,1,Guatemala
Santos Iriarte,0,129.0,0,0,2,0,2,Uruguay
Sanzhar Tursunov,0,107.0,0,0,2,1,3,Uzbekistan
Saoud Al Gassem Mohammed Bo Saeed,0,54.0,0,0,1,0,1,Saudi Arabia
Saphir Sliti Taïder,0,110.0,0,0,1,1,2,Algeria
Sarayoot Chaikamdee,0,402.0,0,0,4,5,9,Yemen
Sardar Azmoun,7,1052.0,0,0,16,11,27,Qatar
Sardor Rashidov,2,369.0,0,0,3,4,7,Uzbekistan
Sargis Hovsepyan,0,89.0,0,1,1,1,2,Kazakhstan
Sarkis Oganessian,0,10.0,1,0,1,0,1,North Macedonia
Sarman Panggabean,2,38.0,0,0,1,1,2,Indonesia
Sath Rosib,1,64.0,0,0,0,1,1,Pakistan
Saturnino Arrúa,0,217.0,0,0,4,0,4,Paraguay
Saud Jassem,0,180.0,0,0,2,0,2,Saudi Arabia
Saud Khariri,0,29.0,0,0,1,0,1,Saudi Arabia
Saula Waqa,0,45.0,0,0,1,0,1,Fiji
Sauli Pietiläinen,0,10.0,0,0,0,1,1,Bulgaria
Saulius Mikoliūnas,0,291.0,0,0,3,1,4,Lithuania
Savo Milošević,12,1255.0,0,0,11,15,26,Serbia
Saydrel Lewis,0,84.0,0,0,2,0,2,Grenada
Sayed Abdel Razek,1,139.0,0,0,2,0,2,Egypt
Sayed Ali Bechir,1,216.0,0,0,1,2,3,Qatar
Sayed Ali Eftekhari,0,16.0,0,0,1,0,1,Iran
Sayed Dhiya Saeed,1,363.0,0,0,4,2,6,Indonesia
Sayed Jaafar Ahmed,1,82.0,0,0,0,1,1,Qatar
Sayed Mahfoodh,0,27.0,0,0,0,1,1,Syria
Sayed Mahmood Jalal,0,27.0,0,0,0,1,1,Indonesia
Sayed Mohamed Adnan,1,195.0,0,0,1,2,3,Thailand
Saïd Benrahma,1,40.0,0,0,0,1,1,Djibouti
Saïd Chiba,2,75.0,0,0,2,0,2,Morocco
Saïd Makasi,1,303.0,0,1,3,2,5,Rwanda
Saïdou Panandétiguiri,0,15.0,1,0,2,0,2,Burkina Faso
Saúl Coco,0,94.0,0,0,1,1,2,Equatorial Guinea
Saúl Martínez,2,193.0,0,0,0,3,3,Brazil
Saúl Ñíguez,0,47.0,0,0,0,1,1,Norway
Saša Ilić,2,176.0,0,0,2,1,3,Serbia
Saša Kalajdžić,1,293.0,0,0,1,3,4,Scotland
Saša Ognenovski,1,35.0,0,0,0,1,1,Uzbekistan
Saša Ćirić,0,296.0,0,1,1,4,5,Liechtenstein
Sašo Miloševski,0,6.0,0,0,1,0,1,North Macedonia
Sašo Udovič,0,267.0,0,0,4,1,5,Slovenia
Schubert Gambetta,2,97.0,0,0,1,2,3,Ecuador
Scott Arfield,2,112.0,0,0,1,1,2,French Guiana
Scott Booth,0,152.0,0,0,4,1,5,Estonia
Scott Brown,0,56.0,0,0,1,0,1,Scotland
Scott Chipperfield,3,470.0,0,0,8,2,10,Australia
Scott McTominay,0,90.0,0,0,1,0,1,Scotland
Scott Sealy,0,85.0,0,0,1,0,1,Trinidad and Tobago
Scott Wiseman,1,44.0,1,0,0,1,1,Gibraltar
Sea Cheng Eang,1,80.0,0,0,1,0,1,Cambodia
Sead Kolašinac,1,3.0,1,0,1,0,1,Argentina
Sean St Ledger,1,122.0,0,0,2,1,3,Republic of Ireland
Seb Larsson,1,90.0,0,0,1,0,1,Sweden
Sebastian Andersson,0,29.0,0,0,1,0,1,Sweden
Sebastian Broderick Imasuen,0,62.0,0,0,1,0,1,Nigeria
Sebastian Deisler,0,67.0,0,0,2,0,2,Germany
Sebastian Giovinco,1,86.0,0,0,1,0,1,Italy
Sebastian Larsson,0,341.0,0,4,2,4,6,Sweden
Sebastian Lletget,0,95.0,0,0,1,1,2,United States
Sebastian Mila,0,161.0,0,0,1,1,2,Poland
Sebastian Prödl,0,67.0,0,0,1,1,2,Austria
Sebastian Rudy,0,2.0,0,0,0,1,1,Northern Ireland
Sebastian Szymański,0,3.0,0,0,1,0,1,Poland
Sebastien Lakou,1,47.0,0,0,1,0,1,Congo
Sebastián Abreu,2,577.0,0,0,7,3,10,Uruguay
Sebastián Coates,0,12.0,0,0,1,0,1,Uruguay
Sebastián Córdova,0,18.0,0,0,1,0,1,Mexico
Sebastián Eguren,0,192.0,0,0,2,1,3,Colombia
Sebastián González,1,161.0,0,0,0,2,2,Paraguay
Sebastián Pérez Cardona,0,48.0,0,0,1,0,1,Colombia
Sebastián Rambert,1,31.0,0,0,0,1,1,Japan
Sebastián Rozental,1,63.0,0,0,0,1,1,United States
Sebastián Soria,2,751.0,0,2,8,6,14,Japan
Sebastián Tagliabúe,0,86.0,0,0,1,0,1,United Arab Emirates
Sebastião Gilberto,0,153.0,0,1,2,1,3,Zambia
Sebastjan Cimirotič,1,258.0,0,0,2,2,4,Switzerland
Sedat Özden,0,123.0,0,0,1,3,4,Malta
Sedonoude Abouta,1,70.0,0,0,0,1,1,Nigeria
Sefedin Braho,0,2.0,0,0,1,0,1,Albania
Segin Wayewol,3,270.0,0,0,1,2,3,New Caledonia
Segun Odegbami,2,508.0,0,0,8,2,10,Nigeria
Segundo Castillo,0,130.0,0,0,2,1,3,Ecuador
Segundo Luna,3,144.0,0,0,3,0,3,Argentina
Segundo Villadóniga,1,1.0,0,0,0,1,1,Brazil
Seif Teiri,1,72.0,0,0,1,0,1,Sudan
Seifeddine Jaziri,1,152.0,0,0,2,0,2,Tunisia
Seiichiro Maki,0,161.0,0,0,1,2,3,Vietnam
Seimata Chilia,2,157.0,0,0,0,3,3,American Samoa
Seiminlen Doungel,1,90.0,0,0,0,1,1,Afghanistan
Sejad Salihović,0,46.0,0,1,1,1,2,Bosnia and Herzegovina
Sekou Cissé,0,191.0,0,0,3,0,3,Ivory Coast
Seksan Piturat,3,368.0,0,0,5,4,9,Iran
Sele Leboela,0,44.0,0,0,0,1,1,Guinea
Selemani Ndikumana,0,169.0,0,1,2,0,2,Burundi
Selim Amallah,1,124.0,0,0,3,0,3,Morocco
Selim Benachour,1,116.0,0,0,2,0,2,Tunisia
Sellam Riahi,0,40.0,0,0,0,1,1,Spain
Sello Muso,1,90.0,0,0,1,0,1,Lesotho
Selvyn Ponciano,0,53.0,0,0,0,1,1,Mexico
Selwyn Murren,0,66.0,1,0,1,0,1,Guatemala
Selçuk Yula,0,162.0,0,1,3,0,3,Turkey
Selçuk İnan,0,333.0,0,1,3,2,5,Turkey
Semi Nuoranen,0,27.0,0,0,1,0,1,Finland
Semih Şentürk,2,432.0,0,0,2,4,6,Switzerland
Senad Lulić,1,176.0,0,0,1,2,3,Latvia
Senad Tiganj,0,82.0,0,0,1,0,1,Slovenia
Sendley Sidney Bito,0,40.0,0,0,0,2,2,Haiti
Sengphet Thongphachan,0,53.0,0,0,1,0,1,Laos
Senijad Ibričić,0,100.0,0,0,1,2,3,Bosnia and Herzegovina
Seninho,0,11.0,0,0,1,0,1,Portugal
Sentayehu Getachew,0,64.0,0,0,1,0,1,Ethiopia
Sentu Johnson,0,79.0,0,0,0,1,1,Algeria
Seo Jung-won,2,283.0,0,0,0,4,4,Hong Kong
Seol Ki-hyeon,1,246.0,0,0,4,0,4,South Korea
Seppo Pyykkö,0,53.0,0,0,1,0,1,Finland
Sercan Yıldırım,0,37.0,0,0,1,0,1,Turkey
Serdar Annaorazow,0,12.0,1,0,1,0,1,Guam
Serdar Aziz,0,83.0,0,0,1,0,1,Turkey
Serdar Dursun,0,157.0,0,0,1,1,2,Latvia
Serdaraly Ataýew,0,70.0,0,0,0,1,1,India
Serey Dié,2,125.0,0,0,1,1,2,Ivory Coast
Serge Chiesa,0,78.0,0,0,1,0,1,France
Serge Gakpé,1,45.0,0,0,1,1,2,Guinea-Bissau
Serge Gnabry,1,585.0,0,0,9,8,17,San Marino
Serge Maguy,1,73.0,0,0,1,0,1,Ivory Coast
Serge Trinchero,0,40.0,0,1,1,0,1,Switzerland
Sergei Aleinikov,2,176.0,0,0,2,2,4,Russia
Sergei Bragin,0,57.0,0,0,0,1,1,Scotland
Sergei Gurenko,0,116.0,0,0,2,1,3,Belarus
Sergei Hohlov-Simson,0,165.0,1,0,2,1,3,Estonia
Sergei Ignashevich,0,299.0,1,1,1,6,7,Switzerland
Sergei Ivanov,1,47.0,0,0,0,1,1,Maldives
Sergei Khizhnichenko,0,184.0,0,0,3,2,5,Andorra
Sergei Kiriakov,0,327.0,0,0,1,6,7,Luxembourg
Sergei Kornilenko,0,573.0,0,2,5,5,10,Romania
Sergei Mošnikov,0,88.0,0,0,1,0,1,Estonia
Sergei Omelyanchuk,0,45.0,0,0,1,0,1,Belarus
Sergei Ostapenko,0,275.0,1,0,4,2,6,Armenia
Sergei Pavlovich Baltacha,1,70.0,0,0,2,0,2,Russia
Sergei Petrov,0,19.0,0,0,0,1,1,San Marino
Sergei Semak,0,173.0,0,0,2,1,3,Luxembourg
Sergei Terehhov,0,264.0,0,0,2,2,4,Estonia
Sergei Yuran,0,285.0,0,0,4,1,5,Cyprus
Sergei Zenjov,1,440.0,0,0,5,3,8,Belgium
Sergej Barbarez,0,501.0,0,1,4,7,11,Bosnia and Herzegovina
Sergej Milinković-Savić,1,249.0,0,0,0,4,4,Norway
Sergen Yalçın,0,287.0,0,0,3,1,4,Turkey
Sergey Andreyev,2,274.0,0,0,4,1,5,Russia
Sergey Chikishev,0,161.0,0,0,1,2,3,Pakistan
Sergey Gotsmanov,0,68.0,0,0,0,1,1,Denmark
Sergey Gridin,0,125.0,0,0,2,0,2,Kazakhstan
Sergey Grishin,0,55.0,0,0,1,0,1,Russia
Sergey Krivets,0,77.0,0,0,1,0,1,Belarus
Sergey Kutsov,2,131.0,0,0,1,2,3,Iran
Sergey Lebedev,1,164.0,0,1,3,0,3,Uzbekistan
Sergey Lushan,1,29.0,0,0,0,1,1,Japan
Sergey Rodionov,1,120.0,0,0,2,0,2,Russia
Serghei Alexeev,0,247.0,0,0,2,1,3,Moldova
Serghei Belous,0,8.0,0,0,1,0,1,Moldova
Serghei Cleșcenco,0,189.0,0,1,2,3,5,Bulgaria
Serghei Covalciuc,0,175.0,0,0,2,0,2,Moldova
Serghei Dadu,0,126.0,0,1,2,1,3,Moldova
Serghei Pogreban,0,10.0,0,0,0,1,1,North Macedonia
Serghei Rogaciov,0,142.0,0,1,5,0,5,Moldova
Serghei Secu,0,28.0,0,0,1,0,1,Moldova
Serghei Stroenco,0,16.0,1,0,1,0,1,Germany
Sergi Moreno,0,53.0,0,0,0,1,1,San Marino
Sergi Roberto,0,55.0,0,0,1,0,1,Spain
Serginho,0,43.0,0,1,0,1,1,Mexico
Serginho Chulapa,2,136.0,0,0,1,1,2,Brazil
Sergio Agüero,8,1025.0,0,1,15,5,20,Argentina
Sergio Ahumada,1,243.0,0,0,4,0,4,Chile
Sergio Angulo,0,66.0,0,0,1,0,1,Colombia
Sergio Barila,0,25.0,0,1,1,0,1,Equatorial Guinea
Sergio Berti,1,83.0,0,0,1,0,1,Argentina
Sergio Busquets,0,64.0,0,0,2,0,2,Spain
Sergio Cervato,0,3.0,0,0,1,0,1,Italy
Sergio Espinoza,1,62.0,0,0,1,0,1,Chile
Sergio Herrera,1,156.0,0,1,2,0,2,Colombia
Sergio Peña,1,120.0,0,0,2,1,3,Colombia
Sergio Ramos,0,499.0,0,4,7,6,13,San Marino
Sergio Salgado,1,83.0,0,0,0,1,1,Venezuela
Sergio Santana,2,287.0,0,0,2,2,4,Mexico
Sergio Zanatta,0,10.0,0,0,1,0,1,Canada
Sergiu Epureanu,0,3.0,0,0,1,0,1,Moldova
Sergiño Dest,0,25.0,0,0,1,0,1,United States
Serguei Prado,0,87.0,0,0,1,0,1,Cuba
Serhat Akın,0,185.0,0,0,3,0,3,Turkey
Serhii Rebrov,2,511.0,0,3,4,5,9,Northern Ireland
Serhiy Fedorov,0,90.0,0,0,1,0,1,Ukraine
Serhiy Konovalov,0,29.0,0,0,1,0,1,Ukraine
Serhiy Malyi,0,44.0,1,0,0,1,1,Kazakhstan
Serhiy Nazarenko,0,234.0,0,0,3,2,5,Kazakhstan
Serhiy Popov,0,56.0,0,0,3,0,3,Ukraine
Serhiy Serebrennikov,0,2.0,0,0,0,1,1,Armenia
Serhiy Skachenko,0,55.0,0,0,2,0,2,Ukraine
Serhiy Sydorchuk,0,192.0,0,0,1,2,3,Belarus
Serikzhan Muzhikov,0,59.0,0,0,0,1,1,Ukraine
Servaas Wilkes,0,26.0,0,0,1,0,1,Netherlands
Server Djeparov,3,731.0,0,2,8,6,14,Uzbekistan
Servet Çetin,0,106.0,0,0,1,1,2,Malta
Servílio de Jesús,1,37.0,0,0,0,1,1,Argentina
Seth Amphadu,1,32.0,0,0,1,0,1,Ghana
Seveci Rokotakala,3,240.0,0,0,3,1,4,Fiji
Severino Da Silva,4,200.0,0,0,4,0,4,Brazil
Severino Varela,9,539.0,0,1,5,10,15,Paraguay
Severo Orgaz,2,168.0,0,0,2,0,2,Bolivia
Seweryn Gancarczyk,0,3.0,1,0,0,1,1,Poland
Seyd Bechir,0,72.0,0,0,2,0,2,Qatar
Seydou Doumbia,1,232.0,0,0,1,2,3,Ivory Coast
Seydou Keita,4,722.0,0,0,8,5,13,Mali
Seydou Traoré,0,77.0,0,0,1,0,1,Burkina Faso
Seydouba Bangoura,1,145.0,0,0,1,1,2,Algeria
Seydouba Soumah,0,80.0,0,1,1,1,2,Egypt
Seydouba Sylla,1,31.0,0,0,1,0,1,Guinea
Seyoum Tesfaye,0,127.0,0,0,2,0,2,Ethiopia
Shabani Nonda,1,437.0,0,1,9,2,11,DR Congo
Shabib Al-Khaldi,0,73.0,0,0,1,0,1,Kuwait
Shadrack Nsajigwa,0,12.0,0,0,0,1,1,Mauritius
Shaharuddin Abdullah,1,70.0,0,0,0,1,1,Thailand
Shahdon Winchester,0,66.0,0,0,0,1,1,Mexico
Shahin Bayani,1,88.0,1,0,1,0,1,Saudi Arabia
Shahrel Fikri,0,115.0,0,0,4,0,4,Malaysia
Shahrokh Bayani,2,183.0,0,2,1,2,3,Iran
Shahrom Samiev,1,174.0,0,0,2,0,2,Tajikistan
Shailemdra Lal,5,159.0,0,0,5,0,5,Fiji
Shailend Lal,1,28.0,0,0,0,1,1,Tahiti
Shait Ahmed Jehad,2,180.0,0,0,0,2,2,Qatar
Shaker Mahmoud,1,49.0,0,0,1,0,1,Iraq
Shakir Hamzah,0,3.0,0,0,1,0,1,Singapore
Shalom Luani,2,98.0,0,0,2,0,2,American Samoa
Shamar Nicholson,2,201.0,0,0,2,3,5,Jamaica
Shamveel Qasim,0,14.0,0,0,1,0,1,Maldives
Shandel Samuel,0,278.0,0,0,3,2,5,Nicaragua
Shane Duffy,0,249.0,0,0,2,3,5,Georgia
Shane Long,1,319.0,0,0,3,2,5,Republic of Ireland
Shane Malcolm,0,51.0,0,0,1,0,1,Guam
Shane Marshall,0,89.0,0,0,1,0,1,Dominica
Shane Rennie,0,96.0,0,1,2,1,3,Grenada
Shane Smeltz,3,613.0,0,1,5,9,14,Fiji
Shannon Burgess,0,208.0,0,2,4,0,4,Bermuda
Shanon Carmelia,0,111.0,0,0,2,0,2,Curaçao
Shao Jiayi,1,238.0,0,0,6,1,7,China PR
Shaq Moore,0,1.0,0,0,1,0,1,United States
Shaquille Pinas,0,96.0,0,0,2,0,2,Suriname
Sharaf Mahfood,1,52.0,0,0,1,0,1,Yemen
Sharif Mukhammad,0,63.0,1,0,1,0,1,Japan
Shaun Bartlett,7,555.0,0,1,14,1,15,South Africa
Shaun Easthope,0,43.0,0,1,1,0,1,Samoa
Shaun Francis,1,6.0,0,0,1,0,1,Jamaica
Shaun Goater,0,564.0,0,1,3,7,10,Bermuda
Shaun Maloney,1,304.0,0,2,3,4,7,Faroe Islands
Shaun Murphy,3,144.0,0,0,2,1,3,Australia
Shaun Wright-Phillips,0,91.0,0,0,3,0,3,England
Shavkat Salomov,0,68.0,0,0,1,0,1,Uzbekistan
Shawky Gharieb,0,73.0,0,0,1,0,1,Egypt
Shawn Beveney,0,26.0,0,0,1,0,1,Guyana
Shawn Martin,0,25.0,0,0,2,1,3,El Salvador
Shay Holtzman,1,90.0,0,0,1,0,1,Israel
Shaye Al Nafeesah,0,90.0,0,0,1,0,1,Saudi Arabia
Shaye Al-Nafisah,1,10.0,0,0,1,0,1,Saudi Arabia
Shayne Lavery,0,67.0,0,0,0,1,1,Lithuania
Shefki Kuqi,0,362.0,0,0,3,2,5,Albania
Sheikh Mohammad Aslam,0,70.0,0,0,1,0,1,Bangladesh
Sheldon Bateau,3,79.0,0,0,4,0,4,Trinidad and Tobago
Sheldon Emmanuel,0,79.0,0,1,2,0,2,Saint Lucia
Shen Si,1,7.0,0,1,1,0,1,China PR
Shen Xiangfu,3,329.0,0,0,4,0,4,China PR
Sheraldo Becker,0,39.0,0,0,2,0,2,Suriname
Sheridan Grosvenor,0,90.0,0,0,0,1,1,Bermuda
Sheriddin Boboev,1,78.0,0,0,1,0,1,Tajikistan
Sherif Touré Coubageat,0,63.0,0,0,1,0,1,Togo
Sheriff Suma,0,169.0,0,0,3,0,3,Sierra Leone
Shewangizaw Agonafer,0,19.0,0,0,1,0,1,Ethiopia
Shi Jiayi,2,213.0,0,0,1,3,4,Palestine
Shibuzor Ehilegbu,1,31.0,0,0,0,1,1,Ghana
Shigeyoshi Mochizuki,1,30.0,0,0,1,0,1,Japan
Shikabala,0,61.0,0,0,0,1,1,Ghana
Shimelis Bekele,0,217.0,0,0,3,0,3,Ethiopia
Shimon Gershon,1,98.0,0,2,2,0,2,Israel
Shin Hong-Ki,1,63.0,0,0,1,0,1,South Korea
Shin Tae-Yong,1,35.0,0,0,1,0,1,South Korea
Shingayi Kaondera,0,178.0,0,0,2,2,4,Gabon
Shinji Kagawa,5,719.0,0,1,8,7,15,Qatar
Shinji Okazaki,12,1213.0,0,0,8,14,22,Uzbekistan
Shinji Ono,1,207.0,0,0,1,2,3,Saudi Arabia
Shiva N'Zigou,1,23.0,0,0,1,1,2,South Africa
Shkodran Mustafi,1,66.0,0,0,2,0,2,Germany
Shkëlqim Muça,0,27.0,0,0,1,0,1,Albania
Shkëlzen Gashi,0,81.0,0,0,1,0,1,Albania
Shlomo Levi,2,207.0,0,0,5,0,5,Israel
Shlomo Nahari,0,34.0,0,0,1,0,1,Israel
Shmuel Rosenthal,1,70.0,0,0,1,0,1,Israel
Sho Inagaki,0,158.0,0,0,2,0,2,Japan
Sho Sasaki,0,72.0,0,0,1,0,1,Japan
Shojae Khalilzadeh,1,22.0,0,0,0,1,1,Cambodia
Shoji Jo,1,119.0,0,0,2,0,2,Japan
Shomari Kapombe,0,61.0,0,0,1,0,1,Tanzania
Shon Weissman,0,117.0,0,0,2,0,2,Israel
Shota Arveladze,0,747.0,0,0,8,11,19,Georgia
Shoya Nakajima,1,31.0,0,0,0,2,2,Ecuador
Shukhrat Dzhaborov,0,148.0,0,0,3,0,3,Tajikistan
Shukhrat Jabbarov,1,77.0,0,0,1,0,1,Tajikistan
Shukhrat Maksudov,0,124.0,0,0,2,0,2,Uzbekistan
Shunsuke Nakamura,7,491.0,0,1,5,8,13,New Zealand
Shurland David,1,75.0,1,0,1,0,1,Mexico
Shusaku Hirasawa,1,28.0,0,0,0,1,1,Israel
Siaka Tiéné,1,133.0,0,0,2,0,2,Ivory Coast
Siboniso Mamba,0,56.0,0,0,0,1,1,Djibouti
Sibusiso Vilakazi,0,45.0,0,0,1,0,1,South Africa
Sibusiso Zuma,1,198.0,0,0,3,2,5,Burkina Faso
Sid Ahmed Zerrouki,0,78.0,0,0,0,1,1,Kenya
Siddiq Manzul,1,143.0,0,1,1,1,2,Sudan
Sidi Napon,0,56.0,0,0,1,0,1,Burkina Faso
Sidi Yaya Keita,0,127.0,0,0,2,0,2,Mali
Sidique Mansaray,0,104.0,0,0,2,0,2,Sierra Leone
Sidney Govou,0,303.0,0,0,4,2,6,France
Sidumo Shongwe,0,126.0,0,0,1,1,2,Eswatini
Siegfried Haltman,0,32.0,0,0,2,1,3,Trinidad and Tobago
Siegfried Stritzl,0,89.0,0,0,0,1,1,Canada
Sieng Chanthea,0,81.0,0,0,1,0,1,Cambodia
Sigamary Diarra,1,90.0,0,0,1,0,1,Mali
Sigfrido Mercado,0,100.0,0,0,2,1,3,United States
Sigfried Held,1,57.0,0,0,2,0,2,Germany
Sigifredo Cuchuca,0,18.0,0,0,0,1,1,Brazil
Sigurd Rushfeldt,0,107.0,0,0,1,1,2,Luxembourg
Sigurður Grétarsson,0,10.0,0,0,1,0,1,Iceland
Sigurður Jónsson,0,194.0,0,0,1,2,3,Spain
Siim Luts,1,10.0,0,0,0,1,1,Gibraltar
Silao Malo,1,158.0,0,0,2,0,2,Samoa
Silvan Widmer,0,11.0,0,0,0,1,1,Italy
Silvestre Igoa,1,152.0,0,0,1,1,2,Spain
Silvestre Varela,2,270.0,0,0,2,2,4,Denmark
Silvio Garay,1,90.0,0,0,0,1,1,Peru
Silvio Lagreca,1,39.0,0,1,0,1,1,Argentina
Silvio Marić,0,39.0,0,0,1,0,1,Croatia
Silvio Marzolini,1,50.0,0,0,1,0,1,Argentina
Silvio Parodi,4,313.0,0,0,2,4,6,Paraguay
Silvio Piola,3,315.0,0,0,1,4,5,Italy
Silvio Rojas,0,89.0,0,0,1,1,2,Colombia
Silvio Spann,1,8.0,0,0,0,1,1,El Salvador
Silviu Bindea,1,35.0,0,0,0,1,1,Cuba
Silvère Ganvoula,0,45.0,0,1,1,0,1,Congo
Simen Brenne,1,31.0,0,0,0,1,1,Turkey
Simeon Jackson,0,170.0,0,0,0,4,4,Puerto Rico
Simo Emmanuel Mvé,0,79.0,0,0,1,0,1,Cameroon
Simo Syrjävaara,0,25.0,0,0,1,0,1,Finland
Simon Church,0,67.0,0,0,1,0,1,Wales
Simon Colosimo,0,132.0,0,0,2,0,2,Australia
Simon Davies,0,204.0,0,0,3,3,6,Finland
Simon Dawkins,0,89.0,0,0,0,1,1,Nicaragua
Simon Elliott,2,146.0,0,0,3,0,3,New Zealand
Simon Kaushi,2,98.0,0,0,0,3,3,Kenya
Simon Kjær,0,233.0,1,1,2,3,5,Czech Republic
Simon Lauru,3,173.0,0,0,1,2,3,Vanuatu
Simon Masaba,0,30.0,0,1,1,0,1,Uganda
Simon Rolfes,0,64.0,0,0,0,1,1,Liechtenstein
Simon Tahamata,0,57.0,0,0,0,1,1,Republic of Ireland
Simon Uutoni,1,130.0,0,0,1,1,2,Namibia
Simone Bacciocchi,0,61.0,1,0,1,0,1,Moldova
Simone Perrotta,1,119.0,0,0,1,1,2,Italy
Simone Zaza,0,16.0,0,0,0,1,1,Norway
Simão,0,245.0,0,0,5,0,5,Brazil
Simão Sabrosa,2,643.0,0,1,11,1,12,Portugal
Sin Yong-nam,0,52.0,0,0,0,1,1,Thailand
Singgih Pitono,0,85.0,0,0,0,1,1,Qatar
Singo McDonald,0,2.0,0,0,0,1,1,Kenya
Sinha,2,211.0,0,0,3,2,5,Mexico
Siniša Gogić,0,104.0,0,1,4,0,4,Cyprus
Siniša Mihajlović,4,340.0,1,0,4,2,6,Slovakia
Sione Uhatahi,0,47.0,0,0,1,0,1,Tonga
Siphiwe Tshabalala,1,105.0,0,0,1,2,3,Equatorial Guinea
Sirous Dinmohammadi,0,84.0,0,0,0,1,1,Saudi Arabia
Sirous Ghayeghran,1,108.0,0,0,0,2,2,Thailand
Sisir Ghosh,0,34.0,0,0,0,1,1,Bangladesh
Siyabonga Nkosi,1,45.0,0,0,0,1,1,Guatemala
Siyabonga Nomvethe,6,430.0,0,0,5,3,8,Ghana
Siyabonga Sangweni,0,116.0,0,0,2,0,2,South Africa
Siza Dlamini,0,198.0,0,0,2,1,3,Angola
Sjaak Roggeveen,0,90.0,0,0,1,0,1,Netherlands
Sjaak Swart,0,132.0,0,0,2,0,2,Netherlands
Skander Souayah,1,43.0,0,1,1,1,2,Tunisia
Slava Metreveli,3,267.0,0,0,4,3,7,Russia
Slaven Bilić,1,51.0,0,0,2,1,3,Bosnia and Herzegovina
Slaven Zambata,0,314.0,0,0,3,4,7,Sweden
Slaviša Jokanović,1,113.0,0,0,1,3,4,Faroe Islands
Slimane Raho,0,60.0,1,0,1,0,1,Zimbabwe
Sloan Privat,1,71.0,0,0,1,0,1,French Guiana
Slobodan Komljenović,3,127.0,0,0,1,2,3,United States
Smail Prevljak,0,91.0,0,0,0,2,2,Kazakhstan
Smith Samuel,0,82.0,0,0,1,0,1,Guinea
So Kyong-jin,0,45.0,0,0,0,1,1,Philippines
Soeuy Visal,1,77.0,1,0,1,1,2,Iran
Sofiane Bendebka,1,73.0,0,0,0,1,1,Ivory Coast
Sofiane Boufal,3,253.0,0,2,2,2,4,Morocco
Sofiane Daoud,0,48.0,0,0,1,0,1,Algeria
Sofiane Feghouli,5,323.0,0,2,4,5,9,Algeria
Sofiane Hanni,1,90.0,0,0,1,0,1,Algeria
Sohrab Bakhtiarizadeh,1,187.0,0,0,3,0,3,Iran
Sok Sun Hean,1,56.0,0,0,1,0,1,Cambodia
Sokol Cikalleshi,0,286.0,0,1,2,3,5,Albania
Sokol Kushta,0,278.0,0,2,6,3,9,Romania
Sokratis Papastathopoulos,1,204.0,0,0,0,3,3,Costa Rica
Sol Campbell,1,24.0,0,0,1,0,1,England
Solome Pita,0,22.0,0,0,1,0,1,Fiji
Solomon Sheferahu,0,42.0,0,0,2,0,2,Ethiopia
Somen Tchoyi,0,65.0,0,0,0,1,1,Cape Verde
Sompit Suwannapluoh,1,49.0,0,0,0,1,1,Malaysia
Sompong Soleb,0,35.0,0,0,1,0,1,Thailand
Son Heung-min,8,1491.0,0,3,16,6,22,South Korea
Song Chong-gug,0,128.0,0,0,1,1,2,United States
Songserm Maperm,1,110.0,0,0,1,1,2,Thailand
Sonni Nattestad,0,38.0,0,0,0,2,2,Latvia
Soony Saad,2,177.0,0,0,1,3,4,Turkmenistan
Sor Rotana,1,32.0,1,0,0,1,1,Cambodia
Soriba Soumah,3,194.0,0,4,1,3,4,Egypt
Sorin Avram,0,71.0,0,0,0,1,1,Portugal
Sory Kaba,1,34.0,0,0,1,0,1,Guinea
Sos Suhana,0,65.0,0,0,0,1,1,Singapore
Sotirios Kyrgiakos,0,43.0,0,0,1,2,3,Greece
Sotiris Kaiafas,0,105.0,0,1,2,0,2,Cyprus
Sotiris Ninis,0,115.0,0,0,1,1,2,Israel
Soufiane Alloudi,3,34.0,0,0,0,3,3,Namibia
Soukaphone Vongchiengkham,0,5.0,0,0,0,1,1,China PR
Souleyman Sané,0,218.0,0,0,4,1,5,Senegal
Souleymane Camara,2,148.0,0,0,1,1,2,Senegal
Souleymane Diamouténé,0,48.0,0,1,1,0,1,Mali
Souleymane Oularé,3,266.0,0,0,2,4,6,Guinea
Souleymane Youla,1,268.0,0,0,2,3,5,Uganda
Souliya Syphasay,0,46.0,0,0,1,0,1,Laos
Soumaila Traoré,1,64.0,0,0,0,1,1,Egypt
Soumaila Yattaga,0,32.0,0,0,0,1,1,Botswana
Soumaïla Coulibaly,1,289.0,0,0,3,3,6,Guinea-Bissau
Sousa Miyamou,0,89.0,0,0,1,0,1,Congo
Spas Delev,0,25.0,0,0,2,0,2,Bulgaria
Spiro Debarski,0,77.0,0,0,1,0,1,Bulgaria
Srdjan Luchin,0,77.0,0,0,0,1,1,Albania
Srečko Katanec,0,252.0,0,0,3,2,5,Yugoslavia
Srgjan Zaharievski,0,141.0,0,0,1,1,2,North Macedonia
Stalin Rivas,1,72.0,0,0,0,1,1,Uruguay
Stan Mortensen,1,146.0,0,0,2,2,4,Wales
Stan Pearson,0,101.0,0,0,2,0,2,England
Stan Vanden Eynde,1,30.0,0,0,0,1,1,Republic of Ireland
Stanislaus Kobierski,1,25.0,0,0,0,1,1,Belgium
Stanislav Andreev,1,50.0,0,0,0,1,1,Yemen
Stanislav Angelov,0,31.0,0,0,1,0,1,Bulgaria
Stanislav Griga,0,93.0,0,0,2,0,2,Czechoslovakia
Stanislav Karasi,2,229.0,0,0,0,4,4,Greece
Stanislav Lobotka,0,11.0,0,0,0,2,2,England
Stanislav Manolev,0,136.0,0,0,3,1,4,Bulgaria
Stanislav Varga,0,58.0,0,0,1,0,1,Slovakia
Stanislav Šesták,0,479.0,0,0,5,4,9,Slovakia
Stanislaw Drahun,0,276.0,0,0,2,3,5,Romania
Stanisław Terlecki,0,213.0,0,0,1,3,4,Poland
Stanley Humbert Krenten,0,115.0,0,0,2,0,2,Suriname
Stanley Mubiru,2,141.0,0,0,0,3,3,Egypt
Stanley Ndunduma,0,90.0,0,0,1,0,1,Zimbabwe
Stanley Simson,0,52.0,0,0,0,1,1,Guyana
Stanley Waita,1,69.0,0,0,1,1,2,Vanuatu
Stanton Lewis,0,60.0,0,0,1,0,1,Bermuda
Stasys Baranauskas,0,63.0,0,0,1,0,1,Lithuania
Stathis Chaitas,0,39.0,0,0,0,1,1,Finland
Stavros Georgiou,0,71.0,0,0,1,0,1,Cyprus
Stavros Sarafis,0,4.0,0,0,1,0,1,Greece
Stavros Stylianou,0,74.0,0,1,1,0,1,Cyprus
Steeve Yago,0,24.0,0,0,0,1,1,Cameroon
Steeven Langil,1,66.0,0,0,1,0,1,Martinique
Steeven Saba,1,22.0,0,0,0,1,1,Nicaragua
Steevy Chong Hue,3,86.0,0,0,2,1,3,Samoa
Stefan Bozhkov,0,55.0,0,1,1,0,1,Bulgaria
Stefan Effenberg,1,47.0,0,0,0,1,1,Scotland
Stefan Johansen,0,45.0,0,0,0,1,1,Sweden
Stefan Kuntz,0,97.0,0,0,0,2,2,England
Stefan Lainer,1,66.0,0,0,2,0,2,Austria
Stefan Landberg,0,89.0,0,0,1,0,1,Sweden
Stefan Maierhofer,0,1.0,0,0,1,0,1,Austria
Stefan Majewski,1,92.0,0,0,2,0,2,Poland
Stefan Mugoša,0,260.0,0,0,2,2,4,Montenegro
Stefan Pettersson,0,76.0,0,0,1,0,1,Sweden
Stefan Posch,0,21.0,0,0,0,1,1,Slovenia
Stefan Reshko,0,22.0,1,0,1,0,1,Turkey
Stefan Ristovski,0,66.0,0,0,1,0,1,North Macedonia
Stefan Rusnák,0,5.0,0,0,0,1,1,Israel
Stefan Savić,0,87.0,0,0,1,1,2,Moldova
Stefan Sultana,0,50.0,0,0,2,0,2,Malta
Stefan Velichkov,0,72.0,0,0,1,0,1,Bulgaria
Stefan de Vrij,1,119.0,0,0,0,2,2,Spain
Stefan Šćepović,0,74.0,0,0,1,0,1,Serbia
Stefanis Michael,0,85.0,0,0,1,1,2,Russia
Stefano Bensi,0,197.0,0,0,1,2,3,Azerbaijan
Stefano Cincotta,0,50.0,0,0,0,2,2,Bermuda
Stefano Eranio,0,170.0,0,0,2,0,2,Italy
Stefano Fanelli,0,82.0,0,0,1,0,1,Luxembourg
Stefano Fiore,0,66.0,0,0,0,1,1,Belgium
Stefano Sensi,0,65.0,0,0,1,1,2,Italy
Stefanos Borbokis,0,146.0,0,0,3,0,3,Greece
Stefanos Lysandrou,0,42.0,0,0,0,1,1,Belgium
Steffen Iversen,1,669.0,0,3,7,10,17,Georgia
Stefán Teitur Þórðarson,0,19.0,0,0,1,0,1,Iceland
Stein Thunberg,0,65.0,0,0,1,0,1,Norway
Steinar Dagur Adolfsson,0,67.0,0,0,0,1,1,Andorra
Stelios Giannakopoulos,0,211.0,0,0,0,4,4,Spain
Stelios Manolas,0,68.0,0,0,1,0,1,Greece
Stelios Okkarides,0,80.0,0,0,0,1,1,Republic of Ireland
Sten-Ove Ramberg,0,35.0,0,0,1,0,1,Sweden
Stephan El Shaarawy,0,125.0,0,0,0,2,2,Azerbaijan
Stephan Lichtsteiner,0,343.0,0,0,6,0,6,Switzerland
Stephan Rabemananjara,0,18.0,0,0,1,0,1,Madagascar
Stephan Schröck,1,264.0,0,0,2,2,4,Philippines
Stephen Appiah,1,290.0,0,1,6,0,6,Ghana
Stephen Astwood,0,140.0,0,0,2,0,2,Bermuda
Stephen Elliott,0,6.0,0,0,0,1,1,Cyprus
Stephen Eustáquio,3,100.0,0,0,1,2,3,Canada
Stephen Ireland,0,144.0,0,0,1,3,4,Cyprus
Stephen Keshi,3,383.0,0,1,2,6,8,Ethiopia
Stephen Malcolm,0,84.0,0,0,1,0,1,Jamaica
Stephen McManus,0,167.0,0,0,2,0,2,Scotland
Stephen O'Donnell,0,59.0,1,0,0,1,1,Scotland
Stephen Ward,0,32.0,0,0,1,0,1,Republic of Ireland
Stephen Wellman,0,74.0,0,0,1,0,1,Malta
Stern John,3,1339.0,0,0,15,8,23,Trinidad and Tobago
Stevan Jovetić,0,1075.0,0,3,11,6,17,Montenegro
Steve Archibald,1,147.0,0,0,2,0,2,Scotland
Steve Borg,0,77.0,0,1,1,0,1,Malta
Steve Coppell,0,22.0,0,0,1,0,1,England
Steve Corica,1,93.0,0,0,2,0,2,Australia
Steve Fatupua-Lecaill,2,167.0,0,0,1,1,2,Tahiti
Steve Finnan,0,90.0,0,0,1,0,1,Republic of Ireland
Steve Hodge,0,19.0,0,0,0,1,1,Northern Ireland
Steve Horvat,1,15.0,0,0,1,0,1,Australia
Steve Lomas,0,25.0,0,0,1,0,1,Northern Ireland
Steve Marlet,0,108.0,0,0,2,1,3,South Korea
Steve McManaman,1,92.0,0,0,2,1,3,England
Steve Morison,0,28.0,0,0,1,0,1,Wales
Steve Morrow,0,62.0,1,0,0,1,1,Northern Ireland
Steve Mounié,0,173.0,0,0,1,2,3,Madagascar
Steve Penney,0,23.0,0,0,1,0,1,Northern Ireland
Steve Purdy,0,13.0,0,0,1,0,1,El Salvador
Steve Ralston,0,163.0,0,0,3,0,3,United States
Steve Staunton,0,150.0,0,0,1,3,4,Republic of Ireland
Steve Sumner,2,884.0,0,1,14,3,17,New Zealand
Steve Wooddin,2,238.0,0,0,5,4,9,New Zealand
Steven Berghuis,0,74.0,0,0,1,1,2,Netherlands
Steven Bergwijn,0,84.0,0,0,1,0,1,Netherlands
Steven Bryce,3,253.0,0,0,2,2,4,Costa Rica
Steven Davis,0,557.0,0,3,8,2,10,Northern Ireland
Steven Defour,0,109.0,0,0,1,1,2,Belgium
Steven Dias,0,90.0,0,0,1,0,1,India
Steven Fletcher,3,594.0,0,0,5,4,9,Scotland
Steven Gerrard,6,796.0,0,0,10,6,16,Germany
Steven Naismith,1,431.0,0,0,5,2,7,Scotland
Steven Pienaar,0,85.0,0,0,2,0,2,South Africa
Steven Séance,0,81.0,0,0,1,0,1,Haiti
Steven Tan,1,35.0,0,1,0,1,1,Vietnam
Steven Thompson,0,31.0,0,0,0,1,1,Moldova
Steven Zuber,1,256.0,0,0,3,3,6,Switzerland
Stevenson Morancie,0,60.0,0,0,0,1,1,Antigua and Barbuda
Stevie Chalmers,0,38.0,0,0,1,0,1,Scotland
Stig Fredriksson,0,69.0,0,0,0,1,1,Malta
Stig Holmqvist,0,8.0,1,0,1,0,1,Italy
Stig Sundqvist,3,72.0,0,0,1,2,3,Paraguay
Stig Tøfting,1,156.0,0,1,0,2,2,Wales
Stiliyan Petrov,0,177.0,1,0,1,4,5,Belgium
Stjepan Bobek,1,167.0,0,1,1,3,4,Yugoslavia
Stjepan Lončar,0,90.0,1,0,1,0,1,Armenia
Stock Dandize,0,71.0,0,0,1,0,1,Malawi
Stokely Mason,0,54.0,0,0,1,0,1,Trinidad and Tobago
Stophira Sunzu,1,15.0,0,0,1,0,1,Zambia
Stopira,0,80.0,0,0,1,1,2,Cape Verde
Stoyan Kitov,0,69.0,0,0,1,0,1,Bulgaria
Stoycho Mladenov,0,247.0,0,0,2,2,4,Albania
Strahinja Pavlović,1,45.0,0,0,0,1,1,Cameroon
Stratos Apostolakis,0,321.0,1,2,3,2,5,Hungary
Stuart Armstrong,0,112.0,0,0,1,1,2,Lithuania
Stuart Dallas,0,90.0,0,0,0,1,1,Azerbaijan
Stuart Elliott,0,237.0,0,0,2,1,3,Bulgaria
Stuart Findlay,0,67.0,0,0,1,0,1,Scotland
Stuart Holden,0,179.0,0,0,3,0,3,United States
Stuart McCall,1,11.0,0,0,0,1,1,Sweden
Stuart Oosthuizen,0,90.0,0,0,1,0,1,Suriname
Stuart Pearce,0,113.0,0,0,2,0,2,England
Stuart Pearson,0,14.0,0,0,0,1,1,Finland
Ståle Solbakken,0,130.0,0,0,4,1,5,Norway
Stéphane Abaul,1,70.0,0,0,0,1,1,Cuba
Stéphane Auvray,1,57.0,0,0,1,0,1,Guadeloupe
Stéphane Bahoken,2,181.0,0,0,2,1,3,Cameroon
Stéphane Bruey,0,71.0,0,0,0,1,1,Greece
Stéphane Chapuisat,2,920.0,0,0,10,7,17,San Marino
Stéphane Demol,1,102.0,0,0,0,1,1,Russia
Stéphane Grichting,0,84.0,0,0,1,0,1,Switzerland
Stéphane Lambese,1,56.0,0,0,1,0,1,Haiti
Stéphane Mbia,2,147.0,0,0,0,3,3,Tunisia
Stéphane N'Guéma,0,226.0,0,0,4,0,4,Gabon
Stéphane Sessègnon,0,181.0,0,1,2,2,4,Egypt
Su Maozhen,1,117.0,0,0,2,1,3,China PR
Suan Lam Mang,1,64.0,0,0,3,0,3,Myanmar
Suat Mamat,4,106.0,0,0,1,3,4,Turkey
Subait Khater,0,124.0,0,0,2,1,3,Brunei
Subash Madushan,0,34.0,0,0,0,1,1,Bhutan
Subhi Al-Gnimaz,2,149.0,0,0,1,2,3,Jordan
Sudirman,2,137.0,0,1,3,0,3,Indonesia
Sujal Shrestha,0,90.0,0,0,1,0,1,Nepal
Suk Bahadur,1,85.0,0,0,1,0,1,Myanmar
Suk Hyun-jun,0,100.0,0,0,1,1,2,South Korea
Sukhrob Hamidov,4,255.0,0,1,4,1,5,Tajikistan
Sukumar Samajpati,1,60.0,0,0,0,1,1,Hong Kong
Suleiman Faris,0,38.0,0,0,0,1,1,Syria
Sulejman Demollari,0,86.0,0,0,0,1,1,Lithuania
Sulley Muntari,2,582.0,0,1,8,4,12,Ghana
Sultan Bakhit Al-Kuwari,0,60.0,0,0,1,0,1,Qatar
Sun Fucheng,0,47.0,0,0,1,0,1,China PR
Sun Jihai,0,62.0,0,0,1,0,1,China PR
Sun Ke,3,111.0,0,0,3,0,3,China PR
Sun Xiang,0,12.0,0,0,0,1,1,Australia
Sunday Ineh,0,55.0,0,0,0,1,1,Sudan
Sunday Mba,2,118.0,0,0,1,1,2,Ivory Coast
Sunday Oliseh,1,91.0,0,0,1,1,2,Nigeria
Sunday Oyarekhua,0,28.0,0,0,0,1,1,Congo
Sundayin Moriri,0,135.0,0,0,1,1,2,Uganda
Sune Andersson,1,117.0,0,2,1,2,3,Sweden
Sung Nak-woon,2,134.0,0,0,1,2,3,Japan
Sunil Chhetri,6,628.0,0,2,5,8,13,Lebanon
Supachai Jaided,1,31.0,0,0,1,0,1,Thailand
Supachok Sarachat,0,126.0,0,0,0,2,2,Indonesia
Supakit Meelarpkit,1,140.0,1,0,1,1,2,Thailand
Suphanat Mueanta,0,54.0,0,0,0,1,1,United Arab Emirates
Surachai Jirasirichote,0,83.0,0,0,1,0,1,Thailand
Suree Sukha,0,39.0,0,0,0,1,1,Macau
Suriamurthy Rajagopal,0,70.0,0,0,1,0,1,Singapore
Surprise Moriri,0,33.0,0,0,1,0,1,South Africa
Sutche Wambo,0,85.0,0,0,1,0,1,Burundi
Sutee Suksomkit,1,128.0,0,1,3,1,4,Thailand
Svein Mathisen,0,79.0,0,0,0,1,1,Switzerland
Sven Andersson,0,79.0,0,0,1,0,1,Sweden
Sven Jacobsson,1,19.0,1,0,1,0,1,Hungary
Sven Jonasson,3,153.0,0,1,1,3,4,Argentina
Sven Otto Birkeland,0,46.0,0,0,1,0,1,Norway
Sverre Brandhaug,0,64.0,0,0,0,1,1,Cyprus
Svetoslav Todorov,0,161.0,0,1,2,0,2,Bulgaria
Syafiq Ahmad,0,66.0,0,0,1,1,2,Indonesia
Syam Ben Youssef,0,51.0,0,0,1,0,1,Tunisia
Syarhey Herasimets,0,310.0,0,1,2,3,5,Belarus
Syarhey Kislyak,0,86.0,0,0,0,1,1,France
Syd Bartlett,0,36.0,0,0,1,0,1,Jamaica
Sydney Urikhob,0,169.0,0,0,1,1,2,Djibouti
Sylvain Booene,1,42.0,0,0,0,1,1,Solomon Islands
Sylvain Graglia,0,144.0,0,0,0,2,2,Papua New Guinea
Sylvain Wiltord,3,735.0,0,0,11,4,15,France
Sylvio Pirillo,6,289.0,0,0,6,0,6,Brazil
Sylwester Czereszewski,0,63.0,0,0,0,2,2,Bulgaria
Syriakata Hassan,1,82.0,0,0,0,1,1,Sudan
Szabolcs Huszti,0,188.0,0,2,1,2,3,Iceland
Szilárd Devecseri,0,65.0,1,0,1,0,1,Netherlands
Szilárd Németh,0,499.0,0,0,10,3,13,Slovakia
Sándor Kiss,0,57.0,0,0,1,0,1,Hungary
Sándor Kocsis,11,603.0,0,0,5,6,11,Hungary
Sándor Müller,0,65.0,0,1,0,1,1,Switzerland
Sándor Pintér,0,52.0,0,0,2,0,2,Hungary
Sándor Schwartz,0,38.0,0,0,1,0,1,Romania
Sándor Torghelle,0,238.0,0,0,3,3,6,Hungary
Sándor Zombori,1,63.0,0,0,1,1,2,Hungary
Sándor Zámbó,0,83.0,0,0,2,0,2,Hungary
Sávio Bortolini Pimentel,2,94.0,0,0,1,1,2,Brazil
Séamus Coleman,0,56.0,0,0,1,0,1,Republic of Ireland
Sébastien Fournier,0,107.0,0,0,1,1,2,Belarus
Sébastien Haller,1,74.0,0,1,3,0,3,Ivory Coast
Sébastien Siani,1,61.0,0,0,1,0,1,Cameroon
Sébastien Thill,0,168.0,0,0,1,1,2,Luxembourg
Sébastien Vorbe,1,61.0,0,0,1,0,1,Haiti
Sékou Bamba,0,169.0,0,0,2,0,2,Ivory Coast
Sékou Dramé,0,16.0,0,0,1,0,1,Guinea
Sérgio Conceição,4,450.0,0,0,6,3,9,Portugal
Séïdath Tchomogo,0,85.0,0,0,0,3,3,Cameroon
Símun Samuelsen,0,90.0,0,0,0,1,1,Israel
Sócrates,4,408.0,0,3,5,5,10,Argentina
Sølvi Vatnhamar,0,62.0,0,0,0,1,1,Israel
Søren Busk,0,76.0,0,0,1,0,1,Denmark
Søren Frederiksen,0,58.0,0,0,1,0,1,Denmark
Søren Larsen,0,434.0,0,0,7,3,10,Denmark
Søren Lerby,2,348.0,0,1,5,3,8,Denmark
Súni Olsen,0,73.0,1,0,3,0,3,Faroe Islands
Süleýman Muhadow,0,67.0,0,0,1,0,1,Turkmenistan
Sławomir Peszko,0,26.0,0,0,0,1,1,Republic of Ireland
T. Tapunuu,1,10.0,0,0,1,0,1,Samoa
Taavi Rähn,0,33.0,1,0,1,0,1,England
Tab Ramos,0,151.0,0,0,2,0,2,United States
Tabania Ametepé,0,55.0,0,0,0,1,1,Guinea
Tadanari Lee,1,109.0,0,0,0,1,1,Australia
Tadas Kijanskas,0,110.0,1,0,1,1,2,Lithuania
Tadeusz Kraus,0,217.0,0,0,2,2,4,Czechoslovakia
Tadjou Salou,0,163.0,0,1,2,0,2,Togo
Tafari Smith,0,48.0,1,0,1,0,1,Panama
Taha Basry,3,159.0,0,0,4,0,4,Egypt
Taha Yassine Khenissi,2,109.0,0,0,0,2,2,Zimbabwe
Tahar Chaïbi,1,102.0,0,0,3,0,3,Tunisia
Tahar Chérif El-Ouazzani,0,81.0,0,0,1,0,1,Algeria
Tahar El Khalej,0,42.0,0,0,1,0,1,Morocco
Taher Abouzeid,2,361.0,0,0,4,3,7,Cameroon
Tahir Agha,1,12.0,0,0,0,1,1,Yemen
Taisir Al-Jassim,3,427.0,0,0,6,2,8,Saudi Arabia
Taiwo Awoniyi,1,45.0,0,0,1,0,1,Nigeria
Tajon Buchanan,1,231.0,0,0,3,1,4,Mexico
Tak Yong-Bin,0,4.0,0,0,0,1,1,Hong Kong
Takashi Fukunishi,1,252.0,0,0,1,4,5,Japan
Takashi Inui,2,86.0,0,0,1,1,2,Japan
Takashi Mizunuma,0,175.0,0,0,3,0,3,Japan
Takashi Usami,1,88.0,0,0,0,1,1,Syria
Takayuki Suzuki,1,297.0,0,0,5,2,7,Japan
Takehiro Tomiyasu,1,20.0,0,0,1,0,1,Japan
Takhirdjon Mouminov,0,108.0,0,0,2,1,3,Tajikistan
Takis Antoniou,0,13.0,0,0,1,0,1,Cyprus
Takis Mavris,0,47.0,0,0,1,0,1,Cyprus
Takis Nikoloudis,0,65.0,0,0,3,0,3,Greece
Takuma Asano,1,448.0,0,0,3,3,6,Thailand
Takumi Horiike,1,54.0,0,0,1,1,2,Japan
Takumi Minamino,1,425.0,0,1,7,4,11,Japan
Takuya Takagi,9,861.0,0,0,8,8,16,Japan
Tal Banin,0,203.0,0,3,4,1,5,Israel
Tal Ben Haim,0,266.0,0,1,2,4,6,Israel
Tala Luvu,1,62.0,1,0,0,1,1,American Samoa
Talal Al-Bloushi,0,86.0,0,0,1,0,1,Qatar
Talal Al-Meshal,3,836.0,0,0,13,4,17,Kuwait
Talal El Karkouri,1,252.0,0,0,3,1,4,Morocco
Talal Yousef,2,304.0,0,0,3,3,6,Bahrain
Tam Siu Wai,0,13.0,0,0,0,1,1,Lebanon
Tama Fasavalu,0,83.0,0,0,2,0,2,Samoa
Tamarley Thomas,0,263.0,0,0,4,2,6,Antigua and Barbuda
Tamer Abdel Hamid,1,58.0,0,0,0,1,1,Zimbabwe
Tamer Haj Mohamad,0,13.0,0,0,0,1,1,Iran
Tamer Seyam,3,264.0,0,2,3,2,5,Malaysia
Tamirlan Kozubaev,0,83.0,0,0,1,0,1,Kyrgyzstan
Tamkin Khalilzade,0,72.0,0,0,1,0,1,Azerbaijan
Tammy Abraham,0,221.0,0,0,1,2,3,England
Tamás Hajnal,0,74.0,0,0,2,1,3,Hungary
Tamás Kádár,0,6.0,0,0,1,0,1,Hungary
Tamás Preszeller,0,88.0,0,0,1,0,1,Hungary
Tamás Priskin,0,166.0,0,0,3,1,4,Hungary
Tan Chun Lok,0,16.0,0,0,0,1,1,Cambodia
Tan Long,1,79.0,0,0,1,0,1,China PR
Tana Chanabut,0,139.0,0,0,1,1,2,Thailand
Tanaboon Kesarat,0,84.0,1,0,0,1,1,Thailand
Tanat Nusserbayev,0,19.0,0,0,0,1,1,Ukraine
Tang Hung Cheong,0,65.0,0,0,1,0,1,Hong Kong
Tang Yaodong,1,116.0,0,0,1,1,2,Thailand
Tang Yee Kit,0,10.0,0,0,1,0,1,Hong Kong
Tanju Çolak,0,188.0,0,0,2,2,4,Austria
Taoufik Herichi,0,121.0,0,0,0,3,3,Benin
Tapiwa Gadibolae,0,14.0,0,0,1,0,1,Botswana
Taqi Mubarak,0,127.0,0,0,3,1,4,Oman
Tarak Dhiab,0,100.0,0,0,1,1,2,Morocco
Tarcisio Burgnich,1,98.0,0,0,0,1,1,Germany
Tarcisio Rodríguez Viquez,0,55.0,0,0,1,0,1,Costa Rica
Tarek El Ali,0,64.0,0,0,1,0,1,Lebanon
Tarek El-Said,0,350.0,0,0,5,0,5,Egypt
Tarek Jabban,0,115.0,0,0,3,0,3,Syria
Tarek Lazizi,0,84.0,0,0,0,1,1,South Africa
Tarek Mostafa,1,13.0,0,0,0,1,1,South Africa
Tareq Ahmed,0,90.0,0,0,1,0,1,United Arab Emirates
Tareq Khattab,1,43.0,0,0,1,0,1,Jordan
Tarik El Taib,0,108.0,0,0,2,0,2,Libya
Tarik Elyounoussi,0,193.0,0,1,3,1,4,Cyprus
Tarik Sektioui,1,48.0,0,1,0,2,2,Namibia
Tarik Tissoudali,0,121.0,0,0,1,1,2,DR Congo
Tariku Ingdawerk,0,60.0,0,0,2,1,3,Ethiopia
Tariq Abdullah Kassim,0,75.0,0,0,0,1,1,Bahrain
Tarlan Ahmadov,0,33.0,1,0,0,1,1,Azerbaijan
Tarmo Kink,0,143.0,0,0,1,2,3,Serbia
Tasos Mitropoulos,0,224.0,0,0,3,2,5,Poland
Tatsuhiko Kubo,0,102.0,0,0,2,0,2,Japan
Tatsuya Tanaka,0,19.0,0,0,0,1,1,Qatar
Tauhiti Keck,0,90.0,0,0,1,0,1,Tahiti
Tay Peng Kee,1,53.0,0,0,1,0,1,Singapore
Taye Taiwo,1,85.0,0,0,1,0,1,Nigeria
Tayfun Korkut,0,2.0,0,0,1,0,1,Turkey
Tayfur Havutçu,0,408.0,0,2,1,5,6,Turkey
Taylor Saghabi,1,189.0,0,0,1,3,4,Tonga
Taylor Twellman,0,130.0,0,0,2,0,2,United States
Taysir Amer,1,166.0,0,0,1,1,2,Palestine
Tchiressoua Guel,4,121.0,0,1,4,1,5,Ivory Coast
Teafore Bennett,1,80.0,0,0,1,0,1,Jamaica
Teaonui Tehau,5,403.0,0,0,4,3,7,Samoa
Teboho Masia,0,65.0,0,0,1,0,1,Lesotho
Teboho Mokoena,1,134.0,0,0,1,2,3,Paraguay
Ted MacDougall,0,61.0,0,0,1,0,1,Scotland
Ted Robledo,0,16.0,0,0,1,0,1,Chile
Teddy Sheringham,0,328.0,0,0,4,2,6,England
Tedj Bensaoula,4,402.0,0,0,7,2,9,Algeria
Teemu Pukki,1,1153.0,0,4,11,9,20,Spain
Teemu Tainio,0,181.0,0,0,1,3,4,Albania
Teerasil Dangda,1,336.0,0,1,7,4,11,Thailand
Teeratep Winothai,0,122.0,0,1,2,1,3,Thailand
Teet Allas,0,22.0,0,0,1,0,1,Estonia
Teitur Gestsson,0,34.0,1,0,0,1,1,Faroe Islands
Teitur Thordarson,0,33.0,0,0,1,0,1,Iceland
Teitur Þórðarson,0,80.0,0,0,0,1,1,Turkey
Tejinder Kumar,0,68.0,0,0,0,1,1,Lebanon
Tekalinge Kassahun,0,40.0,0,0,1,0,1,Ethiopia
Tekeste Gebremedhin,0,30.0,0,0,0,1,1,Tanzania
Telinho,0,10.0,0,0,0,1,1,Mauritius
Telmo Zarra,4,342.0,0,0,4,3,7,Spain
Telésforo Báez,0,44.0,0,0,0,1,1,Argentina
Temirlan Yerlanov,0,34.0,0,0,1,0,1,Kazakhstan
Temur Ketsbaia,0,343.0,0,0,5,4,9,Georgia
Tenant Chilumba,1,87.0,0,0,1,0,1,Zambia
Tendai Ndoro,1,58.0,0,0,1,0,1,Zimbabwe
Tenema Ndiaye,0,68.0,0,0,0,1,1,Ghana
Tengiz Sulakvelidze,0,44.0,0,0,0,1,1,Iceland
Teodor Țarălungă,0,72.0,0,0,0,1,1,Albania
Teodoro Fernández,7,550.0,0,1,9,6,15,Peru
Teppo Heikkinen,0,54.0,0,0,1,0,1,Finland
Terence Groothusen,1,45.0,0,0,0,1,1,Cayman Islands
Terence Scerri,0,71.0,0,0,1,0,1,Malta
Terence Vancooten,2,48.0,1,0,1,1,2,Guyana
Terio Vakatawa,0,90.0,0,0,0,1,1,New Zealand
Terrence Tisdell,0,18.0,0,1,1,0,1,Liberia
Terry Butcher,0,80.0,0,0,0,1,1,Luxembourg
Terry Conroy,0,110.0,0,0,2,0,2,Republic of Ireland
Terry Harkin,0,123.0,0,0,0,2,2,Turkey
Terry Hennessey,0,65.0,1,0,1,0,1,England
Terry McDermott,0,170.0,0,0,2,1,3,England
Terry Medwin,1,95.0,0,0,0,2,2,Hungary
Terry Neill,0,62.0,0,0,1,0,1,Northern Ireland
Terry Yorath,0,75.0,0,0,1,0,1,Wales
Teruki Miyamoto,1,38.0,0,0,0,2,2,South Korea
Tes Sean,1,59.0,0,0,1,0,1,Cambodia
Tesfalem Tekle,0,35.0,0,0,1,0,1,Eritrea
Tesfaye Tafese,0,47.0,0,0,1,0,1,Ethiopia
Tesho Akindele,0,4.0,0,0,1,0,1,Canada
Teshome Getu,0,81.0,0,1,1,0,1,Ethiopia
Tesourinha,1,380.0,0,1,7,1,8,Bolivia
Tetahio Auraa,1,65.0,0,0,1,0,1,Tahiti
Teteh Bangura,0,25.0,0,0,0,1,1,Equatorial Guinea
Tetsuji Hashiratani,0,38.0,0,0,2,0,2,Japan
Teu Fakava,1,86.0,0,0,0,1,1,American Samoa
Teuvo Moilanen,0,90.0,1,0,0,1,1,Finland
Teva Zaveroni,2,92.0,0,0,1,1,2,Tahiti
Tevaughn Harriette,0,106.0,0,0,2,0,2,Antigua and Barbuda
Tevin Slater,0,318.0,0,0,2,3,5,Saint Vincent and the Grenadines
Tevita Waranaivalu,1,12.0,0,0,1,0,1,Fiji
Teófilo Aguilar,0,62.0,0,0,0,1,1,Chile
Teófilo Cubillas,12,861.0,0,2,6,9,15,Peru
Teófilo Gutiérrez,1,534.0,0,0,8,1,9,Colombia
Tha'er Bawab,0,176.0,0,0,0,2,2,Turkmenistan
Thabo Matlaba,0,33.0,0,0,1,0,1,South Africa
Thabo Mngomeni,1,48.0,0,0,1,0,1,South Africa
Thadée Cisowski,0,390.0,0,0,7,2,9,France
Thamsanqa Gabuza,0,20.0,0,0,0,1,1,Angola
Thamsanqa Mkhize,0,38.0,1,0,0,1,1,South Africa
Thanasis Bembis,0,52.0,0,0,1,0,1,Greece
Thanis Areesngarkul,1,132.0,0,0,1,1,2,Thailand
Thapelo Tale,0,16.0,0,0,0,1,1,Burundi
Thasmbiayah Pathmanathan,0,87.0,0,0,0,1,1,Hong Kong
Thawatchai Damrong-Ongtrakul,1,84.0,0,0,1,0,1,Thailand
Theerathon Bunmathan,0,215.0,0,2,1,2,3,Thailand
Themba Zwane,0,34.0,0,0,1,0,1,South Africa
Thembinkosi Fanteni,0,62.0,0,0,1,0,1,South Africa
Thembinkosi Lorch,0,85.0,0,0,0,1,1,Egypt
Themistoklis Nikolaidis,0,69.0,0,0,0,1,1,England
Themistoklis Tzimopoulos,1,16.0,0,0,1,0,1,New Zealand
Theo Corbeanu,2,170.0,0,0,2,0,2,Canada
Theo Laseroms,0,64.0,0,0,0,1,1,Switzerland
Theo Pahlplatz,0,185.0,0,0,3,0,3,Netherlands
Theo Walcott,1,422.0,0,0,1,6,7,Croatia
Theo de Jong,1,158.0,0,0,1,1,2,Netherlands
Theodor Gebre Selassie,0,96.0,0,0,1,2,3,Czech Republic
Theodor Wagner,0,327.0,0,0,3,3,6,Austria
Theodore Filomina,0,124.0,0,0,2,0,2,Aruba
Theodore Whitmore,2,339.0,0,0,5,4,9,Suriname
Theodoros Zagorakis,0,128.0,2,0,2,1,3,Greece
Theofanis Gekas,1,952.0,0,1,12,7,19,Greece
Therdsak Chaiman,2,206.0,0,0,3,0,3,Thailand
Theódór Elmar Bjarnason,0,42.0,0,0,1,0,1,Iceland
Thiago Alcântara,0,27.0,0,0,1,0,1,Spain
Thiago Cionek,1,37.0,1,0,0,1,1,Poland
Thiago Motta,0,73.0,0,0,0,1,1,Slovenia
Thiago Silva,2,83.0,0,0,2,1,3,Brazil
Thierno Youm,0,67.0,0,0,0,1,1,Egypt
Thierry Bin,0,29.0,0,0,0,1,1,Macau
Thierry Fondelot,1,86.0,0,0,0,1,1,Canada
Thierry Henry,9,1605.0,0,2,21,13,34,France
Thierry Issiémou,0,73.0,0,0,2,0,2,Gabon
Thierry Tinmar,1,59.0,0,1,0,1,1,Costa Rica
Thievy Bifouma,2,314.0,0,0,3,3,6,Equatorial Guinea
Thitipan Puangchan,0,41.0,0,0,0,1,1,United Arab Emirates
Thomas Beck,0,368.0,0,0,5,0,5,Liechtenstein
Thomas Berthold,0,8.0,0,0,0,1,1,Czechoslovakia
Thomas Bickel,0,125.0,0,0,3,1,4,Switzerland
Thomas Buffel,0,181.0,0,0,3,0,3,Belgium
Thomas Christiansen,0,86.0,0,0,1,0,1,Spain
Thomas Delaney,1,334.0,0,0,2,5,7,Denmark
Thomas Doll,0,187.0,0,0,1,2,3,Iceland
Thomas Dooley,0,127.0,0,0,2,0,2,United States
Thomas Elliot,0,72.0,0,0,1,0,1,Cayman Islands
Thomas Flögel,0,95.0,0,0,1,1,2,Liechtenstein
Thomas Foket,0,76.0,0,0,0,1,1,Estonia
Thomas Fontaine,0,45.0,0,0,0,1,1,Tanzania
Thomas Gravesen,0,169.0,0,0,2,2,4,Denmark
Thomas Helmer,0,82.0,0,0,2,0,2,Germany
Thomas Helveg,1,76.0,0,0,0,1,1,Nigeria
Thomas Hitzlsperger,0,338.0,0,0,2,3,5,San Marino
Thomas Häßler,1,411.0,0,0,4,4,8,Germany
Thomas Kahlenberg,0,251.0,0,0,3,1,4,Denmark
Thomas Larsson,0,38.0,0,0,0,1,1,Portugal
Thomas Lemar,0,161.0,0,0,2,0,2,France
Thomas Linke,1,73.0,0,0,1,0,1,Germany
Thomas Mavros,0,337.0,0,2,6,1,7,Greece
Thomas Meunier,1,249.0,0,0,5,3,8,Belgium
Thomas Müller,9,1547.0,0,2,20,14,34,Germany
Thomas Nordahl,0,108.0,0,0,2,1,3,Norway
Thomas Parits,0,279.0,0,0,5,0,5,Austria
Thomas Partey,1,359.0,0,0,2,5,7,Ghana
Thomas Sjöberg,1,379.0,0,0,2,5,7,Norway
Thomas Sowunmi,0,55.0,0,0,1,0,1,Hungary
Thomas Strunz,0,44.0,0,0,0,1,1,Bulgaria
Thomas Sunesson,0,150.0,0,0,2,1,3,Italy
Thomas Ulimwengu,0,103.0,0,0,3,0,3,Tanzania
Thomas Vermaelen,0,24.0,0,0,0,1,1,Scotland
Thomas Vulivuli,1,24.0,0,0,1,0,1,Fiji
Thomaz Soares da Silva,0,136.0,0,0,2,0,2,Brazil
Thompson Oliha,0,20.0,0,0,1,0,1,Nigeria
Thompson Usiyan,2,175.0,0,0,5,0,5,Nigeria
Thorgan Hazard,1,270.0,0,0,4,2,6,Belgium
Thorstein Helstad,0,229.0,0,0,2,2,4,Wales
Thrizen Leader,0,117.0,1,0,1,1,2,Saint Kitts and Nevis
Thulani Hlatshwayo,1,67.0,1,0,1,0,1,Algeria
Thuso Phala,1,51.0,0,0,0,1,1,Algeria
Thuwein Ali,0,242.0,0,0,2,1,3,Kenya
Thuwein Waziri,2,145.0,0,0,0,2,2,Egypt
Théo Hernandez,1,5.0,0,0,1,0,1,France
Théo Malget,0,71.0,0,0,0,2,2,Hungary
Théodore Nzue Nguema,0,246.0,0,0,4,1,5,Gabon
Théophile Abega,3,220.0,0,0,4,0,4,Cameroon
Théophile Speicher,0,47.0,0,0,1,0,1,Luxembourg
Tia Koffi,0,27.0,0,0,1,0,1,Ivory Coast
Tiago Mendes,2,154.0,0,0,2,1,3,Serbia
Tiberio Godoy,3,95.0,0,0,0,3,3,Chile
Tiberiu Ghioane,0,81.0,0,0,0,1,1,Luxembourg
Tibor Jančula,1,309.0,0,0,4,2,6,Azerbaijan
Tibor Nyilasi,2,778.0,0,0,17,3,20,Hungary
Tibor Vigh,0,92.0,0,0,2,0,2,Canada
Tibor Wollek,0,78.0,0,0,1,0,1,Hungary
Tibou Bangoura,0,61.0,0,0,1,0,1,Guinea
Tico-Tico,1,211.0,0,0,4,1,5,Tunisia
Tigran Barseghyan,0,325.0,0,1,3,2,5,Armenia
Tigran Yesayan,0,220.0,0,0,2,1,3,Armenia
Tihomir Ognjanov,1,84.0,0,0,0,1,1,Switzerland
Tijan Jaiteh,0,106.0,0,1,1,1,2,Gambia
Tijani Babangida,1,162.0,0,0,5,0,5,Nigeria
Tijani Belaid,0,38.0,0,0,1,0,1,Tunisia
Tim Bredbury,0,54.0,0,0,1,1,2,Hong Kong
Tim Cahill,9,1865.0,0,0,26,10,36,Australia
Tim Matavž,0,347.0,0,0,6,2,8,Slovenia
Tim Payne,0,91.0,0,0,0,2,2,Solomon Islands
Tim Stevens,0,80.0,0,0,1,0,1,New Zealand
Timmy Simons,0,203.0,0,6,4,2,6,San Marino
Timo Rahja,0,19.0,0,0,2,0,2,Finland
Timo Werner,4,739.0,0,0,7,6,13,Germany
Timofei Kalachev,0,528.0,0,0,6,4,10,Belarus
Timote Maamaaloa,1,26.0,0,0,1,0,1,Tonga
Timote Moleni,0,87.0,0,0,2,0,2,Tonga
Timothy Batabaire,0,19.0,0,0,1,0,1,Uganda
Timothy Castagne,0,104.0,0,0,2,0,2,Belgium
Timothy Mwitwa,0,68.0,0,0,1,0,1,Zambia
Timothy Weah,1,47.0,0,0,1,1,2,Jamaica
Timur Kapadze,1,245.0,0,0,4,2,6,Malaysia
Tinashe Nengomasha,0,79.0,0,0,0,1,1,Rwanda
Tinol Christie,1,1.0,0,0,1,0,1,New Zealand
Tishan Hanley,0,68.0,0,0,1,0,1,Saint Kitts and Nevis
Tita,0,252.0,0,0,5,0,5,Brazil
Titi Camara,2,615.0,0,0,5,6,11,Guinea
Tito Montaño,0,45.0,0,0,0,1,1,Peru
Titus Buberník,0,168.0,0,0,5,0,5,Czechoslovakia
Titus Elva,0,209.0,0,0,2,1,3,British Virgin Islands
Titus Mulama,1,103.0,0,0,2,0,2,Kenya
Titus Ozon,0,78.0,0,0,0,1,1,Greece
Tivadar Monostori,0,21.0,0,0,1,0,1,Hungary
Tjay De Barr,0,71.0,0,1,0,1,1,Latvia
Tobias Hysén,0,164.0,0,0,2,1,3,San Marino
Toby Alderweireld,1,145.0,0,0,2,2,4,Hungary
Todi Jónsson,0,367.0,0,0,3,4,7,Faroe Islands
Todor Diev,0,240.0,0,0,5,0,5,Bulgaria
Todor Kolev,1,89.0,0,0,1,0,1,Bulgaria
Todor Nedelev,0,198.0,0,1,3,0,3,Bulgaria
Todor Veselinović,3,222.0,0,0,0,4,4,Greece
Togbe Dovi-Akon,0,87.0,0,0,1,0,1,Togo
Tokelo Rantie,0,58.0,0,0,1,2,3,South Africa
Tokhirjon Muminov,1,13.0,0,0,1,0,1,Tajikistan
Tokia Russell,0,34.0,0,0,1,0,1,Bermuda
Tol Kimchi,0,93.0,0,0,0,2,2,Thailand
Tolga Seyhan,0,12.0,0,0,0,1,1,Georgia
Tolutau Vane,0,29.0,0,0,1,0,1,Tonga
Tom Boyd,1,99.0,1,0,2,0,2,Scotland
Tom Finney,2,152.0,0,1,2,0,2,England
Tom Florie,1,45.0,0,0,0,1,1,Belgium
Tom Høgli,0,152.0,0,0,1,1,2,Norway
Tom Lawrence,0,49.0,0,0,0,1,1,Georgia
Tom Lund,0,365.0,0,0,6,2,8,Norway
Tom McColl,3,194.0,0,0,1,3,4,Japan
Tom McCulloch,0,86.0,0,0,0,1,1,Solomon Islands
Tom Rodríguez,0,16.0,0,0,1,0,1,Ecuador
Tom Rogic,2,463.0,0,0,9,0,9,Australia
Tom Sundby,0,164.0,0,0,1,2,3,Norway
Tom Søndergaard,0,92.0,0,0,1,1,2,Denmark
Tom Turesson,1,231.0,0,0,3,1,4,Sweden
Tomas Brolin,4,590.0,0,3,10,2,12,Brazil
Tomas Danilevičius,0,418.0,0,2,6,3,9,Lithuania
Tomas Jun,0,6.0,0,0,0,1,1,Finland
Tomas Ramelis,0,107.0,0,0,0,2,2,Estonia
Tomas Ražanauskas,0,332.0,0,2,2,3,5,Liechtenstein
Tomas Žiukas,0,51.0,0,0,1,0,1,Lithuania
Tomasz Frankowski,0,376.0,0,0,3,4,7,Austria
Tomasz Hajto,0,15.0,0,0,1,0,1,Poland
Tomasz Iwan,0,178.0,0,0,1,2,3,Bulgaria
Tomasz Kędziora,0,50.0,0,0,1,0,1,Poland
Tomasz Kłos,0,96.0,0,0,0,2,2,Latvia
Tomasz Radzinski,1,215.0,0,0,3,1,4,Brazil
Tomasz Wałdoch,0,33.0,0,0,1,0,1,Poland
Tomasz Wieszczycki,0,58.0,0,0,1,0,1,Poland
Tome Faisi,0,77.0,1,0,0,1,1,Solomon Islands
Tome Pačovski,0,8.0,1,0,0,1,1,North Macedonia
Tomer Hemed,0,569.0,0,2,6,7,13,Croatia
Tomi Juric,1,373.0,0,0,6,1,7,Australia
Tomislav Kaloperović,0,42.0,0,1,1,0,1,Yugoslavia
Tomislav Knez,0,75.0,0,0,0,1,1,France
Tomislav Marić,0,70.0,0,0,1,0,1,Croatia
Tommy Carroll,0,44.0,0,1,1,0,1,Republic of Ireland
Tommy Casey,0,22.0,0,0,1,0,1,Northern Ireland
Tommy Coyne,0,6.0,0,0,2,0,2,Republic of Ireland
Tommy Eglington,0,59.0,0,0,1,0,1,Republic of Ireland
Tommy Finney,0,3.0,0,0,0,1,1,Norway
Tommy Gemmell,0,76.0,0,0,1,0,1,Scotland
Tommy Lindholm,0,95.0,0,1,1,1,2,Belgium
Tommy Oar,0,149.0,0,0,0,2,2,Japan
Tommy Ring,0,71.0,0,0,0,1,1,Switzerland
Tommy Semmy,2,112.0,0,0,2,1,3,Papua New Guinea
Tommy Smith,1,101.0,0,0,1,1,2,Fiji
Tommy Taylor,0,303.0,0,0,6,2,8,England
Tommy Troelsen,0,79.0,0,0,1,0,1,Denmark
Tomokazu Myojin,2,123.0,0,0,1,1,2,Japan
Tomás Balcázar,1,280.0,0,0,4,2,6,Mexico
Tomás Fernández,1,57.0,0,0,1,0,1,Cuba
Tomáš Galásek,0,52.0,0,0,1,0,1,Czech Republic
Tomáš Holeš,1,68.0,0,0,0,1,1,Netherlands
Tomáš Hübschman,0,3.0,0,0,0,1,1,Malta
Tomáš Kalas,0,84.0,1,0,1,0,1,England
Tomáš Necid,1,392.0,0,1,3,3,6,San Marino
Tomáš Oravec,0,89.0,0,0,0,1,1,North Macedonia
Tomáš Pekhart,0,142.0,0,0,1,1,2,Czech Republic
Tomáš Pospíchal,1,246.0,0,0,4,0,4,Czechoslovakia
Tomáš Rosický,2,848.0,0,1,8,7,15,Czech Republic
Tomáš Sivok,0,105.0,0,0,1,1,2,Czech Republic
Tomáš Skuhravý,6,681.0,0,1,9,4,13,Czechoslovakia
Tomáš Souček,3,177.0,0,0,0,4,4,Montenegro
Tomáš Řepka,0,65.0,0,0,1,0,1,Czech Republic
Toni Kroos,1,666.0,0,1,7,4,11,Republic of Ireland
Toni Micevski,0,114.0,0,0,1,2,3,Liechtenstein
Toni Polster,1,1353.0,0,5,16,13,29,Austria
Toni Šunjić,0,33.0,0,0,0,1,1,Cyprus
Toninho Cerezo,1,70.0,0,0,1,0,1,Brazil
Tonny van de Linden,0,22.0,0,0,0,2,2,Hungary
Tony Adams,1,41.0,0,0,1,1,2,Yugoslavia
Tony Cascarino,0,836.0,0,0,8,5,13,Republic of Ireland
Tony Dunne,0,85.0,2,0,1,1,2,Republic of Ireland
Tony Galvin,0,44.0,0,0,0,1,1,Luxembourg
Tony Grealish,0,245.0,0,0,5,1,6,Denmark
Tony Henderson,0,17.0,0,0,1,0,1,Australia
Tony Laus,0,131.0,0,0,3,0,3,New Zealand
Tony Lochhead,0,69.0,0,0,1,0,1,New Zealand
Tony Mawejje,0,93.0,0,0,2,0,2,Uganda
Tony Persson,0,89.0,0,0,0,1,1,Portugal
Tony Popovic,1,307.0,0,0,6,0,6,Australia
Tony Senechal,3,73.0,0,0,0,3,3,Vanuatu
Tony Tsabedze,0,83.0,0,0,0,1,1,Djibouti
Tony Vidmar,0,134.0,0,0,2,0,2,Australia
Tony Woodcock,1,485.0,0,0,3,8,11,Northern Ireland
Tony Yeboah,3,155.0,0,0,2,2,4,Egypt
Toon Brusselers,0,80.0,0,0,1,0,1,Netherlands
Topu Barman,1,83.0,0,0,1,0,1,Bangladesh
Tor Egil Johansen,0,229.0,0,0,1,2,3,Norway
Tor Fuglset,0,83.0,0,0,0,1,1,Bulgaria
Torbjörn Jonsson,0,107.0,0,0,3,0,3,Sweden
Torbjörn Nilsson,0,38.0,0,0,0,1,1,Portugal
Tore André Dahlum,0,69.0,0,0,2,0,2,Norway
Tore André Flo,1,585.0,0,0,2,8,10,Finland
Tore Cervin,0,29.0,0,0,1,0,1,Sweden
Tore Keller,1,80.0,0,0,0,1,1,Cuba
Tore Reginiussen,0,4.0,0,0,1,0,1,Norway
Torea,1,90.0,0,0,0,1,1,Australia
Torkil Nielsen,1,61.0,0,0,1,0,1,Faroe Islands
Tornike Okriashvili,1,219.0,0,2,4,3,7,Georgia
Torsten Bunke,0,43.0,0,0,1,0,1,Sweden
Torsten Frings,1,173.0,0,1,3,0,3,Germany
Tosaint Ricketts,0,410.0,0,0,6,1,7,Puerto Rico
Toshio Iwatani,0,78.0,0,0,2,0,2,Japan
Toshiya Fujita,0,81.0,0,0,0,1,1,Singapore
Tostão,3,472.0,0,0,8,5,13,Brazil
Totchtawan Sripan,0,80.0,0,1,1,1,2,Thailand
Toto Tamuz,1,106.0,0,0,1,1,2,Israel
Traianos Dellas,1,105.0,0,0,1,0,1,Greece
Tranquillo Barnetta,1,221.0,0,0,0,4,4,Togo
Travis Nicklaw,0,100.0,1,0,2,0,2,Guam
Trayon Bobb,0,69.0,0,0,0,2,2,El Salvador
Tremain Paul,0,33.0,0,0,0,2,2,Canada
Trent Sainsbury,1,89.0,0,0,2,1,3,Australia
Tressor Moreno,3,130.0,0,2,4,2,6,Colombia
Tresór Toropité,1,53.0,0,0,1,0,1,Central African Republic
Trevin Caesar,0,175.0,0,0,2,0,2,Trinidad and Tobago
Trevor Anderson,2,161.0,0,0,3,0,3,Northern Ireland
Trevor Brooking,1,178.0,0,0,1,3,4,England
Trevor Francis,2,348.0,0,0,4,4,8,England
Trevor Hockey,0,85.0,0,0,1,0,1,Wales
Trevor Lennen,0,90.0,1,0,1,0,1,Mexico
Trevor Peters,0,38.0,0,0,1,0,1,British Virgin Islands
Trifon Ivanov,0,199.0,0,0,2,3,5,Bulgaria
Troy Greenidge,0,90.0,0,0,0,1,1,Antigua and Barbuda
Troy Halpin,0,80.0,0,0,1,0,1,Australia
Tryggvi Guðmundsson,0,336.0,0,0,4,2,6,Liechtenstein
Trésor Mputu,2,339.0,0,0,4,5,9,DR Congo
Trézéguet,1,141.0,0,0,2,0,2,Egypt
Trải Văn Đào,1,20.0,0,0,0,1,1,South Korea
Trần Minh Vương,0,90.0,0,0,0,1,1,United Arab Emirates
Trần Phi Sơn,0,90.0,0,0,0,1,1,Taiwan
Trần Văn Nhung,1,68.0,0,1,0,1,1,Israel
Trần Văn Tổng,1,88.0,0,0,0,2,2,Hong Kong
Tsepo Lekhoana,0,75.0,0,0,0,1,1,Sudan
Tsepo Seturumane,0,119.0,0,0,2,1,3,Sudan
Tshepiso Molwantwa,0,101.0,0,0,3,1,4,Botswana
Tshepo Motlhabankwe,0,88.0,0,0,0,1,1,Malawi
Tshering Dorji,0,250.0,0,1,2,2,4,Sri Lanka
Tshilumba Mukendi,0,53.0,0,0,0,1,1,Cameroon
Tsholola Tshinyama,0,59.0,0,0,1,0,1,DR Congo
Tsoanelo Koetle,0,77.0,0,0,0,1,1,Sudan
Tsukasa Shiotani,1,58.0,0,0,1,0,1,Japan
Tsuneyasu Miyamoto,0,87.0,0,0,0,1,1,India
Tsuyoshi Kitazawa,0,57.0,0,0,1,0,1,Japan
Tsvetan Atanasov,0,29.0,0,0,1,0,1,Bulgaria
Tsvetan Yonchev,0,66.0,0,0,1,0,1,Bulgaria
Tueba Menayane,1,1.0,0,0,0,1,1,Cameroon
Tukamin Bahari,2,179.0,0,0,1,1,2,United Arab Emirates
Tuncay,1,665.0,0,0,6,6,12,Georgia
Tuncay Şanlı,2,121.0,0,0,1,2,3,Turkey
Tuomo Hakala,0,82.0,0,0,0,1,1,Russia
Turbie Terblanche,0,85.0,0,0,1,0,1,Eswatini
Turlough O'Connor,0,86.0,0,1,0,1,1,Czechoslovakia
Turo Flink,0,15.0,0,0,1,0,1,Finland
Tursunali Rustamov,1,112.0,0,0,0,2,2,United Arab Emirates
Tutizama Tanito,0,33.0,0,0,1,0,1,Solomon Islands
Txiki Begiristain,1,317.0,0,1,4,1,5,Malta
Tyio Simon,0,81.0,0,0,1,0,1,Antigua and Barbuda
Tyler Boyd,0,132.0,0,0,2,0,2,United States
Tymerlan Huseynov,0,269.0,0,0,1,4,5,Ukraine
Tyrell Burgess,0,99.0,0,0,2,0,2,Bermuda
Tyrone Loran,1,42.0,0,0,1,0,1,Curaçao
Tyrone Marshall,0,56.0,0,0,2,0,2,Jamaica
Tyrone Mings,0,69.0,0,0,0,1,1,San Marino
Tyrone White,0,55.0,0,0,1,0,1,Barbados
Tyrone de la Bastide,0,78.0,1,0,1,0,1,Guatemala
Témime Lahzami,0,153.0,0,0,3,0,3,Tunisia
Túlio Costa,1,76.0,0,0,1,0,1,Brazil
Túlio Maravilha,1,111.0,0,0,1,1,2,Brazil
Tümer Metin,1,354.0,0,0,2,4,6,Liechtenstein
Ubaldo Cruche,0,35.0,0,0,0,1,1,Chile
Uche Okechukwu,1,18.0,0,0,1,0,1,Nigeria
Ul Radike Mateiwai,1,5.0,0,0,0,1,1,Samoa
Uladzimir Makowski,0,113.0,0,0,2,0,2,Belarus
Ulaiasi Mateiwai,1,31.0,0,0,1,0,1,Fiji
Ulaisi Seruvatu,1,43.0,0,0,0,1,1,Tahiti
Ulan Konysbayev,0,55.0,0,0,0,1,1,Turkey
Ulf Eriksson,0,90.0,0,0,0,1,1,Czechoslovakia
Ulf Kirsten,3,879.0,0,0,9,7,16,German DR
Uli Hoeneß,0,133.0,0,1,2,1,3,England
Uli Stielike,0,66.0,0,0,1,0,1,Germany
Ulises Ramos,1,72.0,0,0,1,0,1,Chile
Ulises de la Cruz,0,130.0,0,0,1,3,4,Brazil
Ulrich Kapolongo,0,76.0,0,0,0,1,1,Niger
Ulrich Lepaye,0,81.0,0,0,1,0,1,Congo
Ulrik Laursen,0,27.0,0,0,1,0,1,Denmark
Ulrik le Fevre,0,35.0,0,0,1,0,1,Denmark
Ulugbek Bakayev,3,494.0,0,1,5,3,8,Turkmenistan
Umar Sadiq,1,56.0,0,0,0,1,1,Guinea-Bissau
Umberto Barberis,0,172.0,0,0,2,2,4,German DR
Umut Bulut,0,231.0,0,0,5,1,6,Turkey
Unaloto Feao,1,88.0,0,0,0,1,1,American Samoa
Uni Arge,0,354.0,0,0,5,1,6,Cyprus
Upendran Choy,0,90.0,0,0,1,0,1,Indonesia
Uri Malmilian,0,219.0,0,0,2,1,3,South Korea
Uriel Antuna,4,172.0,0,0,4,1,5,Mexico
Urmas Kirs,0,134.0,1,0,2,0,2,Ukraine
Uston Nawawi,0,220.0,0,0,4,0,4,Indonesia
Uwa Elderson Echiéjilé,2,105.0,0,0,0,2,2,Mali
Uwe Bein,1,88.0,0,0,1,1,2,Germany
Uwe Rahn,0,102.0,0,0,3,0,3,Germany
Uwe Reinders,1,83.0,0,0,1,0,1,Germany
Uwe Seeler,8,850.0,0,0,8,6,14,Argentina
Uwe Zötzsche,0,4.0,0,1,1,0,1,German DR
Uğur Boral,1,22.0,0,0,0,1,1,Germany
V. P. Sathyan,1,172.0,0,1,0,2,2,Lebanon
V. Sundramoorthy,3,274.0,0,0,1,3,4,North Korea
Vaclavs Borduško,0,41.0,0,0,0,2,2,Lithuania
Vadim Boret,0,16.0,0,0,1,0,1,Moldova
Vadim Evseev,0,21.0,0,0,0,1,1,Wales
Vadim Rață,0,9.0,0,0,0,1,1,France
Vadim Vasilyev,0,29.0,0,1,1,1,2,Slovakia
Vaggelis Panakis,0,29.0,0,0,1,0,1,Greece
Vagif Javadov,0,328.0,0,0,3,2,5,Liechtenstein
Vagiz Khidiyatullin,0,54.0,0,0,1,0,1,Russia
Vahagn Minasyan,0,85.0,0,0,0,1,1,Bosnia and Herzegovina
Vahid Amiri,0,61.0,0,0,1,0,1,Iran
Vahid Halilhodžić,0,113.0,0,0,4,0,4,Yugoslavia
Vahid Hashemian,0,186.0,0,0,2,2,4,Qatar
Vahidin Musemić,0,344.0,0,0,5,1,6,France
Vaidotas Šlekys,0,118.0,0,0,2,0,2,Lithuania
Valasine Dalaphone,0,55.0,0,0,1,0,1,Laos
Valdas Ivanauskas,0,293.0,0,0,5,1,6,Ukraine
Valdes Pasolini,0,30.0,0,1,1,0,1,San Marino
Valdet Rama,0,49.0,0,0,1,1,2,Albania
Valdir Pereira,0,11.0,0,0,1,0,1,Brazil
Valdomiro Vaz Franco,1,79.0,0,0,0,1,1,DR Congo
Valentin Belkevich,0,97.0,0,0,2,1,3,Belarus
Valentin Bubukin,2,98.0,0,0,2,0,2,Russia
Valentin Ivanov,3,177.0,0,0,0,3,3,Czechoslovakia
Valentin Kozmich Ivanov,8,588.0,0,0,6,5,11,Poland
Valentin Mihăilă,0,50.0,0,0,1,0,1,Romania
Valentin Stocker,0,270.0,0,0,3,1,4,Switzerland
Valentino Lazaro,0,80.0,0,0,1,1,2,North Macedonia
Valentinos Sielis,0,87.0,0,0,1,0,1,Cyprus
Valentín Mendoza,0,70.0,1,0,0,1,1,Paraguay
Valeri Aleksanyan,0,43.0,1,0,1,0,1,Republic of Ireland
Valeri Berezovsky,0,12.0,0,0,1,0,1,Kyrgyzstan
Valeri Bojinov,0,58.0,0,0,1,0,1,Bulgaria
Valeri Broshin,0,20.0,0,0,0,1,1,Vietnam
Valeri Domovchiyski,0,90.0,0,0,1,0,1,Bulgaria
Valeri Gulyan,0,53.0,0,0,1,0,1,Turkmenistan
Valeri Qazaishvili,0,245.0,0,0,4,1,5,Georgia
Valeri Yablochkin,0,49.0,0,0,1,0,1,Kazakhstan
Valerian Gvilia,0,38.0,0,0,1,1,2,Austria
Valeriano López,2,137.0,0,0,0,2,2,Chile
Valerică Găman,0,90.0,0,0,1,0,1,Romania
Valerio Nasema,2,118.0,0,0,1,1,2,Fiji
Valerio Nawatu,0,2.0,0,0,1,0,1,Fiji
Valeriu Andronic,0,90.0,0,0,1,0,1,Moldova
Valeriu Călinoiu,0,52.0,0,0,0,1,1,Bulgaria
Valeriu Pogorelov,0,76.0,0,0,1,0,1,Moldova
Valeriy Porkujan,4,247.0,0,0,0,4,4,Chile
Valery Karpin,1,571.0,0,2,5,5,10,Russia
Valery Kechinov,0,73.0,0,0,2,0,2,Russia
Valery Kichin,0,77.0,1,0,2,0,2,Bangladesh
Valery Maslov,0,14.0,0,0,0,1,1,Finland
Valery Ondo,0,82.0,0,0,1,0,1,Gabon
Valery Voronin,3,186.0,0,0,3,1,4,Russia
Valon Behrami,0,86.0,0,0,1,0,1,Switzerland
Valon Berisha,0,110.0,0,1,0,3,3,Finland
Valter Birsa,1,297.0,0,2,4,2,6,Slovenia
Valyantsin Byalkevich,0,147.0,0,0,0,3,3,Sweden
Valērijs Šabala,0,385.0,0,1,4,3,7,Latvia
Vampeta,0,95.0,0,0,2,0,2,Brazil
Van-Dave Harmon,1,45.0,0,0,1,0,1,Liberia
Vangelis Pavlidis,0,108.0,0,0,2,0,2,Greece
Vaniel Sirin,0,46.0,0,0,0,1,1,United States
Vanče Šikov,0,146.0,0,0,0,2,2,Andorra
Vančo Micevski,0,90.0,0,0,0,1,1,Liechtenstein
Vančo Trajanov,0,36.0,0,0,0,2,2,Azerbaijan
Varazdat Haroyan,0,161.0,0,0,2,0,2,Armenia
Vasil Bozhikov,0,95.0,0,0,1,1,2,Kosovo
Vasil Mitkov,0,44.0,0,0,1,0,1,Bulgaria
Vasili Baranov,0,30.0,0,0,1,0,1,Belarus
Vasili Berezutski,1,164.0,0,0,3,1,4,Russia
Vasili Kulkov,0,265.0,0,0,1,4,5,Luxembourg
Vasilis Botinos,0,162.0,0,0,2,1,3,Portugal
Vasilis Dimitriadis,0,30.0,0,1,1,0,1,Greece
Vasilis Torosidis,2,419.0,1,0,5,4,9,Luxembourg
Vassilios Tsiartas,0,272.0,0,1,3,2,5,Greece
Vassilis Karapialis,0,40.0,0,0,1,0,1,Greece
Vassos Melanarkitis,0,18.0,0,0,1,0,1,Cyprus
Vasyl Rats,2,178.0,0,0,0,3,3,France
Vato Arveladze,0,76.0,0,1,1,0,1,Georgia
Vaughan Coveny,10,877.0,0,1,21,2,23,New Zealand
Vavá,5,379.0,0,0,5,4,9,Brazil
Veaceslav Sofroni,0,90.0,0,0,0,1,1,Latvia
Vedad Ibišević,1,927.0,0,0,9,9,18,Greece
Vedat Muriqi,0,327.0,0,2,4,3,7,Bulgaria
Vedran Ćorluka,0,153.0,1,0,1,2,3,Turkey
Vegard Forren,0,57.0,0,0,0,1,1,Bulgaria
Veigar Páll Gunnarsson,0,100.0,0,0,2,0,2,Iceland
Veli Lampi,0,65.0,1,0,1,0,1,Russia
Velibor Vasović,0,112.0,0,0,2,0,2,Yugoslavia
Velizar Dimitrov,0,6.0,0,0,1,0,1,Bulgaria
Veliče Šumulikoski,0,90.0,0,0,1,0,1,North Macedonia
Venancio García,0,13.0,0,0,1,0,1,Spain
Venancio Ramos,0,150.0,0,0,2,0,2,Uruguay
Ventsislav Hristov,0,87.0,0,0,0,1,1,Azerbaijan
Veresa Toma,7,213.0,0,0,7,1,8,Fiji
Verner Lička,0,67.0,0,0,1,0,1,Czechoslovakia
Vernon De Marco,0,72.0,0,0,0,1,1,Malta
Vernon Sargeant,0,66.0,0,0,2,0,2,Saint Kitts and Nevis
Viacheslav Knizaev,0,90.0,0,0,0,2,2,Turkmenistan
Viačeslavas Sukristovas,0,25.0,0,0,1,0,1,Lithuania
Vic Bozanic,2,180.0,0,0,2,0,2,Australia
Vicente Aguirre,3,221.0,0,0,3,0,3,Argentina
Vicente Flores,0,88.0,0,0,1,0,1,Venezuela
Vicente Guillot,0,104.0,0,0,3,0,3,Spain
Vicente Matías Vuoso,0,149.0,0,0,0,3,3,Canada
Vicente Rodríguez,0,138.0,0,0,1,2,3,Paraguay
Vicente Sánchez,4,302.0,0,0,1,4,5,Argentina
Vicente de la Mata,2,345.0,0,0,5,0,5,Argentina
Vicente del Bosque,0,10.0,0,0,1,0,1,Spain
Victor Agali,0,184.0,0,0,4,0,4,Nigeria
Victor Covilhã,0,85.0,0,0,1,0,1,Angola
Victor Diagne,0,89.0,0,0,1,0,1,Senegal
Victor Ikpeba,1,176.0,0,0,3,0,3,Nigeria
Victor Karpenko,0,112.0,0,0,1,2,3,Uzbekistan
Victor Lemberechts,0,40.0,0,0,0,1,1,Sweden
Victor Lindelöf,0,81.0,0,0,1,1,2,Sweden
Victor Manuel Azucar,0,144.0,0,0,2,0,2,El Salvador
Victor Mees,0,97.0,0,0,3,0,3,Belgium
Victor Moreland,0,50.0,0,1,1,0,1,Northern Ireland
Victor Moses,3,461.0,0,5,6,2,8,Ethiopia
Victor Núñez,0,165.0,0,0,1,1,2,Grenada
Victor Obinna,2,417.0,0,1,7,0,7,Nigeria
Victor Osimhen,2,91.0,0,1,1,3,4,Cape Verde
Victor Pițurcă,0,40.0,0,0,2,0,2,Romania
Victor Pálsson,0,77.0,0,0,0,1,1,Liechtenstein
Victor Wanyama,0,74.0,0,0,1,0,1,Kenya
Victorien Adebayor,2,230.0,0,0,3,2,5,Djibouti
Vidadi Rzayev,0,28.0,0,0,1,0,1,Azerbaijan
Vidal Sanabria,1,81.0,0,0,1,0,1,Paraguay
Vidar Davidsen,0,88.0,0,0,1,0,1,Norway
Vidar Riseth,0,39.0,0,0,1,0,1,Norway
Viera Ellong,0,24.0,0,0,0,1,1,Madagascar
Vikash Dhorasoo,0,44.0,0,0,1,0,1,France
Viktor Claesson,1,342.0,0,0,5,1,6,Sweden
Viktor Fayzulin,0,147.0,0,0,1,2,3,Russia
Viktor Kolotov,0,376.0,0,2,6,2,8,Cyprus
Viktor Onopko,0,332.0,0,0,3,3,6,Russia
Viktor Pasulko,1,73.0,0,0,0,1,1,England
Viktor Pečovský,0,77.0,0,0,0,1,1,Bosnia and Herzegovina
Viktor Ponedelnik,6,542.0,0,0,6,4,10,Czechoslovakia
Viktor Skrypnyk,0,24.0,0,0,0,1,1,Slovenia
Viktor Tsyhankov,0,93.0,0,0,2,1,3,Luxembourg
Viktor Zubarev,0,294.0,0,0,1,3,4,Pakistan
Viliami Vaitaki,1,61.0,0,0,1,0,1,Tonga
Viljormur Davidsen,0,40.0,0,1,0,1,1,Romania
Vilmos Kohut,1,13.0,0,0,1,0,1,Hungary
Vilmos Sebők,0,304.0,0,3,6,0,6,Hungary
Vilmos Vanczák,0,45.0,1,0,1,2,3,Hungary
Vincent Aboubakar,5,982.0,0,5,13,4,17,Niger
Vincent Candela,0,54.0,0,0,1,0,1,France
Vincent Casimir,0,213.0,0,0,0,3,3,Bahamas
Vincent Guérin,0,95.0,0,0,2,0,2,France
Vincent Janssen,0,148.0,0,1,2,0,2,Netherlands
Vincent John,0,11.0,0,0,1,0,1,Saint Vincent and the Grenadines
Vincent Kompany,0,162.0,0,0,2,1,3,Belgium
Vincent Kwarula,0,58.0,0,0,1,0,1,Kenya
Vincent Laban,0,148.0,0,0,1,2,3,Albania
Vincent Magro,0,79.0,0,0,1,0,1,Malta
Vincent Mutale,1,100.0,0,0,2,0,2,Zambia
Vincent Simon,0,74.0,1,0,1,1,2,Solomon Islands
Vincenzo Iaquinta,2,162.0,0,1,4,0,4,Italy
Vinceroy Nelson,1,42.0,0,0,1,0,1,Saint Kitts and Nevis
Vinícius Júnior,1,52.0,0,0,2,0,2,Brazil
Viorel Frunză,0,272.0,0,0,3,3,6,Moldova
Viorel Mateianu,0,106.0,0,1,2,0,2,Romania
Viorel Moldovan,3,674.0,0,0,7,9,16,Romania
Virgil van Dijk,0,95.0,0,0,2,0,2,Netherlands
Virgilio Ferreira,2,87.0,0,0,0,2,2,Peru
Virgilio Sille,1,77.0,0,0,0,2,2,Cuba
Virginijus Baltušnikas,0,110.0,0,0,2,0,2,Lithuania
Virginio De Paoli,0,43.0,0,0,1,0,1,Italy
Visar Musliu,0,36.0,0,0,1,0,1,North Macedonia
Visay Phaphouvanin,0,185.0,0,0,3,1,4,Laos
Vita Lutonadio,0,88.0,0,0,0,1,1,Morocco
Vital Bulyga,0,214.0,0,0,3,1,4,Belarus
Vitali Culibaba,0,77.0,1,0,0,1,1,Moldova
Vitali Kutuzov,0,348.0,0,0,3,5,8,Belarus
Vitali Rodionov,0,177.0,0,0,1,2,3,Andorra
Vitali Sparyshev,0,55.0,0,0,1,0,1,Kazakhstan
Vitali Yevstigneyev,0,77.0,0,0,0,1,1,Azerbaijan
Vitalij Lux,3,197.0,0,0,4,1,5,Kyrgyzstan
Vitalis Takawira,0,293.0,0,2,3,2,5,Madagascar
Vitaliy Denisov,0,42.0,0,0,0,1,1,Singapore
Vitaliy Khmelnytskyi,1,110.0,0,0,0,2,2,Turkey
Vitaliy Kosovskyi,0,35.0,0,0,1,1,2,Ukraine
Vitaliy Mandzyuk,0,80.0,0,0,0,1,1,San Marino
Vitaliy Shevchenko,0,133.0,0,0,1,1,2,Cyprus
Vitaly Daraselia,1,13.0,0,0,1,0,1,Russia
Vitaly Lisakovich,1,157.0,0,2,3,0,3,Belarus
Vitolo,0,223.0,0,0,3,1,4,Spain
Vitoon Kijmongkolsak,0,90.0,0,0,1,0,1,Thailand
Vitālijs Astafjevs,0,400.0,0,0,4,4,8,Northern Ireland
Viv Anderson,0,143.0,0,0,1,1,2,Turkey
Vivian Wickham,2,64.0,0,0,0,2,2,Vanuatu
Viðar Örn Kjartansson,0,80.0,0,0,0,1,1,Andorra
Vladan Lukić,0,18.0,0,0,0,1,1,Austria
Vladas Douksas,3,137.0,0,0,0,3,3,Bolivia
Vladica Kovačević,0,15.0,0,0,1,0,1,Yugoslavia
Vladimir Ambros,0,89.0,0,0,1,0,1,Moldova
Vladimir Barkaya,2,146.0,0,0,2,0,2,Russia
Vladimir Bayramov,1,67.0,0,0,2,0,2,Turkmenistan
Vladimir Beschastnykh,3,865.0,0,2,9,9,18,Greece
Vladimir Burduli,0,85.0,0,0,0,1,1,Albania
Vladimir Bystrov,0,84.0,0,0,0,2,2,North Macedonia
Vladimir Chertkov,1,50.0,0,0,1,1,2,Maldives
Vladimir Dvalishvili,0,79.0,0,0,0,2,2,Montenegro
Vladimir Edouard,0,137.0,0,0,1,2,3,Haiti
Vladimir Farrell,1,48.0,0,0,1,0,1,Montserrat
Vladimir Fedotov,0,145.0,0,0,2,1,3,Russia
Vladimir Gaidamașciuc,0,22.0,0,0,0,1,1,Northern Ireland
Vladimir Gregorio,1,66.0,0,0,0,1,1,Montserrat
Vladimir Jugović,1,146.0,0,0,0,3,3,Faroe Islands
Vladimir Kokol,0,90.0,0,0,1,0,1,Slovenia
Vladimir Koman,0,322.0,0,0,3,2,5,Hungary
Vladimir Korytko,0,150.0,0,0,2,0,2,Belarus
Vladimir Kragić,0,121.0,0,0,1,1,2,Yugoslavia
Vladimir Loginov,0,120.0,0,0,1,2,3,Iraq
Vladimir Maminov,0,165.0,0,2,2,1,3,Uzbekistan
Vladimir Muntyan,2,199.0,0,0,2,1,3,Russia
Vladimir Onishchenko,0,82.0,0,0,2,0,2,Russia
Vladimir Petrović,1,318.0,0,2,1,4,5,Romania
Vladimir Shishelov,1,128.0,0,0,2,0,2,Uzbekistan
Vladimir Soria,0,28.0,0,0,1,0,1,Bolivia
Vladimir Todorov,0,61.0,0,0,0,1,1,Hungary
Vladimir Veremeyev,0,81.0,0,0,1,0,1,Russia
Vladimir Voskoboinikov,0,7.0,0,0,0,1,1,Turkey
Vladimiro Schettina,0,22.0,0,0,0,1,1,Chile
Vladimirs Babičevs,0,67.0,0,0,0,2,2,Liechtenstein
Vladimirs Kamešs,0,69.0,0,0,1,1,2,Latvia
Vladimirs Koļesņičenko,0,89.0,0,0,1,0,1,Latvia
Vladimír Darida,0,289.0,0,2,1,4,5,Latvia
Vladimír Hagara,0,166.0,0,0,2,1,3,Denmark
Vladimír Hruška,0,21.0,0,0,1,0,1,Czechoslovakia
Vladimír Janočko,0,120.0,0,0,1,1,2,Slovakia
Vladimír Labant,0,92.0,0,1,1,1,2,Slovakia
Vladimír Táborský,0,81.0,0,0,0,1,1,Wales
Vladimír Weiss,1,124.0,0,0,1,4,5,Armenia
Vladimír Šmicer,9,1089.0,0,0,4,16,20,Russia
Vladis-Emmerson Illoy-Ayyet,0,43.0,0,0,1,0,1,Congo
Vladislao Cap,0,69.0,0,0,1,0,1,Argentina
Vladislav Bogićević,1,48.0,0,0,1,1,2,Yugoslavia
Vladislav Lauda,0,62.0,0,0,0,1,1,Germany
Vladislav Radimov,0,8.0,0,0,1,0,1,Russia
Vladislavs Gutkovskis,0,160.0,0,1,2,1,3,Latvia
Vladyslav Vashchuk,0,59.0,0,0,1,0,1,Ukraine
Vlastimil Bubník,0,202.0,0,0,2,2,4,Czechoslovakia
Vlastimil Kopecký,1,25.0,0,0,0,1,1,Brazil
Vlatko Grozdanoski,0,25.0,0,0,1,1,2,North Macedonia
Vlatko Stojanovski,0,90.0,0,0,0,1,1,Austria
Vojin Lazarević,0,56.0,0,0,1,0,1,Yugoslavia
Vojislav Melić,1,82.0,0,0,0,1,1,Colombia
Vojtech Masný,0,47.0,0,0,0,1,1,Republic of Ireland
Vokhid Shodiev,1,71.0,0,0,1,0,1,Uzbekistan
Volkan Yayim,0,81.0,0,0,1,0,1,Turkey
Volkan Şen,1,62.0,0,0,1,1,2,Turkey
Volodymyr Bezsonov,1,137.0,0,0,2,0,2,Russia
Volodymyr Muntyan,0,43.0,0,0,1,0,1,Russia
Volodymyr Onyshchenko,2,142.0,0,0,2,0,2,Russia
Volodymyr Yezerskiy,0,20.0,0,0,0,1,1,Faroe Islands
Voulani Ely,0,44.0,0,0,0,1,1,Ethiopia
Vratislav Greško,0,48.0,0,0,1,0,1,Slovakia
Vratislav Lokvenc,0,611.0,0,0,7,2,9,Czech Republic
Vujadin Stanojković,1,5.0,0,0,0,1,1,Cyprus
Vurlon Mills,0,110.0,0,0,2,0,2,Guyana
Vyacheslav Amin,0,47.0,0,0,0,1,1,Syria
Vyacheslav Hleb,0,90.0,0,0,0,1,1,Andorra
Vyacheslav Lychkin,0,113.0,0,0,1,1,2,Hungary
Vyacheslav Sukristov,0,64.0,0,0,0,1,1,Slovenia
Vykintas Slivka,0,87.0,0,0,1,1,2,Lithuania
Vytautas Andriuškevičius,0,28.0,0,0,1,0,1,Lithuania
Václav Daněk,0,200.0,0,0,5,0,5,Czechoslovakia
Václav Hovorka,2,171.0,0,0,0,2,2,Argentina
Václav Kadlec,0,163.0,0,0,1,2,3,Liechtenstein
Václav Mašek,1,67.0,0,0,2,0,2,Czechoslovakia
Václav Němeček,0,241.0,0,1,3,2,5,Czechoslovakia
Václav Pilař,2,301.0,0,0,3,2,5,Czech Republic
Václav Svěrkoš,0,208.0,0,0,2,1,3,Switzerland
Vágner Love,1,104.0,0,0,1,1,2,Chile
Víctor Aguayo,4,138.0,0,0,1,3,4,Ecuador
Víctor Aristizábal,2,625.0,0,3,8,4,12,Colombia
Víctor Artega,1,35.0,0,0,1,0,1,Ecuador
Víctor Ayala,1,71.0,0,0,0,1,1,Colombia
Víctor Benítez,0,78.0,1,0,1,0,1,Argentina
Víctor Bernárdez,0,62.0,0,0,0,1,1,Cuba
Víctor Bielich,0,35.0,0,0,1,0,1,Peru
Víctor Bonilla,3,196.0,0,0,1,3,4,Uruguay
Víctor Celestino Algañaraz,1,57.0,0,0,1,0,1,Bolivia
Víctor Cuesta,1,32.0,0,0,1,0,1,Argentina
Víctor Cáceres,0,55.0,0,0,0,1,1,Chile
Víctor Diogo,0,80.0,0,0,1,0,1,Uruguay
Víctor Espárrago,1,117.0,0,0,0,1,1,Russia
Víctor Guaglianone,1,17.0,0,0,0,1,1,Bolivia
Víctor Muñoz,0,60.0,0,0,0,1,1,Republic of Ireland
Víctor Pacheco,0,48.0,0,0,2,0,2,Colombia
Víctor Pedraza,3,197.0,0,0,0,3,3,Colombia
Víctor Rangel,1,52.0,0,0,1,0,1,Mexico
Víctor René Mendieta Ocampo,1,271.0,0,3,3,2,5,Panama
Víctor Rogelio Ramos,0,50.0,0,0,1,0,1,Argentina
Víctor Ruiz,0,250.0,0,2,2,2,4,Mexico
Víctor Turcios,0,6.0,0,0,1,0,1,El Salvador
Víctor Ugarte,5,475.0,0,3,7,2,9,Bolivia
Víctor Velásquez,0,61.0,0,0,2,0,2,El Salvador
Víctor Zegarra,0,37.0,0,0,1,0,1,Peru
Víctor Ábrego,0,84.0,0,0,1,0,1,Bolivia
Vítor Baptista,0,96.0,0,0,2,0,2,Portugal
Vítor Baía,0,44.0,1,0,1,0,1,Republic of Ireland
Vítor Paneira,0,163.0,0,1,3,0,3,Portugal
Vítor Silva,0,10.0,0,0,1,0,1,Portugal
Vüqar Nadirov,0,167.0,0,0,1,2,3,Kazakhstan
Vīts Rimkus,0,384.0,0,0,3,4,7,Portugal
Vũ Văn Thanh,1,74.0,0,0,1,0,1,Vietnam
Wael Gomaa,0,23.0,1,0,1,0,1,Ghana
Wael Nazha,1,125.0,0,0,1,1,2,Hong Kong
Wagdan Mahmoud Shadli,1,170.0,0,0,1,2,3,Bahrain
Wagner Lopes,2,211.0,0,1,1,4,5,Uzbekistan
Wahbi Khazri,8,718.0,0,4,7,6,13,Tunisia
Wahyt Orazsähedow,0,96.0,0,0,1,1,2,Sri Lanka
Wail Al Habashi,1,81.0,0,0,1,0,1,Kuwait
Waisake Sabutu,2,178.0,0,0,2,1,3,Fiji
Waldemar Sobota,0,34.0,0,0,0,1,1,San Marino
Waldemar Victorino,0,246.0,0,2,2,2,4,Ecuador
Waldir Guerra,0,87.0,0,0,1,0,1,El Salvador
Waldir Sáenz,1,87.0,0,0,0,1,1,Honduras
Waldo Ponce,0,36.0,0,0,1,1,2,Colombia
Waleed Ali,0,132.0,0,0,1,1,2,Kuwait
Waleed Bakhit Maayof,0,47.0,0,0,1,0,1,Qatar
Waleed Hamzah,0,213.0,0,0,1,3,4,Oman
Waleed Jassem,0,155.0,0,0,2,0,2,Qatar
Waleed Salim Al-Lami,1,28.0,0,0,1,0,1,Iraq
Walford Vaughns,0,88.0,0,0,1,0,1,Costa Rica
Walid Abbas,2,248.0,3,0,1,2,3,United Arab Emirates
Walid Abu Al-Sel,4,242.0,0,1,1,4,5,Kuwait
Walid Al-Nasser,1,124.0,0,0,1,1,2,Syria
Walid Badir,1,277.0,0,0,3,1,4,Cyprus
Walid Salah Abdel Latif,0,90.0,0,0,1,0,1,Egypt
Walieldin Khedr,1,70.0,0,1,0,1,1,Nigeria
Walker Zimmerman,0,37.0,0,0,1,0,1,United States
Walmer Martinez,1,175.0,0,0,1,1,2,El Salvador
Walt Schmotolocha,0,49.0,0,0,1,0,1,United States
Walter Ayoví,0,130.0,0,0,3,0,3,Ecuador
Walter Bahr,1,16.0,0,0,1,0,1,United States
Walter Bakouma,0,131.0,0,0,2,0,2,Congo
Walter Baseggio,0,64.0,0,0,1,0,1,Belgium
Walter Boyd,1,377.0,0,0,3,3,6,Honduras
Walter Casagrande,0,82.0,0,0,0,2,2,Bolivia
Walter Centeno,9,722.0,0,2,10,5,15,Costa Rica
Walter Haummer,0,79.0,0,0,1,0,1,Austria
Walter Horak,0,40.0,0,0,0,1,1,France
Walter Julián Martínez,3,135.0,0,1,2,2,4,Honduras
Walter Kelsch,0,70.0,0,0,1,0,1,Germany
Walter Koleznik,0,38.0,0,0,0,1,1,Republic of Ireland
Walter Morel,3,202.0,0,0,0,3,3,Chile
Walter Pearson,0,85.0,0,0,1,0,1,Costa Rica
Walter Samuel,0,199.0,1,0,3,0,3,Peru
Walter Schachner,3,669.0,0,0,11,7,18,Austria
Wamidh Munir,0,90.0,0,0,0,1,1,Jordan
Wan Chi Keung,0,205.0,0,0,2,2,4,Hong Kong
Wandel Gross,0,89.0,0,0,1,0,1,Aruba
Wang Baoshan,0,74.0,0,0,1,1,2,China PR
Wang Dong,0,141.0,0,0,0,2,2,Malaysia
Wang Huiliang,0,60.0,0,0,1,0,1,China PR
Wang Jilian,1,58.0,0,0,1,0,1,China PR
Wang Lu,0,75.0,0,0,1,0,1,China PR
Wang Rui,0,37.0,0,0,0,1,1,Brunei
Wang Yongpo,0,147.0,0,0,2,0,2,China PR
Ward Al Salama,1,23.0,0,0,1,0,1,Syria
Waren Waiwai,1,82.0,0,0,0,1,1,Cook Islands
Warren Archibald,0,360.0,0,0,0,4,4,Haiti
Warren Feeney,0,229.0,0,0,4,0,4,Northern Ireland
Warren Granados,1,64.0,0,0,1,0,1,Costa Rica
Warren Spink,0,25.0,0,0,1,0,1,Australia
Warsama Hassan,1,90.0,0,0,1,0,1,Djibouti
Wartan Ghazarian,3,130.0,0,0,0,4,4,Pakistan
Waseem Al-Bzour,0,33.0,0,0,0,1,1,Turkmenistan
Washington,1,53.0,0,0,1,0,1,Brazil
Washington Muñoz,0,258.0,0,0,2,3,5,Colombia
Washington Oliveira,0,5.0,0,0,0,1,1,Venezuela
Washington Puente,2,174.0,0,0,0,4,4,Ecuador
Washington Villacreses,0,64.0,0,0,0,1,1,Chile
Wasieu Sounmonu,0,123.0,0,0,2,0,2,Sierra Leone
Waskito Kaihun,1,12.0,0,0,0,1,1,Hong Kong
Wason Rentería,0,88.0,0,0,1,0,1,Colombia
Wataru Endo,0,57.0,0,0,1,0,1,Japan
Wayne Dyer,1,83.0,0,0,1,0,1,Montserrat
Wayne Rooney,6,1770.0,0,6,18,19,37,North Macedonia
Webster Chikabala,2,131.0,0,0,0,2,2,Cameroon
Weerarathne Kassun,1,83.0,0,0,0,1,1,Pakistan
Wellington Sánchez,1,94.0,0,0,0,2,2,Paraguay
Wen Chih-hao,1,167.0,0,0,1,1,2,Iraq
Wensley Christoph,2,209.0,0,0,1,4,5,Montserrat
Werner Heine,0,12.0,0,0,0,1,1,Hungary
Werner Krämer,0,77.0,0,0,0,2,2,Sweden
Werner Otto,0,30.0,0,0,0,1,1,Norway
Werner Peter,0,6.0,0,0,1,0,1,German DR
Wes Hoolahan,1,104.0,0,0,2,0,2,Republic of Ireland
Wes Morgan,0,52.0,1,0,0,1,1,Jamaica
Wesam Rizik,1,95.0,0,1,0,2,2,Bahrain
Wesley Charles,0,114.0,0,0,2,0,2,Saint Vincent and the Grenadines
Wesley Marquette,0,52.0,0,0,1,1,2,Tanzania
Wesley Sneijder,9,1112.0,0,0,16,5,21,Netherlands
Wesley Sonck,1,721.0,0,1,11,4,15,San Marino
Wesley Waiwai,0,68.0,0,0,0,1,1,Fiji
Weston McKennie,0,127.0,0,0,4,0,4,United States
Whayne Wilson,0,40.0,0,1,1,0,1,Costa Rica
Widlin Calixte,0,19.0,0,2,2,0,2,Turks and Caicos Islands
Widodo Cahyono Putro,2,225.0,0,0,2,3,5,Indonesia
Wietse Veenstra,0,35.0,0,0,1,0,1,Netherlands
Wilberforce Mfum,5,450.0,0,0,4,2,6,Ghana
Wilbur Cush,1,49.0,0,0,1,1,2,Northern Ireland
Wilde-Donald Guerrier,1,163.0,0,0,2,1,3,Curaçao
Wilf Mannion,1,51.0,0,0,0,1,1,Chile
Wilfred Bouma,1,46.0,0,0,1,1,2,Netherlands
Wilfred Moke,0,77.0,1,0,0,1,1,DR Congo
Wilfred de Lanoy,0,54.0,0,0,0,2,2,Guatemala
Wilfredo Alvarado,0,131.0,0,0,2,0,2,Venezuela
Wilfredo Camacho,0,272.0,0,0,4,1,5,Uruguay
Wilfredo Iraheta Sanabria,0,68.0,0,0,1,0,1,El Salvador
Wilfried Bony,7,604.0,0,1,6,4,10,Ivory Coast
Wilfried Kanon,1,68.0,0,0,0,1,1,DR Congo
Wilfried Puis,0,253.0,0,1,3,2,5,Israel
Wilfried Urbain Elvis Endzanga,0,147.0,0,0,2,0,2,Congo
Wilfried Van Moer,2,173.0,0,0,4,1,5,Belgium
Wilfried Zaha,2,160.0,0,0,0,2,2,Namibia
Wilhelm Hahnemann,1,8.0,0,0,1,0,1,Germany
Wilhelm Kreuz,0,237.0,0,0,4,1,5,Cyprus
Wilkins Lauru,2,128.0,0,0,0,2,2,Fiji
Wilko Risser,0,83.0,0,0,3,0,3,Namibia
Will Johnson,0,208.0,0,0,2,1,3,Canada
Willi Lippens,0,26.0,0,0,1,0,1,Netherlands
Willi Orbán,0,166.0,0,0,1,3,4,Azerbaijan
Willi Wigold,0,12.0,0,0,0,1,1,Luxembourg
William Antonio Torres,1,36.0,0,0,0,1,1,Anguilla
William Campbell,0,76.0,0,0,1,0,1,Northern Ireland
William Carvalho,0,260.0,0,0,2,2,4,Portugal
William Chiroque,1,41.0,0,0,1,0,1,Peru
William Gallas,0,155.0,0,0,2,0,2,France
William Jebor,0,146.0,0,1,1,3,4,Liberia
William Kvist,0,45.0,0,0,0,1,1,Italy
William Martínez,0,88.0,0,0,1,0,1,Uruguay
William N'Gounou,1,9.0,0,0,1,0,1,Niger
William Ouma,0,377.0,0,0,4,2,6,Kenya
William Quirós,0,228.0,0,0,3,0,3,Costa Rica
William Ramallo,0,53.0,0,0,1,0,1,Bolivia
William Renderos Iraheta,0,132.0,0,0,3,0,3,El Salvador
William Sango,0,37.0,0,0,0,1,1,Niger
William Scheppel,0,16.0,1,0,1,0,1,Mexico
William Sunsing,0,86.0,0,0,0,2,2,Jamaica
William Torres,0,160.0,0,0,2,0,2,El Salvador
William Troost-Ekong,3,226.0,1,1,3,1,4,Nigeria
William Waddell,0,36.0,0,1,0,2,2,Northern Ireland
Willian,0,231.0,0,0,3,2,5,Brazil
Willie August Marango,1,6.0,0,0,0,1,1,Fiji
Willie Henderson,0,70.0,0,0,1,0,1,Scotland
Willie Irvine,0,134.0,0,0,0,2,2,Spain
Willie Klutse,1,145.0,0,0,2,0,2,Ghana
Willie Morgan,0,83.0,0,0,0,1,1,Denmark
Willie Ormond,0,89.0,0,0,1,0,1,Scotland
Willie Phiri,0,87.0,0,0,2,0,2,Zambia
Willie Rutherford,1,57.0,0,0,0,1,1,Zimbabwe
Willie Vassallo,0,66.0,0,0,1,0,1,Malta
Willington Ortiz,0,354.0,0,0,3,4,7,Colombia
Willy Brokamp,0,282.0,0,0,5,0,5,Netherlands
Willy Jäggi,1,158.0,0,0,0,2,2,Yugoslavia
Willy Roy,0,139.0,0,0,1,2,3,Canada
Willy Stephanus,0,103.0,0,0,1,1,2,Gambia
Willy Tröger,0,61.0,0,0,1,0,1,German DR
Willy van de Kerkhof,2,420.0,0,0,0,6,6,Yugoslavia
Willy van der Kuijlen,0,192.0,0,0,4,0,4,Netherlands
Wilmar Cabrera,0,78.0,0,0,2,0,2,Uruguay
Wilmer Cabrera,1,130.0,0,1,2,0,2,Colombia
Wilmer López,1,113.0,0,1,1,1,2,Costa Rica
Wilmer Velásquez,3,213.0,0,0,3,1,4,Saint Vincent and the Grenadines
Wilson Chevalier,0,11.0,0,0,1,0,1,Haiti
Wilson Gaspar,0,31.0,0,0,0,1,1,Gambia
Wilson Nieves,0,88.0,0,0,0,1,1,Paraguay
Wilson Oruma,1,94.0,0,0,2,0,2,Nigeria
Wilson Palacios,0,165.0,0,0,2,1,3,Honduras
Wilson Pérez,0,76.0,0,0,1,0,1,Colombia
Wim Jansen,0,22.0,0,0,1,0,1,Netherlands
Wim Jonk,4,414.0,0,1,4,5,9,San Marino
Wim Kieft,2,387.0,0,0,5,2,7,Netherlands
Wim Rijsbergen,0,17.0,0,0,1,0,1,Netherlands
Wim Suurbier,0,220.0,0,0,1,2,3,Hungary
Wim van Hanegem,0,161.0,0,0,4,0,4,Netherlands
Windsor del Llano,0,84.0,1,0,0,1,1,Bolivia
Winston Anglin,0,65.0,0,0,0,1,1,Trinidad and Tobago
Winston Kalengo,0,109.0,0,0,1,1,2,Sudan
Winston Parks,1,86.0,0,0,1,0,1,Costa Rica
Winston Reid,1,90.0,0,0,1,0,1,New Zealand
Winston Roberts,0,39.0,0,0,1,0,1,Antigua and Barbuda
Winston Trott,0,34.0,0,0,0,1,1,United States
Wisam El Abdy,0,78.0,0,0,0,1,1,Botswana
Wisdom Mumba Chansa,0,4.0,0,0,1,0,1,Zambia
Wissam Ben Yedder,0,120.0,0,0,1,1,2,Andorra
Wissem Ben Yahia,0,21.0,0,1,1,0,1,Tunisia
Witson Nyirenda,0,10.0,0,0,1,0,1,Zambia
Witthaya Laohakul,2,141.0,0,0,1,1,2,Malaysia
Wladimir Baýramow,2,170.0,0,0,4,0,4,Turkmenistan
Wojciech Kowalczyk,0,94.0,0,0,1,2,3,Netherlands
Wojciech Rudy,0,4.0,0,0,0,1,1,Netherlands
Wojciech Szczęsny,1,18.0,1,0,0,1,1,Poland
Wojciech Łobodziński,0,34.0,0,0,1,0,1,Poland
Wole Odegbami,0,5.0,0,0,1,0,1,Nigeria
Wolfgang Dremmler,0,119.0,0,0,1,1,2,Germany
Wolfgang Overath,1,276.0,0,0,8,0,8,Germany
Wolfgang Weber,0,89.0,0,0,0,1,1,England
Wolfram Löwe,0,322.0,0,0,3,4,7,Denmark
Wong Chi Keung,1,66.0,0,0,1,0,1,Hong Kong
Wong Chi-keung,1,64.0,0,0,0,1,1,Myanmar
Wong Chun Yue,0,51.0,0,0,1,0,1,Hong Kong
Woo Sang-kwon,3,208.0,0,1,4,1,5,Israel
Worrawoot Srimaka,0,21.0,0,0,1,0,1,Thailand
Wout Weghorst,2,231.0,0,0,3,0,3,Netherlands
Wouter Brokke,1,90.0,0,0,1,0,1,Curaçao
Wu Chengying,0,87.0,0,0,1,1,2,China PR
Wu Chun-ching,0,140.0,0,0,1,2,3,Taiwan
Wu Kwok Hung,0,62.0,0,0,1,0,1,Hong Kong
Wu Lei,9,912.0,0,4,11,6,17,Bhutan
Wu Qunli,0,66.0,0,0,0,1,1,Jordan
Wu Wei'an,1,13.0,0,0,0,1,1,Myanmar
Wu Xi,2,356.0,0,0,3,3,6,China PR
Wu Xinghan,1,65.0,0,0,1,0,1,China PR
Wun Chee Keung,1,137.0,0,0,1,2,3,Hong Kong
Wyn Davies,0,122.0,0,0,2,1,3,Wales
Wynton Rufer,1,318.0,0,0,5,4,9,Kuwait
Wálter Flores,0,85.0,0,0,1,0,1,Bolivia
Wýaçeslaw Krendelew,0,12.0,0,0,1,0,1,Turkmenistan
Włodzimierz Ciołek,1,76.0,0,0,1,0,1,Poland
Włodzimierz Lubański,0,1043.0,0,0,17,4,21,Poland
Włodzimierz Mazur,0,146.0,0,1,1,1,2,Cyprus
Włodzimierz Smolarek,2,540.0,0,2,7,6,13,Malta
Xabi Alonso,4,342.0,0,3,4,3,7,Spain
Xavi,1,313.0,0,0,4,4,8,Northern Ireland
Xavier Arreaga,0,39.0,0,0,1,0,1,Ecuador
Xavier Camargo,0,137.0,0,0,2,0,2,Brazil
Xavier Chen,0,75.0,0,1,1,0,1,Taiwan
Xavier García,0,90.0,0,0,0,1,1,Cayman Islands
Xavier Samin,1,59.0,1,0,0,1,1,Tahiti
Xherdan Shaqiri,9,1194.0,0,0,12,9,21,Switzerland
Xiao Zhi,1,141.0,0,0,0,2,2,Qatar
Xie Hui,0,405.0,0,0,5,2,7,China PR
Xie Yuxin,3,101.0,0,0,2,2,4,China PR
Xu Deshuai,0,63.0,0,0,1,0,1,Hong Kong
Xu Hong,0,136.0,0,0,2,0,2,China PR
Xu Xin,0,90.0,0,0,0,1,1,Vietnam
Xu Yonglai,4,359.0,0,0,4,0,4,China PR
Xu Yunlong,0,205.0,0,0,5,0,5,China PR
Yabe Siad Isman,0,84.0,0,0,0,1,1,Niger
Yacine Bammou,0,66.0,0,0,1,0,1,Morocco
Yacine Bezzaz,0,68.0,0,0,1,0,1,Algeria
Yacine Brahimi,1,117.0,0,0,1,2,3,South Korea
Yacouba Ali,0,14.0,0,0,0,1,1,Gabon
Yahia Kébé,0,54.0,0,0,1,1,2,Burkina Faso
Yahya Al Ghassani,0,70.0,0,0,1,0,1,United Arab Emirates
Yahya Al-Shehri,0,186.0,0,0,4,1,5,Saudi Arabia
Yahya Golmohammadi,1,201.0,1,0,2,1,3,Iran
Yahya Madon,0,39.0,0,0,1,0,1,Singapore
Yaki Yen,0,3.0,0,0,0,1,1,Thailand
Yakubu,3,602.0,0,4,4,7,11,Sudan
Yakubu Mambo,0,100.0,0,0,2,0,2,Nigeria
Yamba Asha,0,72.0,0,0,0,1,1,Niger
Yan Vorogovskiy,0,10.0,0,0,1,0,1,Kazakhstan
Yang Chen,3,235.0,0,0,5,0,5,China PR
Yang Lin,0,58.0,0,0,1,0,1,China PR
Yang Seung-kook,1,25.0,0,0,1,0,1,North Korea
Yang Xu,0,722.0,0,2,12,5,17,China PR
Yang Zhaohui,1,89.0,0,0,3,0,3,China PR
Yangel Herrera,0,84.0,0,0,0,1,1,Paraguay
Yanik Frick,0,151.0,0,0,2,0,2,Liechtenstein
Yaniv Katan,0,155.0,0,0,1,1,2,Israel
Yann M'Vila,0,18.0,0,0,0,1,1,Albania
Yann Sommer,1,90.0,1,0,0,1,1,Switzerland
Yannick Bolasie,1,128.0,0,0,0,3,3,Zambia
Yannick Carrasco,1,414.0,0,0,3,3,6,Hungary
Yannick Mukunzi,0,93.0,0,0,1,1,2,Seychelles
Yannick Stopyra,2,240.0,0,0,2,4,6,Luxembourg
Yanti Barsales,0,59.0,0,0,0,1,1,Syria
Yao Junior Sènaya,0,161.0,0,0,2,0,2,Togo
Yao Lambert Amani,0,81.0,0,0,1,0,1,Ivory Coast
Yaqoob Juma Al-Mukhaini,0,579.0,0,0,11,0,11,Oman
Yari Verschaeren,0,84.0,0,1,1,0,1,Belgium
Yaroslav Rakytskiy,0,170.0,0,0,1,1,2,Andorra
Yaseen Al-Bakhit,0,58.0,0,0,0,1,1,Bangladesh
Yaser Hamed,2,143.0,0,0,2,1,3,Singapore
Yaser Kasim,1,77.0,0,0,0,1,1,Jordan
Yaser Salem Ali,0,502.0,0,0,4,6,10,Brunei
Yashir Pinto,0,71.0,0,0,2,0,2,Palestine
Yasmani Duk,0,59.0,0,0,0,1,1,Paraguay
Yasser Al-Qahtani,6,670.0,0,3,8,6,14,Saudi Arabia
Yasser Al-Shahrani,0,104.0,0,0,2,0,2,Saudi Arabia
Yasser Ezzat,0,83.0,0,0,1,0,1,Egypt
Yasser Radwan,3,180.0,0,0,1,2,3,Zambia
Yassin Mikari,0,18.0,0,0,1,0,1,Tunisia
Yassine Chikhaoui,2,238.0,0,0,1,2,3,Tunisia
Yassine Meriah,1,51.0,1,1,2,0,2,Tunisia
Yasuhito Endō,2,187.0,0,2,2,4,6,Vietnam
Yasuto Honda,1,90.0,0,0,0,1,1,Nepal
Yasuyuki Konno,0,88.0,0,0,0,2,2,Tajikistan
Yasuyuki Kuwahara,0,50.0,0,0,0,1,1,South Korea
Yatma Diop,2,92.0,0,0,0,2,2,Ghana
Yatma Diouck,2,176.0,0,0,0,2,2,Congo
Yaw Preko,0,75.0,0,0,1,0,1,Ghana
Yaya Dissa,0,80.0,0,0,1,0,1,Mali
Yaya Touré,6,609.0,0,1,5,8,13,Libya
Yazan Al-Arab,1,67.0,0,0,0,1,1,Nepal
Yaúca,0,291.0,0,0,3,1,4,Portugal
Ye Nyunt,1,42.0,0,0,1,0,1,Myanmar
Yeferson Soteldo,0,90.0,0,1,1,0,1,Venezuela
Yegor Titov,1,357.0,0,0,5,1,6,Russia
Yeh Ching-Tueng,1,66.0,0,0,1,0,1,Taiwan
Yehoshua Feigenbaum,0,158.0,0,0,2,0,2,Israel
Yehoshua Glazer,0,427.0,0,0,5,2,7,Israel
Yeltsin Tejeda,1,58.0,0,0,1,0,1,Costa Rica
Yerry Mina,4,393.0,1,0,2,4,6,Colombia
Yervand Krbachyan,0,3.0,1,0,1,0,1,Belgium
Yevgeni Varlamov,0,67.0,0,0,0,1,1,Ukraine
Yevgeniy Lunev,1,73.0,0,0,0,1,1,Nepal
Yevhen Khacheridi,0,169.0,0,0,3,0,3,Ukraine
Yevhen Konoplyanka,0,464.0,0,1,5,3,8,England
Yevhen Seleznyov,0,341.0,0,3,3,4,7,Ukraine
Yiannos Ioannou,0,256.0,0,0,2,2,4,Cyprus
Yiasoumis Yiasoumi,0,171.0,0,0,1,1,2,Cyprus
Yisa Sofoluwe,0,89.0,0,0,1,0,1,Nigeria
Yiu Cheuk Yin,1,90.0,0,0,1,0,1,Taiwan
Ylber Ramadani,0,90.0,0,0,1,0,1,Albania
Ylli Shehu,0,33.0,0,0,1,0,1,Albania
Yngve Brodd,1,320.0,0,0,1,4,5,Sweden
Yoane Wissa,0,12.0,0,0,1,0,1,DR Congo
Yoann Gourcuff,0,307.0,0,0,2,2,4,Romania
Yoann Langlet,0,3.0,0,0,1,0,1,Mauritania
Yoel Bárcenas,1,135.0,0,0,2,0,2,Panama
Yogan Santos,0,67.0,1,0,1,0,1,Germany
Yohai Aharoni,0,76.0,0,0,1,0,1,Israel
Yohan Cabaye,0,56.0,0,0,0,1,1,Ukraine
Yohanan Sukenik,1,54.0,0,0,1,0,1,Israel
Yohance Marshall,1,90.0,0,0,1,0,1,Trinidad and Tobago
Yong Jin-Li,1,61.0,0,0,0,1,1,Vietnam
Yony Flores,0,31.0,0,0,1,0,1,Guatemala
Yoo Pan-soon,0,26.0,0,0,0,1,1,Japan
Yoo Pan-sun,0,61.0,0,0,1,0,1,South Korea
Yoo Sang-chul,1,347.0,0,0,4,2,6,South Korea
Yoon Bit-garam,1,105.0,0,0,0,1,1,Iran
Yordan Letchkov,2,325.0,0,0,5,0,5,Bulgaria
Yordan Minev,0,4.0,1,0,0,1,1,Bulgaria
Yordan Yordanov,0,83.0,0,0,0,1,1,Malta
Yoshimar Yotún,3,223.0,0,0,4,1,5,Peru
Yoshinori Muto,1,43.0,0,0,1,0,1,Japan
Yoshito Ōkubo,0,76.0,0,0,2,0,2,Japan
Yossi Abukasis,0,151.0,0,0,2,0,2,Israel
Yossi Benayoun,1,712.0,0,2,13,4,17,Cyprus
Yosuke Ideguchi,0,82.0,0,0,1,0,1,Japan
Youcef Belaïli,3,102.0,0,0,1,2,3,Senegal
Younes Al Shibani,0,78.0,0,0,2,0,2,Libya
Younis Mahmoud,13,1229.0,0,2,11,9,20,Saudi Arabia
Younès Belhanda,1,129.0,0,0,1,1,2,Niger
Youri Djorkaeff,3,678.0,0,2,8,5,13,France
Youri Mulder,0,178.0,0,0,3,0,3,Netherlands
Youri Tielemans,0,59.0,0,0,2,0,2,Belgium
Yousef Aboloya,0,90.0,0,0,1,0,1,Saudi Arabia
Yousef Al-Naber,0,82.0,0,0,1,0,1,Jordan
Yousef Al-Rawashdeh,1,64.0,0,0,1,1,2,Palestine
Yousef Khalaf,0,50.0,0,0,1,0,1,Qatar
Yousef Nasser,2,520.0,0,0,9,5,14,Kuwait
Yousef Sheikh Al-Eshreh,0,92.0,0,0,1,1,2,Bahrain
Yousif Al-Sobaei,0,60.0,0,0,0,1,1,Yemen DPR
Youssef Chippo,1,45.0,1,0,0,1,1,Morocco
Youssef El-Arabi,1,301.0,0,0,3,2,5,Morocco
Youssef En-Nesyri,7,362.0,0,0,5,2,7,Morocco
Youssef Farhat,1,38.0,0,0,0,1,1,Hong Kong
Youssef Fertout,1,261.0,0,0,3,2,5,Morocco
Youssef Mohamad,0,27.0,0,0,1,0,1,Lebanon
Youssef Mokhtari,2,140.0,0,0,2,2,4,Morocco
Youssef Msakni,7,542.0,0,1,2,8,10,Morocco
Youssef Safri,1,248.0,0,3,3,3,6,Morocco
Youssouf Abdi Ahmed,0,33.0,0,0,0,1,1,Niger
Youssouf Arouna,0,62.0,0,0,1,0,1,Benin
Youssouf Falikou Fofana,1,87.0,0,0,1,1,2,Ivory Coast
Youssouf Hadji,3,625.0,0,0,8,1,9,Nigeria
Youssouf M'Changama,0,81.0,0,0,0,1,1,Cameroon
Youssouf Oumarou,1,81.0,1,1,1,1,2,Algeria
Youssuf Camara,0,52.0,0,0,0,1,1,Ghana
Yousuf Al-Thunayan,5,430.0,0,1,7,1,8,Saudi Arabia
Yousuf Jazea'a,1,78.0,0,0,1,0,1,Saudi Arabia
Yousuf Saleh Al-Alawi,2,35.0,0,0,1,1,2,Oman
Yousuf Shaaban,0,3.0,0,0,0,1,1,Singapore
Yozhef Sabo,0,198.0,0,2,1,3,4,Denmark
Ysrael Zúñiga,2,156.0,0,0,1,1,2,Peru
Yssouf Koné,0,261.0,0,0,1,2,3,Tunisia
Yu Dabao,2,551.0,0,0,7,3,10,China PR
Yu Genwei,0,124.0,0,0,2,0,2,China PR
Yu Hai,2,275.0,0,0,2,3,5,China PR
Yu Hanchao,0,229.0,0,0,2,2,4,Laos
Yu Song-chol,0,90.0,0,0,0,1,1,Singapore
Yuan Kuan Yick,1,75.0,0,0,1,0,1,Hong Kong
Yuen Kuen-Chu,1,73.0,0,0,1,1,2,Hong Kong
Yuji Nakazawa,4,527.0,0,0,5,4,9,Japan
Yuki Abe,1,53.0,0,0,1,0,1,Japan
Yun Jong-su,1,125.0,0,0,2,1,3,North Korea
Yunis Aman Al-Naseeb,1,35.0,0,0,1,0,1,Oman
Yunus Alif,0,40.0,0,0,1,0,1,Malaysia
Yura Movsisyan,0,305.0,0,0,3,5,8,North Macedonia
Yuri Borodolimov,1,72.0,0,0,0,1,1,Taiwan
Yuri Chesnokov,0,43.0,0,0,2,0,2,Russia
Yuri Gavrilov,2,226.0,0,0,3,2,5,Russia
Yuri Kovtun,0,112.0,1,0,2,0,2,Iceland
Yuriy Dmytrulin,0,56.0,0,0,1,0,1,Ukraine
Yuriy Kalitvintsev,0,13.0,0,0,1,0,1,Ukraine
Yuriy Logvinenko,0,195.0,0,0,2,1,3,Kazakhstan
Yuriy Maksymov,0,142.0,0,0,1,1,2,Ukraine
Yuriy Nikiforov,0,159.0,0,0,3,1,4,Russia
Yuriy Pertsukh,0,6.0,0,0,1,0,1,Kazakhstan
Yuriy Voynov,1,81.0,0,0,1,1,2,Russia
Yury Gazinsky,0,12.0,0,0,1,0,1,Russia
Yury Kendysh,0,64.0,0,0,1,0,1,Belarus
Yusef Ahmed,0,178.0,0,0,4,1,5,Qatar
Yussuf Poulsen,1,469.0,0,0,7,2,9,Denmark
Yusuf A'Amer Al Sadi,3,259.0,0,0,3,2,5,Bahrain
Yusuf Abdurisag,0,28.0,0,0,0,1,1,Bangladesh
Yusuf Altıntaş,0,68.0,0,0,1,0,1,Turkey
Yusuf Rabiev,0,102.0,0,0,2,0,2,Tajikistan
Yusuf Yazıcı,0,119.0,0,0,1,1,2,Moldova
Yutaka Akita,1,35.0,0,0,1,2,3,Macau
Yuto Nagatomo,0,33.0,0,0,1,0,1,Japan
Yuya Kubo,0,71.0,0,0,1,1,2,United Arab Emirates
Yuya Osako,7,766.0,0,3,11,5,16,Iraq
Yuzo Kurihara,0,154.0,0,0,1,1,2,Japan
Yvan Rajoarimanana,0,54.0,0,0,1,0,1,Madagascar
Yves Bissouma,1,73.0,0,0,0,1,1,Uganda
Yves Diba Ilunga,0,66.0,0,0,1,0,1,DR Congo
Yves Herbet,0,8.0,0,0,0,1,1,Luxembourg
Yves Vanderhaeghe,0,60.0,0,0,2,0,2,Belgium
Yves Yuvuladio,1,28.0,0,0,1,0,1,DR Congo
Yvon Douis,1,82.0,0,0,2,0,2,France
Yvon Goujon,0,133.0,0,0,2,1,3,England
Yénier Márquez,2,332.0,0,0,4,1,5,Cuba
Yıldıray Baştürk,0,26.0,0,0,2,0,2,Turkey
Yūichi Komano,0,35.0,0,0,1,0,1,Japan
Zach Muscat,0,53.0,0,0,0,1,1,Cyprus
Zachary Brault-Guillard,1,49.0,0,0,0,1,1,Aruba
Zafar Babajanow,1,59.0,0,0,1,0,1,Turkmenistan
Zah Rahan Krangar,0,89.0,0,0,0,1,1,Senegal
Zahi Armeli,0,230.0,0,0,4,1,5,Israel
Zahir Rafiq,0,53.0,0,0,1,0,1,Pakistan
Zainal Abidin Hassan,1,240.0,0,0,4,1,5,Malaysia
Zaine Pierre,0,65.0,0,0,1,0,1,Saint Lucia
Zainudin Kassim,0,49.0,0,0,1,0,1,Brunei
Zakaria Aboukhlal,2,178.0,0,0,1,1,2,Morocco
Zakaria Sanogo,0,37.0,0,0,0,1,1,Algeria
Zakariya Souleymane,0,70.0,1,0,1,0,1,Algeria
Zaker Berdykulov,2,129.0,0,0,2,0,2,Tajikistan
Zamel Al Kuwari,2,138.0,0,0,1,2,3,Indonesia
Zamel Essa Al-Kuwari,0,60.0,0,0,0,1,1,China PR
Zamirbek Jumagulov,1,8.0,0,0,1,0,1,Kyrgyzstan
Zanzan Atte-Oudeyi,0,78.0,0,0,0,1,1,Libya
Zaur Tagizade,0,166.0,0,0,3,0,3,Azerbaijan
Zaw Min Tun,1,97.0,1,0,1,1,2,Laos
Zaza Janashia,0,99.0,0,0,2,0,2,Georgia
Zbigniew Boniek,6,599.0,0,0,9,5,14,Poland
Zdenko Morovic,1,39.0,1,0,1,0,1,Brazil
Zdeněk Grygera,0,13.0,0,0,1,0,1,Czech Republic
Zdeněk Nehoda,3,628.0,0,1,11,5,16,Czechoslovakia
Zdeněk Ondrášek,0,85.0,0,0,1,0,1,Czech Republic
Zdeněk Pospěch,0,53.0,0,0,0,1,1,San Marino
Zdeněk Prokeš,0,37.0,0,0,1,0,1,Czechoslovakia
Zdeněk Zikán,4,117.0,0,0,2,2,4,Czechoslovakia
Zdravko Kuzmanović,0,310.0,0,0,2,2,4,Belgium
Zdravko Lazarov,0,55.0,0,0,1,0,1,Bulgaria
Zdravko Rajkov,1,73.0,0,0,0,1,1,Paraguay
Zeca,0,127.0,0,0,2,0,2,Greece
Zeddy Saileti,1,30.0,0,0,1,0,1,Zambia
Zeiko Lewis,0,29.0,0,0,0,1,1,Bahamas
Zelfy Nazary,1,45.0,0,0,1,0,1,Afghanistan
Zelimkhan Bakayev,0,84.0,0,1,1,0,1,Russia
Zenón González,3,188.0,0,0,3,0,3,Bolivia
Zerga Geremew,0,180.0,0,0,2,0,2,Ethiopia
Zhambyl Kukeyev,0,68.0,0,0,0,1,1,England
Zhang Enhua,2,164.0,0,0,1,2,3,Saudi Arabia
Zhang Honggen,0,1.0,0,0,1,0,1,China PR
Zhang Linpeng,2,200.0,1,0,2,1,3,Kuwait
Zhang Xiaowen,1,165.0,0,0,1,1,2,Bahrain
Zhang Xizhe,0,131.0,0,0,2,0,2,China PR
Zhang Yaokun,1,39.0,0,1,0,1,1,Myanmar
Zhang Yuning,2,212.0,0,0,3,0,3,China PR
Zhao Dayu,6,441.0,0,0,5,3,8,Singapore
Zhao Faqing,0,89.0,0,0,1,0,1,China PR
Zheng Bin,1,35.0,0,0,0,1,1,Myanmar
Zheng Zheng,0,154.0,0,0,0,2,2,Singapore
Zheng Zhi,1,394.0,1,4,5,1,6,China PR
Zhou Haibin,0,33.0,0,0,1,0,1,China PR
Zhu Chenjie,1,82.0,0,1,1,0,1,China PR
Zia Arabshahi,1,69.0,0,0,0,1,1,China PR
Ziad Jaziri,1,406.0,0,0,7,2,9,Tunisia
Ziad Tlemçani,2,100.0,0,0,2,1,3,Benin
Zico,9,790.0,0,5,15,3,18,Brazil
Zico Tumba,1,26.0,0,0,1,0,1,DR Congo
Zidane Sam,1,20.0,0,0,1,0,1,Saint Vincent and the Grenadines
Zinedine Zidane,9,973.0,0,4,9,8,17,France
Zinho,1,77.0,0,1,1,0,1,Brazil
Zini,0,106.0,0,0,1,1,2,Angola
Zisis Vryzas,1,123.0,0,0,0,3,3,Armenia
Zito,1,69.0,0,0,1,0,1,Brazil
Ziyad Al-Kord,1,10.0,0,0,1,0,1,Palestine
Zizi Roberts,0,75.0,0,0,2,0,2,Liberia
Zizinho,12,785.0,0,1,16,1,17,Brazil
Zlatan Bajramović,0,165.0,0,0,1,2,3,Bosnia and Herzegovina
Zlatan Ibrahimović,5,2364.0,0,5,26,18,44,Sweden
Zlatan Ljubijankić,1,217.0,0,0,3,0,3,Slovenia
Zlatan Muslimović,0,393.0,0,0,5,3,8,Malta
Zlatko Dedić,0,176.0,0,0,3,1,4,Poland
Zlatko Junuzović,0,350.0,0,0,3,2,5,Azerbaijan
Zlatko Kranjčar,0,119.0,0,0,3,0,3,Yugoslavia
Zlatko Vujović,0,997.0,0,0,11,7,18,Cyprus
Zlatko Yankov,0,81.0,0,0,2,0,2,Bulgaria
Zlatko Zahovič,3,1168.0,0,5,14,10,24,Slovenia
Zlatko Čajkovski,0,41.0,0,0,0,1,1,Israel
Zoilo Saldombide,2,129.0,0,1,0,2,2,Paraguay
Zola Matumona,0,242.0,0,1,2,2,4,DR Congo
Zoltan Crişan,0,243.0,0,0,2,2,4,Spain
Zoltán Böőr,0,4.0,0,0,0,1,1,San Marino
Zoltán Czibor,3,80.0,0,0,2,1,3,Hungary
Zoltán Gera,1,1244.0,0,4,14,7,21,Hungary
Zoltán Halmosi,0,30.0,0,0,1,0,1,Hungary
Zoltán Kereki,0,151.0,0,0,1,1,2,Greece
Zoltán Kovács,0,22.0,0,0,1,0,1,Hungary
Zoltán Lipták,0,40.0,0,0,0,1,1,San Marino
Zoltán Péter,0,65.0,0,0,1,0,1,Hungary
Zoltán Stieber,1,169.0,0,0,0,2,2,Finland
Zoltán Varga,0,83.0,0,0,1,0,1,Hungary
Zoran Boškovski,0,51.0,0,0,0,1,1,Belgium
Zoran Filipović,0,95.0,0,0,0,2,2,German DR
Zoran Janković,0,17.0,0,0,0,1,1,Belgium
Zoran Mirković,1,2.0,0,0,1,0,1,Serbia
Zoran Tošić,0,354.0,0,0,6,2,8,Lithuania
Zoran Vujović,0,37.0,0,0,1,0,1,Yugoslavia
Zoran Vulić,0,65.0,0,0,1,0,1,Yugoslavia
Zoubeir Baya,2,542.0,0,0,7,5,12,Gabon
Zouheir Dhaouadi,1,40.0,0,0,0,1,1,Zambia
Zsolt Kalmár,0,47.0,0,0,0,1,1,Bulgaria
Zuhair Bakheet,1,477.0,0,0,4,3,7,Kuwait
Zulkarnaen Zainal,0,88.0,0,0,0,1,1,Lebanon
Zulkifli Hamzah,1,134.0,0,0,1,1,2,Malaysia
Zumratul Hossain Mithu,0,50.0,0,0,1,0,1,Bangladesh
Zuo Shusheng,5,273.0,0,0,4,2,6,China PR
Zuriko Davitashvili,0,82.0,0,0,0,1,1,Kosovo
Zvenyika Makonese,0,30.0,1,0,0,1,1,Zimbabwe
Zvezdan Cvetković,0,14.0,0,0,1,0,1,Yugoslavia
Zvezdan Čebinac,0,87.0,0,0,2,0,2,Yugoslavia
Zvi Farkash,1,50.0,0,0,1,0,1,Israel
Zvi Rozen,2,157.0,0,0,2,0,2,Israel
Zvjezdan Misimović,0,838.0,0,4,11,8,19,Spain
Zvonimir Boban,1,501.0,0,0,9,0,9,Yugoslavia
Zvonimir Soldo,0,171.0,0,0,1,2,3,Slovenia
Zvonimir Vukić,1,172.0,0,0,1,4,5,Wales
Zvonko Ivezić,0,77.0,0,0,0,1,1,Sweden
Zvonko Živković,0,17.0,0,0,1,0,1,Yugoslavia
Zyad Chaabo,0,216.0,0,0,4,1,5,Indonesia
Zygfryd Szołtysik,0,162.0,0,0,2,0,2,Poland
Zé Kalanga,0,162.0,0,0,2,0,2,Angola
Zé Roberto,3,402.0,0,0,4,2,6,Bolivia
Zé de Mello,0,45.0,0,0,0,1,1,Ecuador
Zéphirin Zoko,0,86.0,0,0,0,1,1,Madagascar
it:Lee Ki-Bum,0,79.0,0,0,3,0,3,South Korea
Ádám Gyurcsó,0,83.0,0,0,1,1,2,Latvia
Ádám Lang,0,43.0,0,0,1,0,1,Hungary
Ádám Szalai,1,765.0,0,2,11,7,18,Hungary
Ákos Buzsáky,0,42.0,0,0,1,1,2,Hungary
Ákos Takács,0,64.0,0,0,1,0,1,Hungary
Álex Aguinaga,4,807.0,0,1,8,7,15,Ecuador
Álex da Rosa,0,45.0,0,0,1,0,1,Bolivia
Álvaro Grant,0,54.0,0,0,0,1,1,Mexico
Álvaro Morata,8,1127.0,0,1,13,8,21,Spain
Álvaro Murillo,0,180.0,0,0,2,1,3,Guatemala
Álvaro Negredo,0,366.0,0,0,4,3,7,Bosnia and Herzegovina
Álvaro Pereira,3,222.0,1,0,4,1,5,South Africa
Álvaro Peña,0,136.0,0,0,2,0,2,Bolivia
Álvaro Recoba,3,283.0,0,1,3,3,6,Uruguay
Álvaro Saborío,4,813.0,0,2,11,10,21,Cuba
Ángel Berni,3,229.0,0,0,1,3,4,Chile
Ángel Cabrera,1,22.0,0,0,2,0,2,Uruguay
Ángel Correa,0,74.0,0,0,0,1,1,Venezuela
Ángel Di María,7,802.0,0,0,10,7,17,Argentina
Ángel Fernández,1,256.0,0,0,3,1,4,Ecuador
Ángel Guirado,2,88.0,0,0,3,1,4,Philippines
Ángel Jara Saguier,0,122.0,0,0,1,1,2,Colombia
Ángel Labruna,5,553.0,0,0,10,0,10,Argentina
Ángel Martínez,0,64.0,0,0,0,1,1,Haiti
Ángel María Villar,0,34.0,0,0,0,2,2,Romania
Ángel Mena,1,242.0,0,0,3,2,5,Ecuador
Ángel Piedra,1,73.0,0,0,1,0,1,Cuba
Ángel Reyna,1,86.0,0,0,0,1,1,Guyana
Ángel Romano,5,524.0,0,0,6,6,12,Uruguay
Ángel Romero,2,420.0,0,2,6,1,7,Paraguay
Ángel Sepúlveda,1,80.0,0,0,0,2,2,El Salvador
Ángel Tejeda,0,18.0,0,1,0,1,1,Jamaica
Ángelo Padilla,0,45.0,0,0,1,0,1,Guatemala
Ármann Björnsson,0,6.0,0,0,1,0,1,Iceland
Árni Sveinsson,0,75.0,0,0,1,0,1,Iceland
Ásgeir Sigurvinsson,0,208.0,0,0,1,3,4,Iceland
Änis Ben-Hatira,0,79.0,0,0,1,0,1,Tunisia
Åge Hareide,0,120.0,0,0,3,1,4,Norway
Çağlar Söyüncü,1,28.0,0,0,0,1,1,Norway
Éder,1,258.0,0,0,2,2,4,Bulgaria
Éder Aleixo de Assis,2,297.0,0,0,3,1,4,Brazil
Éder Militão,0,37.0,0,0,1,0,1,Brazil
Édgar Barreto,1,29.0,0,0,0,1,1,United States
Édgar Benítez,1,371.0,1,0,2,4,6,Ecuador
Édgar González,0,90.0,0,0,1,0,1,Guatemala
Édison Méndez,4,730.0,1,1,10,5,15,Peru
Édouard Kargu,0,73.0,0,0,0,1,1,Luxembourg
Élmer Ponciano,0,2.0,0,0,1,0,1,Guatemala
Émerson Ferreira da Rosa,0,67.0,0,0,0,1,1,Uruguay
Émile Mpenza,0,304.0,0,0,9,0,9,Belgium
Émile Veinante,0,1.0,0,0,1,0,1,France
Éric Assadourian,0,135.0,0,0,1,2,3,Northern Ireland
Éric Mouloungui,0,119.0,0,0,2,0,2,Gabon
Éric Pécout,0,67.0,0,0,1,0,1,France
Étienne Capoue,0,49.0,0,0,1,0,1,France
Étienne N'tsunda,1,29.0,0,0,1,0,1,DR Congo
Éver Banega,1,103.0,0,0,1,1,2,Bolivia
Éverton Ribeiro,0,168.0,0,0,2,1,3,Brazil
Ísak Bergmann Jóhannesson,0,77.0,0,0,1,0,1,Iceland
Ítalo Díaz,0,12.0,1,0,0,1,1,Chile
Ítalo Estupiñán,0,35.0,0,0,1,0,1,Ecuador
Óli Johannesen,0,70.0,1,0,0,1,1,Faroe Islands
Óscar Aguilera,0,88.0,0,0,0,1,1,Colombia
Óscar Cardozo,2,310.0,0,1,2,3,5,United States
Óscar Carmelo Sánchez,0,71.0,0,0,0,1,1,Uruguay
Óscar Duarte,1,77.0,0,0,1,1,2,Uruguay
Óscar Gómez Sánchez,7,513.0,0,0,3,7,10,Peru
Óscar Míguez,11,767.0,0,2,4,11,15,Bolivia
Óscar Ramírez,0,93.0,0,0,1,1,2,Costa Rica
Óscar Reyes,1,85.0,0,0,0,1,1,Bolivia
Óscar Rojas,0,48.0,0,0,1,0,1,Mexico
Óscar Romero,0,6.0,0,0,1,0,1,Paraguay
Óscar Sonejee,0,110.0,1,0,1,1,2,Andorra
Óscar Ulloa,0,399.0,0,0,2,4,6,Nicaragua
Örjan Martinsson,0,50.0,0,0,0,2,2,Norway
Örjan Persson,0,111.0,0,0,2,1,3,Sweden
Örn Óskarsson,0,90.0,0,0,0,1,1,Norway
Øssur Hansen,0,150.0,0,0,1,1,2,Malta
Øyvind Leonhardsen,0,250.0,0,0,3,3,6,Norway
Ümit Davala,1,181.0,0,0,2,2,4,North Macedonia
Ümit Karan,0,63.0,0,0,0,1,1,Moldova
Ünal Karaman,0,73.0,0,0,1,0,1,Turkey
Þorsteinn Bjarnason,0,78.0,1,0,1,0,1,Czechoslovakia
Þorvaldur Örlygsson,0,122.0,0,0,1,1,2,Iceland
Þórður Guðjónsson,0,326.0,0,0,3,2,5,Iceland
Þórður Jónsson,0,129.0,0,0,2,0,2,Iceland
Þórður Þórðarson,0,110.0,0,0,0,2,2,Belgium
Đinh Tiến Thành,0,109.0,1,0,0,2,2,Taiwan
Đorđe Vujadinović,1,89.0,0,0,0,2,2,Bolivia
Đovani Roso,0,71.0,0,0,0,1,1,Andorra
Đỗ Duy Mạnh,0,26.0,0,0,0,1,1,Indonesia
Ģirts Karlsons,0,61.0,0,0,2,2,4,Latvia
İbrahim Toraman,0,15.0,0,0,0,1,1,Kazakhstan
İlhan Mansız,1,265.0,0,0,2,4,6,Moldova
İlkay Gündoğan,2,528.0,0,5,6,6,12,Germany
İlyas Tüfekçi,0,140.0,0,1,2,0,2,Turkey
İrfan Kahveci,1,62.0,0,0,0,1,1,Switzerland
İsmail Arca,0,64.0,1,0,2,0,2,Turkey
Ľubomír Meszároš,0,57.0,0,0,1,0,1,Slovakia
Ľubomír Michalík,0,42.0,0,0,0,1,1,San Marino
Ľubomír Moravčík,0,262.0,0,0,3,3,6,Czechoslovakia
Ľubomír Reiter,0,312.0,0,0,2,4,6,North Macedonia
Ľuboš Hanzel,0,68.0,0,0,1,0,1,Slovakia
Ľudovít Lancz,0,39.0,0,0,1,0,1,Czechoslovakia
Łukasz Garguła,0,89.0,0,0,1,0,1,Poland
Łukasz Piszczek,0,128.0,0,0,2,1,3,Poland
Łukasz Szukała,1,58.0,0,0,0,1,1,Gibraltar
Łukasz Teodorczyk,0,60.0,0,0,1,0,1,Poland
Ştefan Sameş,0,130.0,0,0,2,0,2,Romania
Štěpán Vachoušek,0,78.0,0,0,0,1,1,Austria
Žarko Odžakov,0,166.0,0,0,3,0,3,Australia
Žarko Serafimovski,0,20.0,0,0,0,1,1,Turkey
Žarko Tomašević,0,233.0,0,0,3,1,4,Montenegro
Željko Milinovič,1,47.0,0,0,0,2,2,Luxembourg
Željko Čajkovski,3,369.0,0,0,2,4,6,Yugoslavia
Ștefan Dobay,3,292.0,0,0,1,4,5,Switzerland
Ștefan Iovan,0,162.0,0,0,2,1,3,Turkey
